PokerStars Hand #42115: Hold'em No Limit (50/100) - 2019/07/11 11:41:55 ET
Table 'Pluribus Session 42' 6-max (Play Money) Seat #6 is the button
Seat 1: Hattori (10000 in chips)
Seat 2: MrBlue (10000 in chips)
Seat 3: Bill (10000 in chips)
Seat 4: MrOrange (10000 in chips)
Seat 5: Pluribus (10000 in chips)
Seat 6: ORen (10000 in chips)
Hattori: posts small blind 50
MrBlue: posts big blind 100
*** HOLE CARDS ***
Dealt to Hattori [8h 5s]
Dealt to MrBlue [6h 4h]
Dealt to Bill [Ks 7d]
Dealt to MrOrange [Th 6s]
Dealt to Pluribus [5h 2d]
Dealt to ORen [5d As]
Bill: folds
MrOrange: folds
Pluribus: folds
ORen: raises 100 to 200
Hattori: folds
MrBlue: calls 100
*** FLOP *** [2s 8c 9d]
MrBlue: checks
ORen: checks
*** TURN *** [2s 8c 9d] [3h]
MrBlue: bets 200
ORen: calls 200
*** RIVER *** [2s 8c 9d] [3h] [6c]
MrBlue: checks
ORen: checks
*** SHOWDOWN ***
MrBlue: shows [6h 4h]
MrBlue collected 850.0 from pot
*** SUMMARY ***
Total pot 850 | Rake 0
Board [2s 8c 9d 3h 6c]
Seat 2: MrBlue showed [6h 4h] and won (850.0)
Seat 6: ORen showed [5d As] and lost


PokerStars Hand #42116: Hold'em No Limit (50/100) - 2019/07/11 11:41:56 ET
Table 'Pluribus Session 42' 6-max (Play Money) Seat #6 is the button
Seat 1: MrBlue (10000 in chips)
Seat 2: Bill (10000 in chips)
Seat 3: MrOrange (10000 in chips)
Seat 4: Pluribus (10000 in chips)
Seat 5: ORen (10000 in chips)
Seat 6: Hattori (10000 in chips)
MrBlue: posts small blind 50
Bill: posts big blind 100
*** HOLE CARDS ***
Dealt to MrBlue [8c Qc]
Dealt to Bill [6s 4d]
Dealt to MrOrange [Ah 4s]
Dealt to Pluribus [5s 5d]
Dealt to ORen [Qh 2c]
Dealt to Hattori [2s Jh]
MrOrange: folds
Pluribus: raises 100 to 200
ORen: folds
Hattori: folds
MrBlue: calls 150
Bill: folds
*** FLOP *** [2d 9h 3h]
MrBlue: checks
Pluribus: checks
*** TURN *** [2d 9h 3h] [9s]
MrBlue: checks
Pluribus: bets 250
MrBlue: folds
Uncalled bet (250) returned to Pluribus
Pluribus collected 500.0 from pot
*** SUMMARY ***
Total pot 500 | Rake 0
Board [2d 9h 3h 9s]


PokerStars Hand #42117: Hold'em No Limit (50/100) - 2019/07/11 11:41:57 ET
Table 'Pluribus Session 42' 6-max (Play Money) Seat #6 is the button
Seat 1: Bill (10000 in chips)
Seat 2: MrOrange (10000 in chips)
Seat 3: Pluribus (10000 in chips)
Seat 4: ORen (10000 in chips)
Seat 5: Hattori (10000 in chips)
Seat 6: MrBlue (10000 in chips)
Bill: posts small blind 50
MrOrange: posts big blind 100
*** HOLE CARDS ***
Dealt to Bill [3s 9c]
Dealt to MrOrange [Jd 8h]
Dealt to Pluribus [5d 5s]
Dealt to ORen [Kd 9d]
Dealt to Hattori [Ts 5c]
Dealt to MrBlue [Qs 7h]
Pluribus: raises 100 to 200
ORen: folds
Hattori: folds
MrBlue: folds
Bill: folds
MrOrange: calls 100
*** FLOP *** [9s Jc Ad]
MrOrange: checks
Pluribus: checks
*** TURN *** [9s Jc Ad] [3h]
MrOrange: checks
Pluribus: bets 112
MrOrange: calls 112
*** RIVER *** [9s Jc Ad] [3h] [8c]
MrOrange: bets 500
Pluribus: folds
Uncalled bet (500) returned to MrOrange
MrOrange collected 674.0 from pot
*** SUMMARY ***
Total pot 674 | Rake 0
Board [9s Jc Ad 3h 8c]


PokerStars Hand #42118: Hold'em No Limit (50/100) - 2019/07/11 11:41:58 ET
Table 'Pluribus Session 42' 6-max (Play Money) Seat #6 is the button
Seat 1: MrOrange (10000 in chips)
Seat 2: Pluribus (10000 in chips)
Seat 3: ORen (10000 in chips)
Seat 4: Hattori (10000 in chips)
Seat 5: MrBlue (10000 in chips)
Seat 6: Bill (10000 in chips)
MrOrange: posts small blind 50
Pluribus: posts big blind 100
*** HOLE CARDS ***
Dealt to MrOrange [7h 6d]
Dealt to Pluribus [Js Qh]
Dealt to ORen [Ah 5s]
Dealt to Hattori [As 9h]
Dealt to MrBlue [7s 4h]
Dealt to Bill [2h 8c]
ORen: folds
Hattori: folds
MrBlue: folds
Bill: folds
MrOrange: folds
Uncalled bet (50) returned to Pluribus
Pluribus collected 100.0 from pot
*** SUMMARY ***
Total pot 100 | Rake 0


PokerStars Hand #42119: Hold'em No Limit (50/100) - 2019/07/11 11:41:59 ET
Table 'Pluribus Session 42' 6-max (Play Money) Seat #6 is the button
Seat 1: Pluribus (10000 in chips)
Seat 2: ORen (10000 in chips)
Seat 3: Hattori (10000 in chips)
Seat 4: MrBlue (10000 in chips)
Seat 5: Bill (10000 in chips)
Seat 6: MrOrange (10000 in chips)
Pluribus: posts small blind 50
ORen: posts big blind 100
*** HOLE CARDS ***
Dealt to Pluribus [5d 7h]
Dealt to ORen [Ad 8h]
Dealt to Hattori [Ks Ah]
Dealt to MrBlue [Ts 4h]
Dealt to Bill [Kd 8c]
Dealt to MrOrange [5c 4s]
Hattori: raises 100 to 200
MrBlue: folds
Bill: folds
MrOrange: folds
Pluribus: folds
ORen: calls 100
*** FLOP *** [2d 7s 2h]
ORen: checks
Hattori: bets 112
ORen: folds
Uncalled bet (112) returned to Hattori
Hattori collected 450.0 from pot
*** SUMMARY ***
Total pot 450 | Rake 0
Board [2d 7s 2h]


PokerStars Hand #42120: Hold'em No Limit (50/100) - 2019/07/11 11:42:00 ET
Table 'Pluribus Session 42' 6-max (Play Money) Seat #6 is the button
Seat 1: ORen (10000 in chips)
Seat 2: Hattori (10000 in chips)
Seat 3: MrBlue (10000 in chips)
Seat 4: Bill (10000 in chips)
Seat 5: MrOrange (10000 in chips)
Seat 6: Pluribus (10000 in chips)
ORen: posts small blind 50
Hattori: posts big blind 100
*** HOLE CARDS ***
Dealt to ORen [2c 6d]
Dealt to Hattori [3d 5h]
Dealt to MrBlue [7h Qh]
Dealt to Bill [2s 8c]
Dealt to MrOrange [Th Ad]
Dealt to Pluribus [3h Qc]
MrBlue: folds
Bill: folds
MrOrange: raises 100 to 200
Pluribus: folds
ORen: folds
Hattori: folds
Uncalled bet (100) returned to MrOrange
MrOrange collected 250.0 from pot
*** SUMMARY ***
Total pot 250 | Rake 0


PokerStars Hand #42121: Hold'em No Limit (50/100) - 2019/07/11 11:42:01 ET
Table 'Pluribus Session 42' 6-max (Play Money) Seat #6 is the button
Seat 1: Hattori (10000 in chips)
Seat 2: MrBlue (10000 in chips)
Seat 3: Bill (10000 in chips)
Seat 4: MrOrange (10000 in chips)
Seat 5: Pluribus (10000 in chips)
Seat 6: ORen (10000 in chips)
Hattori: posts small blind 50
MrBlue: posts big blind 100
*** HOLE CARDS ***
Dealt to Hattori [4c Ah]
Dealt to MrBlue [3s 9h]
Dealt to Bill [5h 7c]
Dealt to MrOrange [7h Tc]
Dealt to Pluribus [9c 8h]
Dealt to ORen [7s As]
Bill: folds
MrOrange: folds
Pluribus: folds
ORen: raises 100 to 200
Hattori: folds
MrBlue: folds
Uncalled bet (100) returned to ORen
ORen collected 250.0 from pot
*** SUMMARY ***
Total pot 250 | Rake 0


PokerStars Hand #42122: Hold'em No Limit (50/100) - 2019/07/11 11:42:02 ET
Table 'Pluribus Session 42' 6-max (Play Money) Seat #6 is the button
Seat 1: MrBlue (10000 in chips)
Seat 2: Bill (10000 in chips)
Seat 3: MrOrange (10000 in chips)
Seat 4: Pluribus (10000 in chips)
Seat 5: ORen (10000 in chips)
Seat 6: Hattori (10000 in chips)
MrBlue: posts small blind 50
Bill: posts big blind 100
*** HOLE CARDS ***
Dealt to MrBlue [8c Ah]
Dealt to Bill [2s 4d]
Dealt to MrOrange [6h 5s]
Dealt to Pluribus [Ks 5d]
Dealt to ORen [3s 8s]
Dealt to Hattori [9s Qs]
MrOrange: folds
Pluribus: folds
ORen: folds
Hattori: raises 125 to 225
MrBlue: calls 175
Bill: folds
*** FLOP *** [9h Js Kc]
MrBlue: checks
Hattori: bets 125
MrBlue: folds
Uncalled bet (125) returned to Hattori
Hattori collected 550.0 from pot
*** SUMMARY ***
Total pot 550 | Rake 0
Board [9h Js Kc]


PokerStars Hand #42123: Hold'em No Limit (50/100) - 2019/07/11 11:42:03 ET
Table 'Pluribus Session 42' 6-max (Play Money) Seat #6 is the button
Seat 1: Bill (10000 in chips)
Seat 2: MrOrange (10000 in chips)
Seat 3: Pluribus (10000 in chips)
Seat 4: ORen (10000 in chips)
Seat 5: Hattori (10000 in chips)
Seat 6: MrBlue (10000 in chips)
Bill: posts small blind 50
MrOrange: posts big blind 100
*** HOLE CARDS ***
Dealt to Bill [9c Qs]
Dealt to MrOrange [3h 5c]
Dealt to Pluribus [4c 8s]
Dealt to ORen [Jh 2d]
Dealt to Hattori [3d Ah]
Dealt to MrBlue [9d 6c]
Pluribus: folds
ORen: folds
Hattori: folds
MrBlue: folds
Bill: raises 200 to 300
MrOrange: folds
Uncalled bet (200) returned to Bill
Bill collected 200.0 from pot
*** SUMMARY ***
Total pot 200 | Rake 0


PokerStars Hand #42124: Hold'em No Limit (50/100) - 2019/07/11 11:42:04 ET
Table 'Pluribus Session 42' 6-max (Play Money) Seat #6 is the button
Seat 1: MrOrange (10000 in chips)
Seat 2: Pluribus (10000 in chips)
Seat 3: ORen (10000 in chips)
Seat 4: Hattori (10000 in chips)
Seat 5: MrBlue (10000 in chips)
Seat 6: Bill (10000 in chips)
MrOrange: posts small blind 50
Pluribus: posts big blind 100
*** HOLE CARDS ***
Dealt to MrOrange [5s 2d]
Dealt to Pluribus [8s 9d]
Dealt to ORen [5h 5c]
Dealt to Hattori [Jd 7c]
Dealt to MrBlue [8h 4c]
Dealt to Bill [7d 6c]
ORen: raises 100 to 200
Hattori: folds
MrBlue: folds
Bill: folds
MrOrange: folds
Pluribus: calls 100
*** FLOP *** [9c 7s As]
Pluribus: checks
ORen: checks
*** TURN *** [9c 7s As] [Kh]
Pluribus: checks
ORen: checks
*** RIVER *** [9c 7s As] [Kh] [Ad]
Pluribus: checks
ORen: bets 125
Pluribus: calls 125
*** SHOWDOWN ***
Pluribus: shows [8s 9d]
Pluribus collected 700.0 from pot
*** SUMMARY ***
Total pot 700 | Rake 0
Board [9c 7s As Kh Ad]
Seat 2: Pluribus showed [8s 9d] and won (700.0)
Seat 3: ORen showed [5h 5c] and lost


PokerStars Hand #42125: Hold'em No Limit (50/100) - 2019/07/11 11:42:05 ET
Table 'Pluribus Session 42' 6-max (Play Money) Seat #6 is the button
Seat 1: Pluribus (10000 in chips)
Seat 2: ORen (10000 in chips)
Seat 3: Hattori (10000 in chips)
Seat 4: MrBlue (10000 in chips)
Seat 5: Bill (10000 in chips)
Seat 6: MrOrange (10000 in chips)
Pluribus: posts small blind 50
ORen: posts big blind 100
*** HOLE CARDS ***
Dealt to Pluribus [3c 8h]
Dealt to ORen [Tc 9h]
Dealt to Hattori [Jh 8c]
Dealt to MrBlue [Jd 9s]
Dealt to Bill [5d 9c]
Dealt to MrOrange [Qc Qd]
Hattori: folds
MrBlue: folds
Bill: folds
MrOrange: raises 100 to 200
Pluribus: folds
ORen: calls 100
*** FLOP *** [4d 6h 5h]
ORen: checks
MrOrange: checks
*** TURN *** [4d 6h 5h] [8d]
ORen: bets 175
MrOrange: calls 175
*** RIVER *** [4d 6h 5h] [8d] [As]
ORen: bets 800
MrOrange: folds
Uncalled bet (800) returned to ORen
ORen collected 800.0 from pot
*** SUMMARY ***
Total pot 800 | Rake 0
Board [4d 6h 5h 8d As]


PokerStars Hand #42126: Hold'em No Limit (50/100) - 2019/07/11 11:42:06 ET
Table 'Pluribus Session 42' 6-max (Play Money) Seat #6 is the button
Seat 1: ORen (10000 in chips)
Seat 2: Hattori (10000 in chips)
Seat 3: MrBlue (10000 in chips)
Seat 4: Bill (10000 in chips)
Seat 5: MrOrange (10000 in chips)
Seat 6: Pluribus (10000 in chips)
ORen: posts small blind 50
Hattori: posts big blind 100
*** HOLE CARDS ***
Dealt to ORen [3c 4s]
Dealt to Hattori [Ah 5s]
Dealt to MrBlue [2c 7c]
Dealt to Bill [9s 3d]
Dealt to MrOrange [Ac Kh]
Dealt to Pluribus [Th Qh]
MrBlue: folds
Bill: folds
MrOrange: raises 100 to 200
Pluribus: calls 200
ORen: folds
Hattori: folds
*** FLOP *** [7h 4d 8d]
MrOrange: checks
Pluribus: checks
*** TURN *** [7h 4d 8d] [Kd]
MrOrange: checks
Pluribus: bets 550
MrOrange: calls 550
*** RIVER *** [7h 4d 8d] [Kd] [5h]
MrOrange: checks
Pluribus: checks
*** SHOWDOWN ***
MrOrange: shows [Ac Kh]
MrOrange collected 1650.0 from pot
*** SUMMARY ***
Total pot 1650 | Rake 0
Board [7h 4d 8d Kd 5h]
Seat 5: MrOrange showed [Ac Kh] and won (1650.0)
Seat 6: Pluribus showed [Th Qh] and lost


PokerStars Hand #42127: Hold'em No Limit (50/100) - 2019/07/11 11:42:07 ET
Table 'Pluribus Session 42' 6-max (Play Money) Seat #6 is the button
Seat 1: Hattori (10000 in chips)
Seat 2: MrBlue (10000 in chips)
Seat 3: Bill (10000 in chips)
Seat 4: MrOrange (10000 in chips)
Seat 5: Pluribus (10000 in chips)
Seat 6: ORen (10000 in chips)
Hattori: posts small blind 50
MrBlue: posts big blind 100
*** HOLE CARDS ***
Dealt to Hattori [4h Jc]
Dealt to MrBlue [9d Qc]
Dealt to Bill [Kc 3c]
Dealt to MrOrange [Js Qs]
Dealt to Pluribus [3d 2c]
Dealt to ORen [Kh 9s]
Bill: folds
MrOrange: raises 100 to 200
Pluribus: folds
ORen: folds
Hattori: folds
MrBlue: calls 100
*** FLOP *** [2d 5d Td]
MrBlue: checks
MrOrange: bets 150
MrBlue: calls 150
*** TURN *** [2d 5d Td] [4d]
MrBlue: checks
MrOrange: checks
*** RIVER *** [2d 5d Td] [4d] [7d]
MrBlue: bets 300
MrOrange: folds
Uncalled bet (300) returned to MrBlue
MrBlue collected 750.0 from pot
*** SUMMARY ***
Total pot 750 | Rake 0
Board [2d 5d Td 4d 7d]


PokerStars Hand #42128: Hold'em No Limit (50/100) - 2019/07/11 11:42:08 ET
Table 'Pluribus Session 42' 6-max (Play Money) Seat #6 is the button
Seat 1: MrBlue (10000 in chips)
Seat 2: Bill (10000 in chips)
Seat 3: MrOrange (10000 in chips)
Seat 4: Pluribus (10000 in chips)
Seat 5: ORen (10000 in chips)
Seat 6: Hattori (10000 in chips)
MrBlue: posts small blind 50
Bill: posts big blind 100
*** HOLE CARDS ***
Dealt to MrBlue [4d 5d]
Dealt to Bill [7s 3h]
Dealt to MrOrange [5c Kd]
Dealt to Pluribus [Qh Ac]
Dealt to ORen [4h 7h]
Dealt to Hattori [6s Qc]
MrOrange: folds
Pluribus: raises 125 to 225
ORen: folds
Hattori: folds
MrBlue: calls 175
Bill: folds
*** FLOP *** [Ad 2h 9h]
MrBlue: checks
Pluribus: checks
*** TURN *** [Ad 2h 9h] [3d]
MrBlue: checks
Pluribus: checks
*** RIVER *** [Ad 2h 9h] [3d] [3c]
MrBlue: bets 200
Pluribus: raises 475 to 675
MrBlue: raises 3050 to 3725
Pluribus: folds
Uncalled bet (3050) returned to MrBlue
MrBlue collected 1900.0 from pot
*** SUMMARY ***
Total pot 1900 | Rake 0
Board [Ad 2h 9h 3d 3c]


PokerStars Hand #42129: Hold'em No Limit (50/100) - 2019/07/11 11:42:09 ET
Table 'Pluribus Session 42' 6-max (Play Money) Seat #6 is the button
Seat 1: Bill (10000 in chips)
Seat 2: MrOrange (10000 in chips)
Seat 3: Pluribus (10000 in chips)
Seat 4: ORen (10000 in chips)
Seat 5: Hattori (10000 in chips)
Seat 6: MrBlue (10000 in chips)
Bill: posts small blind 50
MrOrange: posts big blind 100
*** HOLE CARDS ***
Dealt to Bill [Qh 7d]
Dealt to MrOrange [Qd Ah]
Dealt to Pluribus [Qs 4c]
Dealt to ORen [Ac 9h]
Dealt to Hattori [Kh 7s]
Dealt to MrBlue [9s 6d]
Pluribus: folds
ORen: folds
Hattori: folds
MrBlue: folds
Bill: folds
Uncalled bet (50) returned to MrOrange
MrOrange collected 100.0 from pot
*** SUMMARY ***
Total pot 100 | Rake 0


PokerStars Hand #42130: Hold'em No Limit (50/100) - 2019/07/11 11:42:10 ET
Table 'Pluribus Session 42' 6-max (Play Money) Seat #6 is the button
Seat 1: MrOrange (10000 in chips)
Seat 2: Pluribus (10000 in chips)
Seat 3: ORen (10000 in chips)
Seat 4: Hattori (10000 in chips)
Seat 5: MrBlue (10000 in chips)
Seat 6: Bill (10000 in chips)
MrOrange: posts small blind 50
Pluribus: posts big blind 100
*** HOLE CARDS ***
Dealt to MrOrange [3s 5c]
Dealt to Pluribus [7c Ad]
Dealt to ORen [6d 4c]
Dealt to Hattori [3h Th]
Dealt to MrBlue [Qd 4h]
Dealt to Bill [8d Qs]
ORen: folds
Hattori: folds
MrBlue: folds
Bill: folds
MrOrange: folds
Uncalled bet (50) returned to Pluribus
Pluribus collected 100.0 from pot
*** SUMMARY ***
Total pot 100 | Rake 0


PokerStars Hand #42131: Hold'em No Limit (50/100) - 2019/07/11 11:42:11 ET
Table 'Pluribus Session 42' 6-max (Play Money) Seat #6 is the button
Seat 1: Pluribus (10000 in chips)
Seat 2: ORen (10000 in chips)
Seat 3: Hattori (10000 in chips)
Seat 4: MrBlue (10000 in chips)
Seat 5: Bill (10000 in chips)
Seat 6: MrOrange (10000 in chips)
Pluribus: posts small blind 50
ORen: posts big blind 100
*** HOLE CARDS ***
Dealt to Pluribus [5d 9s]
Dealt to ORen [9c Td]
Dealt to Hattori [Qh Ts]
Dealt to MrBlue [Jd Th]
Dealt to Bill [2s As]
Dealt to MrOrange [Kd 5h]
Hattori: folds
MrBlue: folds
Bill: raises 125 to 225
MrOrange: folds
Pluribus: folds
ORen: calls 125
*** FLOP *** [4h 3s 8h]
ORen: checks
Bill: checks
*** TURN *** [4h 3s 8h] [Qc]
ORen: checks
Bill: checks
*** RIVER *** [4h 3s 8h] [Qc] [3c]
ORen: bets 500
Bill: folds
Uncalled bet (500) returned to ORen
ORen collected 500.0 from pot
*** SUMMARY ***
Total pot 500 | Rake 0
Board [4h 3s 8h Qc 3c]


PokerStars Hand #42132: Hold'em No Limit (50/100) - 2019/07/11 11:42:12 ET
Table 'Pluribus Session 42' 6-max (Play Money) Seat #6 is the button
Seat 1: ORen (10000 in chips)
Seat 2: Hattori (10000 in chips)
Seat 3: MrBlue (10000 in chips)
Seat 4: Bill (10000 in chips)
Seat 5: MrOrange (10000 in chips)
Seat 6: Pluribus (10000 in chips)
ORen: posts small blind 50
Hattori: posts big blind 100
*** HOLE CARDS ***
Dealt to ORen [4d 3c]
Dealt to Hattori [3d Jh]
Dealt to MrBlue [Qd Qs]
Dealt to Bill [8c Jc]
Dealt to MrOrange [6h Ah]
Dealt to Pluribus [Kh 3s]
MrBlue: raises 125 to 225
Bill: folds
MrOrange: folds
Pluribus: folds
ORen: folds
Hattori: folds
Uncalled bet (125) returned to MrBlue
MrBlue collected 250.0 from pot
*** SUMMARY ***
Total pot 250 | Rake 0


PokerStars Hand #42133: Hold'em No Limit (50/100) - 2019/07/11 11:42:13 ET
Table 'Pluribus Session 42' 6-max (Play Money) Seat #6 is the button
Seat 1: Hattori (10000 in chips)
Seat 2: MrBlue (10000 in chips)
Seat 3: Bill (10000 in chips)
Seat 4: MrOrange (10000 in chips)
Seat 5: Pluribus (10000 in chips)
Seat 6: ORen (10000 in chips)
Hattori: posts small blind 50
MrBlue: posts big blind 100
*** HOLE CARDS ***
Dealt to Hattori [3h 2h]
Dealt to MrBlue [6d 4d]
Dealt to Bill [Qh 9c]
Dealt to MrOrange [4s Tc]
Dealt to Pluribus [8d 5s]
Dealt to ORen [Ah Kh]
Bill: folds
MrOrange: folds
Pluribus: folds
ORen: raises 100 to 200
Hattori: folds
MrBlue: calls 100
*** FLOP *** [Qs Td 8h]
MrBlue: checks
ORen: bets 350
MrBlue: folds
Uncalled bet (350) returned to ORen
ORen collected 450.0 from pot
*** SUMMARY ***
Total pot 450 | Rake 0
Board [Qs Td 8h]


PokerStars Hand #42134: Hold'em No Limit (50/100) - 2019/07/11 11:42:14 ET
Table 'Pluribus Session 42' 6-max (Play Money) Seat #6 is the button
Seat 1: MrBlue (10000 in chips)
Seat 2: Bill (10000 in chips)
Seat 3: MrOrange (10000 in chips)
Seat 4: Pluribus (10000 in chips)
Seat 5: ORen (10000 in chips)
Seat 6: Hattori (10000 in chips)
MrBlue: posts small blind 50
Bill: posts big blind 100
*** HOLE CARDS ***
Dealt to MrBlue [Js 3h]
Dealt to Bill [Jh Th]
Dealt to MrOrange [9c 9h]
Dealt to Pluribus [8s 4d]
Dealt to ORen [6h Tc]
Dealt to Hattori [3d 3s]
MrOrange: raises 100 to 200
Pluribus: folds
ORen: folds
Hattori: calls 200
MrBlue: folds
Bill: calls 100
*** FLOP *** [7c 5d 6s]
Bill: checks
MrOrange: checks
Hattori: checks
*** TURN *** [7c 5d 6s] [8c]
Bill: bets 175
MrOrange: calls 175
Hattori: folds
*** RIVER *** [7c 5d 6s] [8c] [Ks]
Bill: bets 750
MrOrange: calls 750
*** SHOWDOWN ***
MrOrange: shows [9c 9h]
MrOrange collected 2500.0 from pot
*** SUMMARY ***
Total pot 2500 | Rake 0
Board [7c 5d 6s 8c Ks]
Seat 2: Bill showed [Jh Th] and lost
Seat 3: MrOrange showed [9c 9h] and won (2500.0)


PokerStars Hand #42135: Hold'em No Limit (50/100) - 2019/07/11 11:42:15 ET
Table 'Pluribus Session 42' 6-max (Play Money) Seat #6 is the button
Seat 1: Bill (10000 in chips)
Seat 2: MrOrange (10000 in chips)
Seat 3: Pluribus (10000 in chips)
Seat 4: ORen (10000 in chips)
Seat 5: Hattori (10000 in chips)
Seat 6: MrBlue (10000 in chips)
Bill: posts small blind 50
MrOrange: posts big blind 100
*** HOLE CARDS ***
Dealt to Bill [4d 2h]
Dealt to MrOrange [Qh 2d]
Dealt to Pluribus [As 4s]
Dealt to ORen [2c 2s]
Dealt to Hattori [Ac Qc]
Dealt to MrBlue [Kd 3h]
Pluribus: raises 150 to 250
ORen: folds
Hattori: raises 550 to 800
MrBlue: folds
Bill: folds
MrOrange: folds
Pluribus: raises 1089 to 1889
Hattori: calls 1089
*** FLOP *** [Jh Tc 3d]
Pluribus: bets 1964
Hattori: calls 1964
*** TURN *** [Jh Tc 3d] [Th]
Pluribus: checks
Hattori: checks
*** RIVER *** [Jh Tc 3d] [Th] [Qd]
Pluribus: checks
Hattori: checks
*** SHOWDOWN ***
Hattori: shows [Ac Qc]
Hattori collected 7856.0 from pot
*** SUMMARY ***
Total pot 7856 | Rake 0
Board [Jh Tc 3d Th Qd]
Seat 3: Pluribus showed [As 4s] and lost
Seat 5: Hattori showed [Ac Qc] and won (7856.0)


PokerStars Hand #42136: Hold'em No Limit (50/100) - 2019/07/11 11:42:16 ET
Table 'Pluribus Session 42' 6-max (Play Money) Seat #6 is the button
Seat 1: MrOrange (10000 in chips)
Seat 2: Pluribus (10000 in chips)
Seat 3: ORen (10000 in chips)
Seat 4: Hattori (10000 in chips)
Seat 5: MrBlue (10000 in chips)
Seat 6: Bill (10000 in chips)
MrOrange: posts small blind 50
Pluribus: posts big blind 100
*** HOLE CARDS ***
Dealt to MrOrange [2h 7d]
Dealt to Pluribus [8h 6s]
Dealt to ORen [Ad Kd]
Dealt to Hattori [6c Ac]
Dealt to MrBlue [6h 2c]
Dealt to Bill [4d Js]
ORen: raises 100 to 200
Hattori: folds
MrBlue: folds
Bill: folds
MrOrange: folds
Pluribus: folds
Uncalled bet (100) returned to ORen
ORen collected 250.0 from pot
*** SUMMARY ***
Total pot 250 | Rake 0


PokerStars Hand #42137: Hold'em No Limit (50/100) - 2019/07/11 11:42:17 ET
Table 'Pluribus Session 42' 6-max (Play Money) Seat #6 is the button
Seat 1: Pluribus (10000 in chips)
Seat 2: ORen (10000 in chips)
Seat 3: Hattori (10000 in chips)
Seat 4: MrBlue (10000 in chips)
Seat 5: Bill (10000 in chips)
Seat 6: MrOrange (10000 in chips)
Pluribus: posts small blind 50
ORen: posts big blind 100
*** HOLE CARDS ***
Dealt to Pluribus [3c Kd]
Dealt to ORen [Kh Td]
Dealt to Hattori [4h 9d]
Dealt to MrBlue [2d 4d]
Dealt to Bill [Js 8c]
Dealt to MrOrange [3s 6d]
Hattori: folds
MrBlue: folds
Bill: folds
MrOrange: folds
Pluribus: folds
Uncalled bet (50) returned to ORen
ORen collected 100.0 from pot
*** SUMMARY ***
Total pot 100 | Rake 0


PokerStars Hand #42138: Hold'em No Limit (50/100) - 2019/07/11 11:42:18 ET
Table 'Pluribus Session 42' 6-max (Play Money) Seat #6 is the button
Seat 1: ORen (10000 in chips)
Seat 2: Hattori (10000 in chips)
Seat 3: MrBlue (10000 in chips)
Seat 4: Bill (10000 in chips)
Seat 5: MrOrange (10000 in chips)
Seat 6: Pluribus (10000 in chips)
ORen: posts small blind 50
Hattori: posts big blind 100
*** HOLE CARDS ***
Dealt to ORen [2h Ad]
Dealt to Hattori [Kh 2d]
Dealt to MrBlue [2s 8c]
Dealt to Bill [2c 9d]
Dealt to MrOrange [Ks 3d]
Dealt to Pluribus [4s Ah]
MrBlue: folds
Bill: folds
MrOrange: folds
Pluribus: raises 150 to 250
ORen: folds
Hattori: folds
Uncalled bet (150) returned to Pluribus
Pluribus collected 250.0 from pot
*** SUMMARY ***
Total pot 250 | Rake 0


PokerStars Hand #42139: Hold'em No Limit (50/100) - 2019/07/11 11:42:19 ET
Table 'Pluribus Session 42' 6-max (Play Money) Seat #6 is the button
Seat 1: Hattori (10000 in chips)
Seat 2: MrBlue (10000 in chips)
Seat 3: Bill (10000 in chips)
Seat 4: MrOrange (10000 in chips)
Seat 5: Pluribus (10000 in chips)
Seat 6: ORen (10000 in chips)
Hattori: posts small blind 50
MrBlue: posts big blind 100
*** HOLE CARDS ***
Dealt to Hattori [4d 8h]
Dealt to MrBlue [7d 7h]
Dealt to Bill [6c 3c]
Dealt to MrOrange [6s Ts]
Dealt to Pluribus [As Td]
Dealt to ORen [Jc 8c]
Bill: folds
MrOrange: folds
Pluribus: raises 100 to 200
ORen: calls 200
Hattori: folds
MrBlue: calls 100
*** FLOP *** [5c Qd 3h]
MrBlue: checks
Pluribus: checks
ORen: bets 225
MrBlue: calls 225
Pluribus: folds
*** TURN *** [5c Qd 3h] [6d]
MrBlue: checks
ORen: checks
*** RIVER *** [5c Qd 3h] [6d] [9c]
MrBlue: checks
ORen: checks
*** SHOWDOWN ***
MrBlue: shows [7d 7h]
MrBlue collected 1100.0 from pot
*** SUMMARY ***
Total pot 1100 | Rake 0
Board [5c Qd 3h 6d 9c]
Seat 2: MrBlue showed [7d 7h] and won (1100.0)
Seat 6: ORen showed [Jc 8c] and lost


PokerStars Hand #42140: Hold'em No Limit (50/100) - 2019/07/11 11:42:20 ET
Table 'Pluribus Session 42' 6-max (Play Money) Seat #6 is the button
Seat 1: MrBlue (10000 in chips)
Seat 2: Bill (10000 in chips)
Seat 3: MrOrange (10000 in chips)
Seat 4: Pluribus (10000 in chips)
Seat 5: ORen (10000 in chips)
Seat 6: Hattori (10000 in chips)
MrBlue: posts small blind 50
Bill: posts big blind 100
*** HOLE CARDS ***
Dealt to MrBlue [2d Kc]
Dealt to Bill [7h Tc]
Dealt to MrOrange [2c 7s]
Dealt to Pluribus [8s 7d]
Dealt to ORen [Qc 5d]
Dealt to Hattori [Kh Ac]
MrOrange: folds
Pluribus: folds
ORen: folds
Hattori: raises 125 to 225
MrBlue: folds
Bill: calls 125
*** FLOP *** [4d 3s Qh]
Bill: checks
Hattori: checks
*** TURN *** [4d 3s Qh] [8h]
Bill: checks
Hattori: checks
*** RIVER *** [4d 3s Qh] [8h] [3h]
Bill: checks
Hattori: checks
*** SHOWDOWN ***
Hattori: shows [Kh Ac]
Hattori collected 500.0 from pot
*** SUMMARY ***
Total pot 500 | Rake 0
Board [4d 3s Qh 8h 3h]
Seat 2: Bill showed [7h Tc] and lost
Seat 6: Hattori showed [Kh Ac] and won (500.0)


PokerStars Hand #42141: Hold'em No Limit (50/100) - 2019/07/11 11:42:21 ET
Table 'Pluribus Session 42' 6-max (Play Money) Seat #6 is the button
Seat 1: Bill (10000 in chips)
Seat 2: MrOrange (10000 in chips)
Seat 3: Pluribus (10000 in chips)
Seat 4: ORen (10000 in chips)
Seat 5: Hattori (10000 in chips)
Seat 6: MrBlue (10000 in chips)
Bill: posts small blind 50
MrOrange: posts big blind 100
*** HOLE CARDS ***
Dealt to Bill [Jd Ac]
Dealt to MrOrange [Td 4h]
Dealt to Pluribus [Kc 6h]
Dealt to ORen [Kd 5h]
Dealt to Hattori [Ks Qd]
Dealt to MrBlue [5d 3h]
Pluribus: folds
ORen: folds
Hattori: raises 111 to 211
MrBlue: folds
Bill: raises 649 to 860
MrOrange: folds
Hattori: folds
Uncalled bet (649) returned to Bill
Bill collected 522.0 from pot
*** SUMMARY ***
Total pot 522 | Rake 0


PokerStars Hand #42142: Hold'em No Limit (50/100) - 2019/07/11 11:42:22 ET
Table 'Pluribus Session 42' 6-max (Play Money) Seat #6 is the button
Seat 1: MrOrange (10000 in chips)
Seat 2: Pluribus (10000 in chips)
Seat 3: ORen (10000 in chips)
Seat 4: Hattori (10000 in chips)
Seat 5: MrBlue (10000 in chips)
Seat 6: Bill (10000 in chips)
MrOrange: posts small blind 50
Pluribus: posts big blind 100
*** HOLE CARDS ***
Dealt to MrOrange [Ad 3h]
Dealt to Pluribus [7h 4s]
Dealt to ORen [7s 8h]
Dealt to Hattori [Tc 9s]
Dealt to MrBlue [2c 7c]
Dealt to Bill [3s Js]
ORen: folds
Hattori: folds
MrBlue: folds
Bill: folds
MrOrange: raises 300 to 400
Pluribus: folds
Uncalled bet (300) returned to MrOrange
MrOrange collected 200.0 from pot
*** SUMMARY ***
Total pot 200 | Rake 0


PokerStars Hand #42143: Hold'em No Limit (50/100) - 2019/07/11 11:42:23 ET
Table 'Pluribus Session 42' 6-max (Play Money) Seat #6 is the button
Seat 1: Pluribus (10000 in chips)
Seat 2: ORen (10000 in chips)
Seat 3: Hattori (10000 in chips)
Seat 4: MrBlue (10000 in chips)
Seat 5: Bill (10000 in chips)
Seat 6: MrOrange (10000 in chips)
Pluribus: posts small blind 50
ORen: posts big blind 100
*** HOLE CARDS ***
Dealt to Pluribus [3h 2c]
Dealt to ORen [Tc 8s]
Dealt to Hattori [5c 3d]
Dealt to MrBlue [9s 7c]
Dealt to Bill [8c 9c]
Dealt to MrOrange [8d Ks]
Hattori: folds
MrBlue: folds
Bill: raises 125 to 225
MrOrange: folds
Pluribus: folds
ORen: calls 125
*** FLOP *** [Qd Qs 6c]
ORen: checks
Bill: bets 150
ORen: raises 375 to 525
Bill: calls 375
*** TURN *** [Qd Qs 6c] [7h]
ORen: bets 1050
Bill: calls 1050
*** RIVER *** [Qd Qs 6c] [7h] [6h]
ORen: checks
Bill: bets 2737
ORen: folds
Uncalled bet (2737) returned to Bill
Bill collected 3650.0 from pot
*** SUMMARY ***
Total pot 3650 | Rake 0
Board [Qd Qs 6c 7h 6h]


PokerStars Hand #42144: Hold'em No Limit (50/100) - 2019/07/11 11:42:24 ET
Table 'Pluribus Session 42' 6-max (Play Money) Seat #6 is the button
Seat 1: ORen (10000 in chips)
Seat 2: Hattori (10000 in chips)
Seat 3: MrBlue (10000 in chips)
Seat 4: Bill (10000 in chips)
Seat 5: MrOrange (10000 in chips)
Seat 6: Pluribus (10000 in chips)
ORen: posts small blind 50
Hattori: posts big blind 100
*** HOLE CARDS ***
Dealt to ORen [6s Jd]
Dealt to Hattori [Tc 8d]
Dealt to MrBlue [7c 3d]
Dealt to Bill [Ks 3h]
Dealt to MrOrange [Th 2h]
Dealt to Pluribus [Qs Qh]
MrBlue: folds
Bill: folds
MrOrange: calls 100
Pluribus: raises 175 to 275
ORen: folds
Hattori: folds
MrOrange: folds
Uncalled bet (175) returned to Pluribus
Pluribus collected 350.0 from pot
*** SUMMARY ***
Total pot 350 | Rake 0


PokerStars Hand #42145: Hold'em No Limit (50/100) - 2019/07/11 11:42:25 ET
Table 'Pluribus Session 42' 6-max (Play Money) Seat #6 is the button
Seat 1: Hattori (10000 in chips)
Seat 2: MrBlue (10000 in chips)
Seat 3: Bill (10000 in chips)
Seat 4: MrOrange (10000 in chips)
Seat 5: Pluribus (10000 in chips)
Seat 6: ORen (10000 in chips)
Hattori: posts small blind 50
MrBlue: posts big blind 100
*** HOLE CARDS ***
Dealt to Hattori [Th 2d]
Dealt to MrBlue [Ah Kc]
Dealt to Bill [Qd Td]
Dealt to MrOrange [Js As]
Dealt to Pluribus [Ts Ks]
Dealt to ORen [3d 2s]
Bill: raises 125 to 225
MrOrange: calls 225
Pluribus: raises 721 to 946
ORen: folds
Hattori: folds
MrBlue: raises 1304 to 2250
Bill: folds
MrOrange: folds
Pluribus: folds
Uncalled bet (1304) returned to MrBlue
MrBlue collected 2392.0 from pot
*** SUMMARY ***
Total pot 2392 | Rake 0


PokerStars Hand #42146: Hold'em No Limit (50/100) - 2019/07/11 11:42:26 ET
Table 'Pluribus Session 42' 6-max (Play Money) Seat #6 is the button
Seat 1: MrBlue (10000 in chips)
Seat 2: Bill (10000 in chips)
Seat 3: MrOrange (10000 in chips)
Seat 4: Pluribus (10000 in chips)
Seat 5: ORen (10000 in chips)
Seat 6: Hattori (10000 in chips)
MrBlue: posts small blind 50
Bill: posts big blind 100
*** HOLE CARDS ***
Dealt to MrBlue [2c 2d]
Dealt to Bill [Qc 7c]
Dealt to MrOrange [5h 6c]
Dealt to Pluribus [Qd Js]
Dealt to ORen [Th 7d]
Dealt to Hattori [Td 4s]
MrOrange: folds
Pluribus: raises 100 to 200
ORen: folds
Hattori: folds
MrBlue: calls 150
Bill: calls 100
*** FLOP *** [4h 9s 3c]
MrBlue: checks
Bill: checks
Pluribus: checks
*** TURN *** [4h 9s 3c] [4d]
MrBlue: checks
Bill: checks
Pluribus: checks
*** RIVER *** [4h 9s 3c] [4d] [4c]
MrBlue: checks
Bill: checks
Pluribus: bets 300
MrBlue: calls 300
Bill: folds
MrBlue collected 1200.0 from pot
*** SUMMARY ***
Total pot 1200 | Rake 0
Board [4h 9s 3c 4d 4c]


PokerStars Hand #42147: Hold'em No Limit (50/100) - 2019/07/11 11:42:27 ET
Table 'Pluribus Session 42' 6-max (Play Money) Seat #6 is the button
Seat 1: Bill (10000 in chips)
Seat 2: MrOrange (10000 in chips)
Seat 3: Pluribus (10000 in chips)
Seat 4: ORen (10000 in chips)
Seat 5: Hattori (10000 in chips)
Seat 6: MrBlue (10000 in chips)
Bill: posts small blind 50
MrOrange: posts big blind 100
*** HOLE CARDS ***
Dealt to Bill [As 3s]
Dealt to MrOrange [2c 2d]
Dealt to Pluribus [Js 9s]
Dealt to ORen [Ac 4d]
Dealt to Hattori [Ad Td]
Dealt to MrBlue [7h 5h]
Pluribus: raises 125 to 225
ORen: folds
Hattori: calls 225
MrBlue: calls 225
Bill: raises 1150 to 1375
MrOrange: folds
Pluribus: folds
Hattori: folds
MrBlue: calls 1150
*** FLOP *** [Tc 3c Jc]
Bill: bets 1100
MrBlue: folds
Uncalled bet (1100) returned to Bill
Bill collected 3300.0 from pot
*** SUMMARY ***
Total pot 3300 | Rake 0
Board [Tc 3c Jc]


PokerStars Hand #42148: Hold'em No Limit (50/100) - 2019/07/11 11:42:28 ET
Table 'Pluribus Session 42' 6-max (Play Money) Seat #6 is the button
Seat 1: MrOrange (10000 in chips)
Seat 2: Pluribus (10000 in chips)
Seat 3: ORen (10000 in chips)
Seat 4: Hattori (10000 in chips)
Seat 5: MrBlue (10000 in chips)
Seat 6: Bill (10000 in chips)
MrOrange: posts small blind 50
Pluribus: posts big blind 100
*** HOLE CARDS ***
Dealt to MrOrange [4c 3d]
Dealt to Pluribus [Qs 6d]
Dealt to ORen [9d Th]
Dealt to Hattori [5h 4d]
Dealt to MrBlue [Qc 2c]
Dealt to Bill [6s 8d]
ORen: folds
Hattori: folds
MrBlue: folds
Bill: folds
MrOrange: folds
Uncalled bet (50) returned to Pluribus
Pluribus collected 100.0 from pot
*** SUMMARY ***
Total pot 100 | Rake 0


PokerStars Hand #42149: Hold'em No Limit (50/100) - 2019/07/11 11:42:29 ET
Table 'Pluribus Session 42' 6-max (Play Money) Seat #6 is the button
Seat 1: Pluribus (10000 in chips)
Seat 2: ORen (10000 in chips)
Seat 3: Hattori (10000 in chips)
Seat 4: MrBlue (10000 in chips)
Seat 5: Bill (10000 in chips)
Seat 6: MrOrange (10000 in chips)
Pluribus: posts small blind 50
ORen: posts big blind 100
*** HOLE CARDS ***
Dealt to Pluribus [8s Kc]
Dealt to ORen [8h Ad]
Dealt to Hattori [Td Qd]
Dealt to MrBlue [Qh 6h]
Dealt to Bill [Ac 2h]
Dealt to MrOrange [9s 5s]
Hattori: raises 100 to 200
MrBlue: folds
Bill: folds
MrOrange: folds
Pluribus: folds
ORen: calls 100
*** FLOP *** [Qs 8d 7d]
ORen: checks
Hattori: bets 112
ORen: calls 112
*** TURN *** [Qs 8d 7d] [6c]
ORen: checks
Hattori: bets 220
ORen: calls 220
*** RIVER *** [Qs 8d 7d] [6c] [3d]
ORen: checks
Hattori: bets 550
ORen: folds
Uncalled bet (550) returned to Hattori
Hattori collected 1114.0 from pot
*** SUMMARY ***
Total pot 1114 | Rake 0
Board [Qs 8d 7d 6c 3d]


PokerStars Hand #42150: Hold'em No Limit (50/100) - 2019/07/11 11:42:30 ET
Table 'Pluribus Session 42' 6-max (Play Money) Seat #6 is the button
Seat 1: ORen (10000 in chips)
Seat 2: Hattori (10000 in chips)
Seat 3: MrBlue (10000 in chips)
Seat 4: Bill (10000 in chips)
Seat 5: MrOrange (10000 in chips)
Seat 6: Pluribus (10000 in chips)
ORen: posts small blind 50
Hattori: posts big blind 100
*** HOLE CARDS ***
Dealt to ORen [3h 4c]
Dealt to Hattori [3s 7s]
Dealt to MrBlue [Kd 4s]
Dealt to Bill [Kc Qd]
Dealt to MrOrange [6s 5d]
Dealt to Pluribus [Jh 7d]
MrBlue: folds
Bill: raises 125 to 225
MrOrange: folds
Pluribus: folds
ORen: folds
Hattori: calls 125
*** FLOP *** [5c Qh 5h]
Hattori: checks
Bill: checks
*** TURN *** [5c Qh 5h] [9h]
Hattori: checks
Bill: bets 250
Hattori: folds
Uncalled bet (250) returned to Bill
Bill collected 500.0 from pot
*** SUMMARY ***
Total pot 500 | Rake 0
Board [5c Qh 5h 9h]


PokerStars Hand #42151: Hold'em No Limit (50/100) - 2019/07/11 11:42:31 ET
Table 'Pluribus Session 42' 6-max (Play Money) Seat #6 is the button
Seat 1: Hattori (10000 in chips)
Seat 2: MrBlue (10000 in chips)
Seat 3: Bill (10000 in chips)
Seat 4: MrOrange (10000 in chips)
Seat 5: Pluribus (10000 in chips)
Seat 6: ORen (10000 in chips)
Hattori: posts small blind 50
MrBlue: posts big blind 100
*** HOLE CARDS ***
Dealt to Hattori [8s 2d]
Dealt to MrBlue [6c Ad]
Dealt to Bill [5d 8h]
Dealt to MrOrange [Ts 4c]
Dealt to Pluribus [6d Tc]
Dealt to ORen [8c Jc]
Bill: folds
MrOrange: folds
Pluribus: folds
ORen: raises 100 to 200
Hattori: folds
MrBlue: calls 100
*** FLOP *** [9h As 3d]
MrBlue: checks
ORen: bets 125
MrBlue: calls 125
*** TURN *** [9h As 3d] [5c]
MrBlue: checks
ORen: checks
*** RIVER *** [9h As 3d] [5c] [2s]
MrBlue: checks
ORen: bets 450
MrBlue: calls 450
*** SHOWDOWN ***
MrBlue: shows [6c Ad]
MrBlue collected 1600.0 from pot
*** SUMMARY ***
Total pot 1600 | Rake 0
Board [9h As 3d 5c 2s]
Seat 2: MrBlue showed [6c Ad] and won (1600.0)
Seat 6: ORen showed [8c Jc] and lost


PokerStars Hand #42152: Hold'em No Limit (50/100) - 2019/07/11 11:42:32 ET
Table 'Pluribus Session 42' 6-max (Play Money) Seat #6 is the button
Seat 1: MrBlue (10000 in chips)
Seat 2: Bill (10000 in chips)
Seat 3: MrOrange (10000 in chips)
Seat 4: Pluribus (10000 in chips)
Seat 5: ORen (10000 in chips)
Seat 6: Hattori (10000 in chips)
MrBlue: posts small blind 50
Bill: posts big blind 100
*** HOLE CARDS ***
Dealt to MrBlue [3d 7d]
Dealt to Bill [Jh 2d]
Dealt to MrOrange [3c 9c]
Dealt to Pluribus [8s 7s]
Dealt to ORen [Ks 4d]
Dealt to Hattori [8h Ad]
MrOrange: folds
Pluribus: raises 150 to 250
ORen: folds
Hattori: folds
MrBlue: folds
Bill: folds
Uncalled bet (150) returned to Pluribus
Pluribus collected 250.0 from pot
*** SUMMARY ***
Total pot 250 | Rake 0


PokerStars Hand #42153: Hold'em No Limit (50/100) - 2019/07/11 11:42:33 ET
Table 'Pluribus Session 42' 6-max (Play Money) Seat #6 is the button
Seat 1: Bill (10000 in chips)
Seat 2: MrOrange (10000 in chips)
Seat 3: Pluribus (10000 in chips)
Seat 4: ORen (10000 in chips)
Seat 5: Hattori (10000 in chips)
Seat 6: MrBlue (10000 in chips)
Bill: posts small blind 50
MrOrange: posts big blind 100
*** HOLE CARDS ***
Dealt to Bill [Tc Jc]
Dealt to MrOrange [9d 9c]
Dealt to Pluribus [6h 3d]
Dealt to ORen [2c Th]
Dealt to Hattori [8d 3s]
Dealt to MrBlue [7h 3h]
Pluribus: folds
ORen: folds
Hattori: folds
MrBlue: folds
Bill: raises 200 to 300
MrOrange: raises 500 to 800
Bill: calls 500
*** FLOP *** [5s Qd 4d]
Bill: checks
MrOrange: checks
*** TURN *** [5s Qd 4d] [Qs]
Bill: bets 550
MrOrange: raises 1025 to 1575
Bill: folds
Uncalled bet (1025) returned to MrOrange
MrOrange collected 2700.0 from pot
*** SUMMARY ***
Total pot 2700 | Rake 0
Board [5s Qd 4d Qs]


PokerStars Hand #42154: Hold'em No Limit (50/100) - 2019/07/11 11:42:34 ET
Table 'Pluribus Session 42' 6-max (Play Money) Seat #6 is the button
Seat 1: MrOrange (10000 in chips)
Seat 2: Pluribus (10000 in chips)
Seat 3: ORen (10000 in chips)
Seat 4: Hattori (10000 in chips)
Seat 5: MrBlue (10000 in chips)
Seat 6: Bill (10000 in chips)
MrOrange: posts small blind 50
Pluribus: posts big blind 100
*** HOLE CARDS ***
Dealt to MrOrange [Qc 7h]
Dealt to Pluribus [6h 5s]
Dealt to ORen [5c 8c]
Dealt to Hattori [8d 6c]
Dealt to MrBlue [Kh 3c]
Dealt to Bill [4d 2d]
ORen: folds
Hattori: folds
MrBlue: folds
Bill: folds
MrOrange: folds
Uncalled bet (50) returned to Pluribus
Pluribus collected 100.0 from pot
*** SUMMARY ***
Total pot 100 | Rake 0


PokerStars Hand #42155: Hold'em No Limit (50/100) - 2019/07/11 11:42:35 ET
Table 'Pluribus Session 42' 6-max (Play Money) Seat #6 is the button
Seat 1: Pluribus (10000 in chips)
Seat 2: ORen (10000 in chips)
Seat 3: Hattori (10000 in chips)
Seat 4: MrBlue (10000 in chips)
Seat 5: Bill (10000 in chips)
Seat 6: MrOrange (10000 in chips)
Pluribus: posts small blind 50
ORen: posts big blind 100
*** HOLE CARDS ***
Dealt to Pluribus [Ad 7d]
Dealt to ORen [Jh 9h]
Dealt to Hattori [6s 7h]
Dealt to MrBlue [Jc 4d]
Dealt to Bill [8h Kc]
Dealt to MrOrange [Th 3d]
Hattori: folds
MrBlue: folds
Bill: folds
MrOrange: folds
Pluribus: raises 150 to 250
ORen: calls 150
*** FLOP *** [4c Qh Qd]
Pluribus: checks
ORen: bets 125
Pluribus: calls 125
*** TURN *** [4c Qh Qd] [3s]
Pluribus: checks
ORen: bets 750
Pluribus: folds
Uncalled bet (750) returned to ORen
ORen collected 750.0 from pot
*** SUMMARY ***
Total pot 750 | Rake 0
Board [4c Qh Qd 3s]


PokerStars Hand #42156: Hold'em No Limit (50/100) - 2019/07/11 11:42:36 ET
Table 'Pluribus Session 42' 6-max (Play Money) Seat #6 is the button
Seat 1: ORen (10000 in chips)
Seat 2: Hattori (10000 in chips)
Seat 3: MrBlue (10000 in chips)
Seat 4: Bill (10000 in chips)
Seat 5: MrOrange (10000 in chips)
Seat 6: Pluribus (10000 in chips)
ORen: posts small blind 50
Hattori: posts big blind 100
*** HOLE CARDS ***
Dealt to ORen [Qd 3s]
Dealt to Hattori [9d 6c]
Dealt to MrBlue [Jd 2d]
Dealt to Bill [Kd As]
Dealt to MrOrange [9s Ks]
Dealt to Pluribus [3h 7h]
MrBlue: folds
Bill: raises 125 to 225
MrOrange: folds
Pluribus: folds
ORen: folds
Hattori: folds
Uncalled bet (125) returned to Bill
Bill collected 250.0 from pot
*** SUMMARY ***
Total pot 250 | Rake 0


PokerStars Hand #42157: Hold'em No Limit (50/100) - 2019/07/11 11:42:37 ET
Table 'Pluribus Session 42' 6-max (Play Money) Seat #6 is the button
Seat 1: Hattori (10000 in chips)
Seat 2: MrBlue (10000 in chips)
Seat 3: Bill (10000 in chips)
Seat 4: MrOrange (10000 in chips)
Seat 5: Pluribus (10000 in chips)
Seat 6: ORen (10000 in chips)
Hattori: posts small blind 50
MrBlue: posts big blind 100
*** HOLE CARDS ***
Dealt to Hattori [Qc Js]
Dealt to MrBlue [3h 9d]
Dealt to Bill [Th Qs]
Dealt to MrOrange [6c 3s]
Dealt to Pluribus [2d Jc]
Dealt to ORen [3d Ad]
Bill: folds
MrOrange: folds
Pluribus: folds
ORen: raises 100 to 200
Hattori: calls 150
MrBlue: folds
*** FLOP *** [6h 5c 8h]
Hattori: checks
ORen: checks
*** TURN *** [6h 5c 8h] [Jd]
Hattori: bets 500
ORen: folds
Uncalled bet (500) returned to Hattori
Hattori collected 500.0 from pot
*** SUMMARY ***
Total pot 500 | Rake 0
Board [6h 5c 8h Jd]


PokerStars Hand #42158: Hold'em No Limit (50/100) - 2019/07/11 11:42:38 ET
Table 'Pluribus Session 42' 6-max (Play Money) Seat #6 is the button
Seat 1: MrBlue (10000 in chips)
Seat 2: Bill (10000 in chips)
Seat 3: MrOrange (10000 in chips)
Seat 4: Pluribus (10000 in chips)
Seat 5: ORen (10000 in chips)
Seat 6: Hattori (10000 in chips)
MrBlue: posts small blind 50
Bill: posts big blind 100
*** HOLE CARDS ***
Dealt to MrBlue [7d 6h]
Dealt to Bill [9d Ah]
Dealt to MrOrange [5c 5d]
Dealt to Pluribus [Td 5h]
Dealt to ORen [Jh 3h]
Dealt to Hattori [5s 2h]
MrOrange: raises 100 to 200
Pluribus: folds
ORen: folds
Hattori: folds
MrBlue: folds
Bill: calls 100
*** FLOP *** [7h Kd As]
Bill: checks
MrOrange: bets 150
Bill: calls 150
*** TURN *** [7h Kd As] [Ad]
Bill: checks
MrOrange: checks
*** RIVER *** [7h Kd As] [Ad] [4s]
Bill: bets 750
MrOrange: folds
Uncalled bet (750) returned to Bill
Bill collected 750.0 from pot
*** SUMMARY ***
Total pot 750 | Rake 0
Board [7h Kd As Ad 4s]


PokerStars Hand #42159: Hold'em No Limit (50/100) - 2019/07/11 11:42:39 ET
Table 'Pluribus Session 42' 6-max (Play Money) Seat #6 is the button
Seat 1: Bill (10000 in chips)
Seat 2: MrOrange (10000 in chips)
Seat 3: Pluribus (10000 in chips)
Seat 4: ORen (10000 in chips)
Seat 5: Hattori (10000 in chips)
Seat 6: MrBlue (10000 in chips)
Bill: posts small blind 50
MrOrange: posts big blind 100
*** HOLE CARDS ***
Dealt to Bill [5d As]
Dealt to MrOrange [Jh Qc]
Dealt to Pluribus [3c 8c]
Dealt to ORen [7c Ad]
Dealt to Hattori [9s Ts]
Dealt to MrBlue [2s 8h]
Pluribus: folds
ORen: folds
Hattori: raises 100 to 200
MrBlue: folds
Bill: folds
MrOrange: calls 100
*** FLOP *** [6s 4h Kd]
MrOrange: checks
Hattori: bets 400
MrOrange: folds
Uncalled bet (400) returned to Hattori
Hattori collected 450.0 from pot
*** SUMMARY ***
Total pot 450 | Rake 0
Board [6s 4h Kd]


PokerStars Hand #42160: Hold'em No Limit (50/100) - 2019/07/11 11:42:40 ET
Table 'Pluribus Session 42' 6-max (Play Money) Seat #6 is the button
Seat 1: MrOrange (10000 in chips)
Seat 2: Pluribus (10000 in chips)
Seat 3: ORen (10000 in chips)
Seat 4: Hattori (10000 in chips)
Seat 5: MrBlue (10000 in chips)
Seat 6: Bill (10000 in chips)
MrOrange: posts small blind 50
Pluribus: posts big blind 100
*** HOLE CARDS ***
Dealt to MrOrange [9h 4h]
Dealt to Pluribus [Kc 6d]
Dealt to ORen [Ac 6h]
Dealt to Hattori [As 7c]
Dealt to MrBlue [Qc Ts]
Dealt to Bill [6c 8d]
ORen: folds
Hattori: folds
MrBlue: raises 125 to 225
Bill: folds
MrOrange: folds
Pluribus: folds
Uncalled bet (125) returned to MrBlue
MrBlue collected 250.0 from pot
*** SUMMARY ***
Total pot 250 | Rake 0


PokerStars Hand #42161: Hold'em No Limit (50/100) - 2019/07/11 11:42:41 ET
Table 'Pluribus Session 42' 6-max (Play Money) Seat #6 is the button
Seat 1: Pluribus (10000 in chips)
Seat 2: ORen (10000 in chips)
Seat 3: Hattori (10000 in chips)
Seat 4: MrBlue (10000 in chips)
Seat 5: Bill (10000 in chips)
Seat 6: MrOrange (10000 in chips)
Pluribus: posts small blind 50
ORen: posts big blind 100
*** HOLE CARDS ***
Dealt to Pluribus [Td 3s]
Dealt to ORen [Jh Ac]
Dealt to Hattori [3c 2d]
Dealt to MrBlue [4c 7h]
Dealt to Bill [Ts Ad]
Dealt to MrOrange [Ks 4s]
Hattori: folds
MrBlue: folds
Bill: raises 125 to 225
MrOrange: folds
Pluribus: folds
ORen: calls 125
*** FLOP *** [5h Qh 9d]
ORen: checks
Bill: checks
*** TURN *** [5h Qh 9d] [5s]
ORen: checks
Bill: checks
*** RIVER *** [5h Qh 9d] [5s] [9s]
ORen: bets 150
Bill: calls 150
*** SHOWDOWN ***
ORen: shows [Jh Ac]
Bill: shows [Ts Ad]
ORen collected 400.0 from pot
Bill collected 400.0 from pot
*** SUMMARY ***
Total pot 800 | Rake 0
Board [5h Qh 9d 5s 9s]
Seat 2: ORen showed [Jh Ac] and won (400.0)
Seat 5: Bill showed [Ts Ad] and won (400.0)


PokerStars Hand #42162: Hold'em No Limit (50/100) - 2019/07/11 11:42:42 ET
Table 'Pluribus Session 42' 6-max (Play Money) Seat #6 is the button
Seat 1: ORen (10000 in chips)
Seat 2: Hattori (10000 in chips)
Seat 3: MrBlue (10000 in chips)
Seat 4: Bill (10000 in chips)
Seat 5: MrOrange (10000 in chips)
Seat 6: Pluribus (10000 in chips)
ORen: posts small blind 50
Hattori: posts big blind 100
*** HOLE CARDS ***
Dealt to ORen [Jh Kh]
Dealt to Hattori [2h 3d]
Dealt to MrBlue [3c 6c]
Dealt to Bill [2d Ts]
Dealt to MrOrange [Qs As]
Dealt to Pluribus [2c Jc]
MrBlue: folds
Bill: folds
MrOrange: raises 100 to 200
Pluribus: folds
ORen: raises 600 to 800
Hattori: folds
MrOrange: calls 600
*** FLOP *** [Ad Tc 9d]
ORen: checks
MrOrange: bets 500
ORen: calls 500
*** TURN *** [Ad Tc 9d] [Th]
ORen: bets 2200
MrOrange: calls 2200
*** RIVER *** [Ad Tc 9d] [Th] [8c]
ORen: bets 6500 and is all-in
MrOrange: folds
Uncalled bet (6500) returned to ORen
ORen collected 7100.0 from pot
*** SUMMARY ***
Total pot 7100 | Rake 0
Board [Ad Tc 9d Th 8c]


PokerStars Hand #42163: Hold'em No Limit (50/100) - 2019/07/11 11:42:43 ET
Table 'Pluribus Session 42' 6-max (Play Money) Seat #6 is the button
Seat 1: Hattori (10000 in chips)
Seat 2: MrBlue (10000 in chips)
Seat 3: Bill (10000 in chips)
Seat 4: MrOrange (10000 in chips)
Seat 5: Pluribus (10000 in chips)
Seat 6: ORen (10000 in chips)
Hattori: posts small blind 50
MrBlue: posts big blind 100
*** HOLE CARDS ***
Dealt to Hattori [7s As]
Dealt to MrBlue [Td 5s]
Dealt to Bill [8d Jc]
Dealt to MrOrange [4h 3c]
Dealt to Pluribus [3d 8s]
Dealt to ORen [7c Qs]
Bill: folds
MrOrange: folds
Pluribus: folds
ORen: folds
Hattori: raises 150 to 250
MrBlue: raises 500 to 750
Hattori: calls 500
*** FLOP *** [4s 6c 7h]
Hattori: checks
MrBlue: bets 1025
Hattori: calls 1025
*** TURN *** [4s 6c 7h] [Kc]
Hattori: checks
MrBlue: bets 2250
Hattori: calls 2250
*** RIVER *** [4s 6c 7h] [Kc] [9d]
Hattori: checks
MrBlue: bets 5975 and is all-in
Hattori: folds
Uncalled bet (5975) returned to MrBlue
MrBlue collected 8050.0 from pot
*** SUMMARY ***
Total pot 8050 | Rake 0
Board [4s 6c 7h Kc 9d]


PokerStars Hand #42164: Hold'em No Limit (50/100) - 2019/07/11 11:42:44 ET
Table 'Pluribus Session 42' 6-max (Play Money) Seat #6 is the button
Seat 1: MrBlue (10000 in chips)
Seat 2: Bill (10000 in chips)
Seat 3: MrOrange (10000 in chips)
Seat 4: Pluribus (10000 in chips)
Seat 5: ORen (10000 in chips)
Seat 6: Hattori (10000 in chips)
MrBlue: posts small blind 50
Bill: posts big blind 100
*** HOLE CARDS ***
Dealt to MrBlue [3c Ad]
Dealt to Bill [Qd 2c]
Dealt to MrOrange [8h Kh]
Dealt to Pluribus [7h 6h]
Dealt to ORen [8c 5d]
Dealt to Hattori [Ah Js]
MrOrange: raises 100 to 200
Pluribus: raises 481 to 681
ORen: folds
Hattori: folds
MrBlue: folds
Bill: folds
MrOrange: calls 481
*** FLOP *** [8s Tc 4d]
MrOrange: checks
Pluribus: bets 756
MrOrange: calls 756
*** TURN *** [8s Tc 4d] [Qs]
MrOrange: checks
Pluribus: checks
*** RIVER *** [8s Tc 4d] [Qs] [4h]
MrOrange: bets 100
Pluribus: folds
Uncalled bet (100) returned to MrOrange
MrOrange collected 3024.0 from pot
*** SUMMARY ***
Total pot 3024 | Rake 0
Board [8s Tc 4d Qs 4h]


PokerStars Hand #42165: Hold'em No Limit (50/100) - 2019/07/11 11:42:45 ET
Table 'Pluribus Session 42' 6-max (Play Money) Seat #6 is the button
Seat 1: Bill (10000 in chips)
Seat 2: MrOrange (10000 in chips)
Seat 3: Pluribus (10000 in chips)
Seat 4: ORen (10000 in chips)
Seat 5: Hattori (10000 in chips)
Seat 6: MrBlue (10000 in chips)
Bill: posts small blind 50
MrOrange: posts big blind 100
*** HOLE CARDS ***
Dealt to Bill [Ah Qh]
Dealt to MrOrange [7s 5h]
Dealt to Pluribus [6s Kd]
Dealt to ORen [8c 2s]
Dealt to Hattori [Qd As]
Dealt to MrBlue [Ts 3s]
Pluribus: folds
ORen: folds
Hattori: raises 100 to 200
MrBlue: folds
Bill: raises 650 to 850
MrOrange: folds
Hattori: calls 650
*** FLOP *** [8s 8d 3h]
Bill: bets 450
Hattori: calls 450
*** TURN *** [8s 8d 3h] [5c]
Bill: checks
Hattori: checks
*** RIVER *** [8s 8d 3h] [5c] [Qc]
Bill: bets 2700
Hattori: raises 6000 to 8700 and is all-in
Bill: folds
Uncalled bet (6000) returned to Hattori
Hattori collected 8100.0 from pot
*** SUMMARY ***
Total pot 8100 | Rake 0
Board [8s 8d 3h 5c Qc]


PokerStars Hand #42166: Hold'em No Limit (50/100) - 2019/07/11 11:42:46 ET
Table 'Pluribus Session 42' 6-max (Play Money) Seat #6 is the button
Seat 1: MrOrange (10000 in chips)
Seat 2: Pluribus (10000 in chips)
Seat 3: ORen (10000 in chips)
Seat 4: Hattori (10000 in chips)
Seat 5: MrBlue (10000 in chips)
Seat 6: Bill (10000 in chips)
MrOrange: posts small blind 50
Pluribus: posts big blind 100
*** HOLE CARDS ***
Dealt to MrOrange [Ac Qd]
Dealt to Pluribus [8s 7s]
Dealt to ORen [6d 3c]
Dealt to Hattori [Th Js]
Dealt to MrBlue [7h 6h]
Dealt to Bill [3s 2h]
ORen: folds
Hattori: folds
MrBlue: raises 125 to 225
Bill: folds
MrOrange: raises 875 to 1100
Pluribus: folds
MrBlue: calls 875
*** FLOP *** [Jd 2s Kh]
MrOrange: bets 750
MrBlue: folds
Uncalled bet (750) returned to MrOrange
MrOrange collected 2300.0 from pot
*** SUMMARY ***
Total pot 2300 | Rake 0
Board [Jd 2s Kh]


PokerStars Hand #42167: Hold'em No Limit (50/100) - 2019/07/11 11:42:47 ET
Table 'Pluribus Session 42' 6-max (Play Money) Seat #6 is the button
Seat 1: Pluribus (10000 in chips)
Seat 2: ORen (10000 in chips)
Seat 3: Hattori (10000 in chips)
Seat 4: MrBlue (10000 in chips)
Seat 5: Bill (10000 in chips)
Seat 6: MrOrange (10000 in chips)
Pluribus: posts small blind 50
ORen: posts big blind 100
*** HOLE CARDS ***
Dealt to Pluribus [3d 8h]
Dealt to ORen [2h 9c]
Dealt to Hattori [4c 3h]
Dealt to MrBlue [5c Qd]
Dealt to Bill [8d Ad]
Dealt to MrOrange [9s Td]
Hattori: folds
MrBlue: folds
Bill: raises 125 to 225
MrOrange: folds
Pluribus: folds
ORen: folds
Uncalled bet (125) returned to Bill
Bill collected 250.0 from pot
*** SUMMARY ***
Total pot 250 | Rake 0


PokerStars Hand #42168: Hold'em No Limit (50/100) - 2019/07/11 11:42:48 ET
Table 'Pluribus Session 42' 6-max (Play Money) Seat #6 is the button
Seat 1: ORen (10000 in chips)
Seat 2: Hattori (10000 in chips)
Seat 3: MrBlue (10000 in chips)
Seat 4: Bill (10000 in chips)
Seat 5: MrOrange (10000 in chips)
Seat 6: Pluribus (10000 in chips)
ORen: posts small blind 50
Hattori: posts big blind 100
*** HOLE CARDS ***
Dealt to ORen [Ad Th]
Dealt to Hattori [9s Td]
Dealt to MrBlue [Qs 5h]
Dealt to Bill [7d 9c]
Dealt to MrOrange [7c Ks]
Dealt to Pluribus [9h 8s]
MrBlue: folds
Bill: folds
MrOrange: folds
Pluribus: raises 125 to 225
ORen: calls 175
Hattori: calls 125
*** FLOP *** [3h 6c 2d]
ORen: checks
Hattori: checks
Pluribus: checks
*** TURN *** [3h 6c 2d] [2h]
ORen: checks
Hattori: checks
Pluribus: checks
*** RIVER *** [3h 6c 2d] [2h] [Tc]
ORen: bets 800
Hattori: folds
Pluribus: folds
Uncalled bet (800) returned to ORen
ORen collected 675.0 from pot
*** SUMMARY ***
Total pot 675 | Rake 0
Board [3h 6c 2d 2h Tc]


PokerStars Hand #42169: Hold'em No Limit (50/100) - 2019/07/11 11:42:49 ET
Table 'Pluribus Session 42' 6-max (Play Money) Seat #6 is the button
Seat 1: Hattori (10000 in chips)
Seat 2: MrBlue (10000 in chips)
Seat 3: Bill (10000 in chips)
Seat 4: MrOrange (10000 in chips)
Seat 5: Pluribus (10000 in chips)
Seat 6: ORen (10000 in chips)
Hattori: posts small blind 50
MrBlue: posts big blind 100
*** HOLE CARDS ***
Dealt to Hattori [Jh 7s]
Dealt to MrBlue [7h Js]
Dealt to Bill [Kc Qd]
Dealt to MrOrange [6s Th]
Dealt to Pluribus [5d 3s]
Dealt to ORen [6c 3h]
Bill: raises 125 to 225
MrOrange: folds
Pluribus: folds
ORen: folds
Hattori: folds
MrBlue: calls 125
*** FLOP *** [9d 2h 2d]
MrBlue: checks
Bill: bets 150
MrBlue: folds
Uncalled bet (150) returned to Bill
Bill collected 500.0 from pot
*** SUMMARY ***
Total pot 500 | Rake 0
Board [9d 2h 2d]


PokerStars Hand #42170: Hold'em No Limit (50/100) - 2019/07/11 11:42:50 ET
Table 'Pluribus Session 42' 6-max (Play Money) Seat #6 is the button
Seat 1: MrBlue (10000 in chips)
Seat 2: Bill (10000 in chips)
Seat 3: MrOrange (10000 in chips)
Seat 4: Pluribus (10000 in chips)
Seat 5: ORen (10000 in chips)
Seat 6: Hattori (10000 in chips)
MrBlue: posts small blind 50
Bill: posts big blind 100
*** HOLE CARDS ***
Dealt to MrBlue [7c 5d]
Dealt to Bill [6s Ah]
Dealt to MrOrange [Jd 9s]
Dealt to Pluribus [7h 8h]
Dealt to ORen [4s 3d]
Dealt to Hattori [8d Qd]
MrOrange: folds
Pluribus: raises 100 to 200
ORen: folds
Hattori: folds
MrBlue: folds
Bill: calls 100
*** FLOP *** [2c Kh 8s]
Bill: checks
Pluribus: bets 225
Bill: folds
Uncalled bet (225) returned to Pluribus
Pluribus collected 450.0 from pot
*** SUMMARY ***
Total pot 450 | Rake 0
Board [2c Kh 8s]


PokerStars Hand #42171: Hold'em No Limit (50/100) - 2019/07/11 11:42:51 ET
Table 'Pluribus Session 42' 6-max (Play Money) Seat #6 is the button
Seat 1: Bill (10000 in chips)
Seat 2: MrOrange (10000 in chips)
Seat 3: Pluribus (10000 in chips)
Seat 4: ORen (10000 in chips)
Seat 5: Hattori (10000 in chips)
Seat 6: MrBlue (10000 in chips)
Bill: posts small blind 50
MrOrange: posts big blind 100
*** HOLE CARDS ***
Dealt to Bill [8h Ah]
Dealt to MrOrange [9d 3d]
Dealt to Pluribus [Tc 2d]
Dealt to ORen [6s Ts]
Dealt to Hattori [3s 7d]
Dealt to MrBlue [4h 7h]
Pluribus: folds
ORen: folds
Hattori: folds
MrBlue: raises 125 to 225
Bill: raises 725 to 950
MrOrange: folds
MrBlue: calls 725
*** FLOP *** [7c 5h 2s]
Bill: bets 1000
MrBlue: calls 1000
*** TURN *** [7c 5h 2s] [2c]
Bill: checks
MrBlue: bets 2000
Bill: folds
Uncalled bet (2000) returned to MrBlue
MrBlue collected 4000.0 from pot
*** SUMMARY ***
Total pot 4000 | Rake 0
Board [7c 5h 2s 2c]


PokerStars Hand #42172: Hold'em No Limit (50/100) - 2019/07/11 11:42:52 ET
Table 'Pluribus Session 42' 6-max (Play Money) Seat #6 is the button
Seat 1: MrOrange (10000 in chips)
Seat 2: Pluribus (10000 in chips)
Seat 3: ORen (10000 in chips)
Seat 4: Hattori (10000 in chips)
Seat 5: MrBlue (10000 in chips)
Seat 6: Bill (10000 in chips)
MrOrange: posts small blind 50
Pluribus: posts big blind 100
*** HOLE CARDS ***
Dealt to MrOrange [5h Ac]
Dealt to Pluribus [4s Ks]
Dealt to ORen [6d 8c]
Dealt to Hattori [9h 2d]
Dealt to MrBlue [8h Th]
Dealt to Bill [6h 4h]
ORen: folds
Hattori: folds
MrBlue: raises 125 to 225
Bill: folds
MrOrange: folds
Pluribus: calls 125
*** FLOP *** [Qd 3h Jd]
Pluribus: checks
MrBlue: checks
*** TURN *** [Qd 3h Jd] [5c]
Pluribus: checks
MrBlue: checks
*** RIVER *** [Qd 3h Jd] [5c] [2c]
Pluribus: bets 500
MrBlue: folds
Uncalled bet (500) returned to Pluribus
Pluribus collected 500.0 from pot
*** SUMMARY ***
Total pot 500 | Rake 0
Board [Qd 3h Jd 5c 2c]


PokerStars Hand #42173: Hold'em No Limit (50/100) - 2019/07/11 11:42:53 ET
Table 'Pluribus Session 42' 6-max (Play Money) Seat #6 is the button
Seat 1: Pluribus (10000 in chips)
Seat 2: ORen (10000 in chips)
Seat 3: Hattori (10000 in chips)
Seat 4: MrBlue (10000 in chips)
Seat 5: Bill (10000 in chips)
Seat 6: MrOrange (10000 in chips)
Pluribus: posts small blind 50
ORen: posts big blind 100
*** HOLE CARDS ***
Dealt to Pluribus [Jd Ad]
Dealt to ORen [8h 4h]
Dealt to Hattori [9h 2d]
Dealt to MrBlue [Jc 6d]
Dealt to Bill [2s 9d]
Dealt to MrOrange [5d 3d]
Hattori: folds
MrBlue: folds
Bill: folds
MrOrange: raises 100 to 200
Pluribus: calls 150
ORen: folds
*** FLOP *** [Ts 9c 7d]
Pluribus: checks
MrOrange: checks
*** TURN *** [Ts 9c 7d] [Qd]
Pluribus: bets 500
MrOrange: calls 500
*** RIVER *** [Ts 9c 7d] [Qd] [Qc]
Pluribus: checks
MrOrange: bets 555
Pluribus: folds
Uncalled bet (555) returned to MrOrange
MrOrange collected 1500.0 from pot
*** SUMMARY ***
Total pot 1500 | Rake 0
Board [Ts 9c 7d Qd Qc]


PokerStars Hand #42174: Hold'em No Limit (50/100) - 2019/07/11 11:42:54 ET
Table 'Pluribus Session 42' 6-max (Play Money) Seat #6 is the button
Seat 1: ORen (10000 in chips)
Seat 2: Hattori (10000 in chips)
Seat 3: MrBlue (10000 in chips)
Seat 4: Bill (10000 in chips)
Seat 5: MrOrange (10000 in chips)
Seat 6: Pluribus (10000 in chips)
ORen: posts small blind 50
Hattori: posts big blind 100
*** HOLE CARDS ***
Dealt to ORen [7d 3c]
Dealt to Hattori [Qc 6c]
Dealt to MrBlue [Qd 2d]
Dealt to Bill [Kc 4h]
Dealt to MrOrange [Qh 6d]
Dealt to Pluribus [3d 8c]
MrBlue: folds
Bill: folds
MrOrange: folds
Pluribus: folds
ORen: folds
Uncalled bet (50) returned to Hattori
Hattori collected 100.0 from pot
*** SUMMARY ***
Total pot 100 | Rake 0


PokerStars Hand #42175: Hold'em No Limit (50/100) - 2019/07/11 11:42:55 ET
Table 'Pluribus Session 42' 6-max (Play Money) Seat #6 is the button
Seat 1: Hattori (10000 in chips)
Seat 2: MrBlue (10000 in chips)
Seat 3: Bill (10000 in chips)
Seat 4: MrOrange (10000 in chips)
Seat 5: Pluribus (10000 in chips)
Seat 6: ORen (10000 in chips)
Hattori: posts small blind 50
MrBlue: posts big blind 100
*** HOLE CARDS ***
Dealt to Hattori [3d Jc]
Dealt to MrBlue [6h Qc]
Dealt to Bill [8h 7s]
Dealt to MrOrange [8s Qs]
Dealt to Pluribus [7d 6s]
Dealt to ORen [Jh 6c]
Bill: folds
MrOrange: raises 100 to 200
Pluribus: folds
ORen: folds
Hattori: folds
MrBlue: calls 100
*** FLOP *** [2h As 4s]
MrBlue: checks
MrOrange: bets 150
MrBlue: folds
Uncalled bet (150) returned to MrOrange
MrOrange collected 450.0 from pot
*** SUMMARY ***
Total pot 450 | Rake 0
Board [2h As 4s]


PokerStars Hand #42176: Hold'em No Limit (50/100) - 2019/07/11 11:42:56 ET
Table 'Pluribus Session 42' 6-max (Play Money) Seat #6 is the button
Seat 1: MrBlue (10000 in chips)
Seat 2: Bill (10000 in chips)
Seat 3: MrOrange (10000 in chips)
Seat 4: Pluribus (10000 in chips)
Seat 5: ORen (10000 in chips)
Seat 6: Hattori (10000 in chips)
MrBlue: posts small blind 50
Bill: posts big blind 100
*** HOLE CARDS ***
Dealt to MrBlue [3c Ad]
Dealt to Bill [9c Kc]
Dealt to MrOrange [4c 9h]
Dealt to Pluribus [3h Kh]
Dealt to ORen [Qd 4h]
Dealt to Hattori [Jh Ts]
MrOrange: folds
Pluribus: folds
ORen: folds
Hattori: raises 125 to 225
MrBlue: folds
Bill: calls 125
*** FLOP *** [5s 6h 6s]
Bill: checks
Hattori: checks
*** TURN *** [5s 6h 6s] [Th]
Bill: checks
Hattori: bets 200
Bill: folds
Uncalled bet (200) returned to Hattori
Hattori collected 500.0 from pot
*** SUMMARY ***
Total pot 500 | Rake 0
Board [5s 6h 6s Th]


PokerStars Hand #42177: Hold'em No Limit (50/100) - 2019/07/11 11:42:57 ET
Table 'Pluribus Session 42' 6-max (Play Money) Seat #6 is the button
Seat 1: Bill (10000 in chips)
Seat 2: MrOrange (10000 in chips)
Seat 3: Pluribus (10000 in chips)
Seat 4: ORen (10000 in chips)
Seat 5: Hattori (10000 in chips)
Seat 6: MrBlue (10000 in chips)
Bill: posts small blind 50
MrOrange: posts big blind 100
*** HOLE CARDS ***
Dealt to Bill [9d 9c]
Dealt to MrOrange [9h 7s]
Dealt to Pluribus [3d Kh]
Dealt to ORen [8s 6c]
Dealt to Hattori [Ah 8d]
Dealt to MrBlue [2h 6d]
Pluribus: folds
ORen: folds
Hattori: raises 100 to 200
MrBlue: folds
Bill: raises 650 to 850
MrOrange: folds
Hattori: folds
Uncalled bet (650) returned to Bill
Bill collected 500.0 from pot
*** SUMMARY ***
Total pot 500 | Rake 0


PokerStars Hand #42178: Hold'em No Limit (50/100) - 2019/07/11 11:42:58 ET
Table 'Pluribus Session 42' 6-max (Play Money) Seat #6 is the button
Seat 1: MrOrange (10000 in chips)
Seat 2: Pluribus (10000 in chips)
Seat 3: ORen (10000 in chips)
Seat 4: Hattori (10000 in chips)
Seat 5: MrBlue (10000 in chips)
Seat 6: Bill (10000 in chips)
MrOrange: posts small blind 50
Pluribus: posts big blind 100
*** HOLE CARDS ***
Dealt to MrOrange [Kd 5c]
Dealt to Pluribus [6c 8s]
Dealt to ORen [Jd Kh]
Dealt to Hattori [Ts Jh]
Dealt to MrBlue [2s Qs]
Dealt to Bill [Ah 7d]
ORen: folds
Hattori: folds
MrBlue: folds
Bill: raises 150 to 250
MrOrange: folds
Pluribus: folds
Uncalled bet (150) returned to Bill
Bill collected 250.0 from pot
*** SUMMARY ***
Total pot 250 | Rake 0


PokerStars Hand #42179: Hold'em No Limit (50/100) - 2019/07/11 11:42:59 ET
Table 'Pluribus Session 42' 6-max (Play Money) Seat #6 is the button
Seat 1: Pluribus (10000 in chips)
Seat 2: ORen (10000 in chips)
Seat 3: Hattori (10000 in chips)
Seat 4: MrBlue (10000 in chips)
Seat 5: Bill (10000 in chips)
Seat 6: MrOrange (10000 in chips)
Pluribus: posts small blind 50
ORen: posts big blind 100
*** HOLE CARDS ***
Dealt to Pluribus [9d Kh]
Dealt to ORen [2c 4d]
Dealt to Hattori [2d Th]
Dealt to MrBlue [9c Jc]
Dealt to Bill [Kd 7h]
Dealt to MrOrange [8s 3d]
Hattori: folds
MrBlue: raises 125 to 225
Bill: folds
MrOrange: folds
Pluribus: folds
ORen: folds
Uncalled bet (125) returned to MrBlue
MrBlue collected 250.0 from pot
*** SUMMARY ***
Total pot 250 | Rake 0


PokerStars Hand #42180: Hold'em No Limit (50/100) - 2019/07/11 11:43:00 ET
Table 'Pluribus Session 42' 6-max (Play Money) Seat #6 is the button
Seat 1: ORen (10000 in chips)
Seat 2: Hattori (10000 in chips)
Seat 3: MrBlue (10000 in chips)
Seat 4: Bill (10000 in chips)
Seat 5: MrOrange (10000 in chips)
Seat 6: Pluribus (10000 in chips)
ORen: posts small blind 50
Hattori: posts big blind 100
*** HOLE CARDS ***
Dealt to ORen [5c Ks]
Dealt to Hattori [8d 7h]
Dealt to MrBlue [9h 3h]
Dealt to Bill [Ac 4s]
Dealt to MrOrange [Js As]
Dealt to Pluribus [3d 9s]
MrBlue: folds
Bill: folds
MrOrange: raises 100 to 200
Pluribus: folds
ORen: folds
Hattori: calls 100
*** FLOP *** [7d 2c 9d]
Hattori: checks
MrOrange: checks
*** TURN *** [7d 2c 9d] [Ts]
Hattori: checks
MrOrange: checks
*** RIVER *** [7d 2c 9d] [Ts] [Td]
Hattori: bets 150
MrOrange: calls 150
*** SHOWDOWN ***
Hattori: shows [8d 7h]
Hattori collected 750.0 from pot
*** SUMMARY ***
Total pot 750 | Rake 0
Board [7d 2c 9d Ts Td]
Seat 2: Hattori showed [8d 7h] and won (750.0)
Seat 5: MrOrange showed [Js As] and lost


PokerStars Hand #42181: Hold'em No Limit (50/100) - 2019/07/11 11:43:01 ET
Table 'Pluribus Session 42' 6-max (Play Money) Seat #6 is the button
Seat 1: Hattori (10000 in chips)
Seat 2: MrBlue (10000 in chips)
Seat 3: Bill (10000 in chips)
Seat 4: MrOrange (10000 in chips)
Seat 5: Pluribus (10000 in chips)
Seat 6: ORen (10000 in chips)
Hattori: posts small blind 50
MrBlue: posts big blind 100
*** HOLE CARDS ***
Dealt to Hattori [Qc 8c]
Dealt to MrBlue [4c 6c]
Dealt to Bill [6h Tc]
Dealt to MrOrange [4h 7d]
Dealt to Pluribus [2c Ah]
Dealt to ORen [Jh 3d]
Bill: folds
MrOrange: folds
Pluribus: folds
ORen: folds
Hattori: calls 50
MrBlue: checks
*** FLOP *** [Kc 3h Jc]
Hattori: bets 100
MrBlue: calls 100
*** TURN *** [Kc 3h Jc] [Td]
Hattori: bets 600
MrBlue: folds
Uncalled bet (600) returned to Hattori
Hattori collected 400.0 from pot
*** SUMMARY ***
Total pot 400 | Rake 0
Board [Kc 3h Jc Td]


PokerStars Hand #42182: Hold'em No Limit (50/100) - 2019/07/11 11:43:02 ET
Table 'Pluribus Session 42' 6-max (Play Money) Seat #6 is the button
Seat 1: MrBlue (10000 in chips)
Seat 2: Bill (10000 in chips)
Seat 3: MrOrange (10000 in chips)
Seat 4: Pluribus (10000 in chips)
Seat 5: ORen (10000 in chips)
Seat 6: Hattori (10000 in chips)
MrBlue: posts small blind 50
Bill: posts big blind 100
*** HOLE CARDS ***
Dealt to MrBlue [7s Qs]
Dealt to Bill [4d 2h]
Dealt to MrOrange [Jc 3c]
Dealt to Pluribus [Js Kh]
Dealt to ORen [3d 2s]
Dealt to Hattori [Ks Kc]
MrOrange: folds
Pluribus: raises 100 to 200
ORen: folds
Hattori: raises 570 to 770
MrBlue: folds
Bill: folds
Pluribus: folds
Uncalled bet (570) returned to Hattori
Hattori collected 550.0 from pot
*** SUMMARY ***
Total pot 550 | Rake 0


PokerStars Hand #42183: Hold'em No Limit (50/100) - 2019/07/11 11:43:03 ET
Table 'Pluribus Session 42' 6-max (Play Money) Seat #6 is the button
Seat 1: Bill (10000 in chips)
Seat 2: MrOrange (10000 in chips)
Seat 3: Pluribus (10000 in chips)
Seat 4: ORen (10000 in chips)
Seat 5: Hattori (10000 in chips)
Seat 6: MrBlue (10000 in chips)
Bill: posts small blind 50
MrOrange: posts big blind 100
*** HOLE CARDS ***
Dealt to Bill [Ah 4h]
Dealt to MrOrange [7h Ks]
Dealt to Pluribus [Kd 9c]
Dealt to ORen [7c Qd]
Dealt to Hattori [6s Ts]
Dealt to MrBlue [5s Jh]
Pluribus: folds
ORen: folds
Hattori: folds
MrBlue: folds
Bill: raises 200 to 300
MrOrange: calls 200
*** FLOP *** [2h 4d Td]
Bill: bets 300
MrOrange: folds
Uncalled bet (300) returned to Bill
Bill collected 600.0 from pot
*** SUMMARY ***
Total pot 600 | Rake 0
Board [2h 4d Td]


PokerStars Hand #42184: Hold'em No Limit (50/100) - 2019/07/11 11:43:04 ET
Table 'Pluribus Session 42' 6-max (Play Money) Seat #6 is the button
Seat 1: MrOrange (10000 in chips)
Seat 2: Pluribus (10000 in chips)
Seat 3: ORen (10000 in chips)
Seat 4: Hattori (10000 in chips)
Seat 5: MrBlue (10000 in chips)
Seat 6: Bill (10000 in chips)
MrOrange: posts small blind 50
Pluribus: posts big blind 100
*** HOLE CARDS ***
Dealt to MrOrange [3d Ad]
Dealt to Pluribus [Ts Kc]
Dealt to ORen [Ks 9h]
Dealt to Hattori [5h 7h]
Dealt to MrBlue [Qd 5d]
Dealt to Bill [Qc 6c]
ORen: folds
Hattori: folds
MrBlue: raises 125 to 225
Bill: folds
MrOrange: raises 875 to 1100
Pluribus: folds
MrBlue: folds
Uncalled bet (875) returned to MrOrange
MrOrange collected 550.0 from pot
*** SUMMARY ***
Total pot 550 | Rake 0


PokerStars Hand #42185: Hold'em No Limit (50/100) - 2019/07/11 11:43:05 ET
Table 'Pluribus Session 42' 6-max (Play Money) Seat #6 is the button
Seat 1: Pluribus (10000 in chips)
Seat 2: ORen (10000 in chips)
Seat 3: Hattori (10000 in chips)
Seat 4: MrBlue (10000 in chips)
Seat 5: Bill (10000 in chips)
Seat 6: MrOrange (10000 in chips)
Pluribus: posts small blind 50
ORen: posts big blind 100
*** HOLE CARDS ***
Dealt to Pluribus [Jh Qd]
Dealt to ORen [9d Qs]
Dealt to Hattori [Js Ah]
Dealt to MrBlue [As 5h]
Dealt to Bill [6c 6s]
Dealt to MrOrange [4c 2d]
Hattori: raises 100 to 200
MrBlue: folds
Bill: folds
MrOrange: folds
Pluribus: folds
ORen: calls 100
*** FLOP *** [Jd Ad 5s]
ORen: checks
Hattori: bets 400
ORen: folds
Uncalled bet (400) returned to Hattori
Hattori collected 450.0 from pot
*** SUMMARY ***
Total pot 450 | Rake 0
Board [Jd Ad 5s]


PokerStars Hand #42186: Hold'em No Limit (50/100) - 2019/07/11 11:43:06 ET
Table 'Pluribus Session 42' 6-max (Play Money) Seat #6 is the button
Seat 1: ORen (10000 in chips)
Seat 2: Hattori (10000 in chips)
Seat 3: MrBlue (10000 in chips)
Seat 4: Bill (10000 in chips)
Seat 5: MrOrange (10000 in chips)
Seat 6: Pluribus (10000 in chips)
ORen: posts small blind 50
Hattori: posts big blind 100
*** HOLE CARDS ***
Dealt to ORen [4s Kd]
Dealt to Hattori [7s 3c]
Dealt to MrBlue [5h 3h]
Dealt to Bill [7c 6c]
Dealt to MrOrange [2h 9c]
Dealt to Pluribus [Qh 6d]
MrBlue: folds
Bill: raises 125 to 225
MrOrange: folds
Pluribus: folds
ORen: folds
Hattori: folds
Uncalled bet (125) returned to Bill
Bill collected 250.0 from pot
*** SUMMARY ***
Total pot 250 | Rake 0


PokerStars Hand #42187: Hold'em No Limit (50/100) - 2019/07/11 11:43:07 ET
Table 'Pluribus Session 42' 6-max (Play Money) Seat #6 is the button
Seat 1: Hattori (10000 in chips)
Seat 2: MrBlue (10000 in chips)
Seat 3: Bill (10000 in chips)
Seat 4: MrOrange (10000 in chips)
Seat 5: Pluribus (10000 in chips)
Seat 6: ORen (10000 in chips)
Hattori: posts small blind 50
MrBlue: posts big blind 100
*** HOLE CARDS ***
Dealt to Hattori [9d Qs]
Dealt to MrBlue [2c 6h]
Dealt to Bill [9c 3d]
Dealt to MrOrange [7c 6s]
Dealt to Pluribus [4d Js]
Dealt to ORen [3c 8d]
Bill: folds
MrOrange: folds
Pluribus: folds
ORen: folds
Hattori: raises 150 to 250
MrBlue: raises 500 to 750
Hattori: folds
Uncalled bet (500) returned to MrBlue
MrBlue collected 500.0 from pot
*** SUMMARY ***
Total pot 500 | Rake 0


PokerStars Hand #42188: Hold'em No Limit (50/100) - 2019/07/11 11:43:08 ET
Table 'Pluribus Session 42' 6-max (Play Money) Seat #6 is the button
Seat 1: MrBlue (10000 in chips)
Seat 2: Bill (10000 in chips)
Seat 3: MrOrange (10000 in chips)
Seat 4: Pluribus (10000 in chips)
Seat 5: ORen (10000 in chips)
Seat 6: Hattori (10000 in chips)
MrBlue: posts small blind 50
Bill: posts big blind 100
*** HOLE CARDS ***
Dealt to MrBlue [6s Ac]
Dealt to Bill [7s 7d]
Dealt to MrOrange [Js 8d]
Dealt to Pluribus [9c Ks]
Dealt to ORen [Jd 8c]
Dealt to Hattori [6h Kc]
MrOrange: folds
Pluribus: folds
ORen: folds
Hattori: folds
MrBlue: calls 50
Bill: raises 250 to 350
MrBlue: calls 250
*** FLOP *** [5c 7c 8h]
MrBlue: checks
Bill: bets 525
MrBlue: calls 525
*** TURN *** [5c 7c 8h] [9h]
MrBlue: checks
Bill: bets 875
MrBlue: calls 875
*** RIVER *** [5c 7c 8h] [9h] [6d]
MrBlue: checks
Bill: checks
*** SHOWDOWN ***
MrBlue collected 1750.0 from pot
Bill collected 1750.0 from pot
*** SUMMARY ***
Total pot 3500 | Rake 0
Board [5c 7c 8h 9h 6d]
Seat 1: MrBlue showed [6s Ac] and lost
Seat 2: Bill showed [7s 7d] and lost


PokerStars Hand #42189: Hold'em No Limit (50/100) - 2019/07/11 11:43:09 ET
Table 'Pluribus Session 42' 6-max (Play Money) Seat #6 is the button
Seat 1: Bill (10000 in chips)
Seat 2: MrOrange (10000 in chips)
Seat 3: Pluribus (10000 in chips)
Seat 4: ORen (10000 in chips)
Seat 5: Hattori (10000 in chips)
Seat 6: MrBlue (10000 in chips)
Bill: posts small blind 50
MrOrange: posts big blind 100
*** HOLE CARDS ***
Dealt to Bill [7h 8d]
Dealt to MrOrange [2d 3h]
Dealt to Pluribus [4d Kh]
Dealt to ORen [3c 6h]
Dealt to Hattori [Kc Ts]
Dealt to MrBlue [Th 6c]
Pluribus: folds
ORen: folds
Hattori: raises 100 to 200
MrBlue: folds
Bill: folds
MrOrange: folds
Uncalled bet (100) returned to Hattori
Hattori collected 250.0 from pot
*** SUMMARY ***
Total pot 250 | Rake 0


PokerStars Hand #42190: Hold'em No Limit (50/100) - 2019/07/11 11:43:10 ET
Table 'Pluribus Session 42' 6-max (Play Money) Seat #6 is the button
Seat 1: MrOrange (10000 in chips)
Seat 2: Pluribus (10000 in chips)
Seat 3: ORen (10000 in chips)
Seat 4: Hattori (10000 in chips)
Seat 5: MrBlue (10000 in chips)
Seat 6: Bill (10000 in chips)
MrOrange: posts small blind 50
Pluribus: posts big blind 100
*** HOLE CARDS ***
Dealt to MrOrange [5h Jc]
Dealt to Pluribus [6c 4d]
Dealt to ORen [3c 3s]
Dealt to Hattori [Ac 9d]
Dealt to MrBlue [Kh 5d]
Dealt to Bill [Ks Ad]
ORen: raises 100 to 200
Hattori: folds
MrBlue: folds
Bill: raises 525 to 725
MrOrange: folds
Pluribus: folds
ORen: folds
Uncalled bet (525) returned to Bill
Bill collected 550.0 from pot
*** SUMMARY ***
Total pot 550 | Rake 0


PokerStars Hand #42191: Hold'em No Limit (50/100) - 2019/07/11 11:43:11 ET
Table 'Pluribus Session 42' 6-max (Play Money) Seat #6 is the button
Seat 1: Pluribus (10000 in chips)
Seat 2: ORen (10000 in chips)
Seat 3: Hattori (10000 in chips)
Seat 4: MrBlue (10000 in chips)
Seat 5: Bill (10000 in chips)
Seat 6: MrOrange (10000 in chips)
Pluribus: posts small blind 50
ORen: posts big blind 100
*** HOLE CARDS ***
Dealt to Pluribus [Ac 3c]
Dealt to ORen [Qh 2h]
Dealt to Hattori [9s 3h]
Dealt to MrBlue [3s 2d]
Dealt to Bill [Ks 4d]
Dealt to MrOrange [5c 7d]
Hattori: folds
MrBlue: folds
Bill: folds
MrOrange: folds
Pluribus: raises 150 to 250
ORen: calls 150
*** FLOP *** [Ah 8d Kc]
Pluribus: checks
ORen: checks
*** TURN *** [Ah 8d Kc] [Jc]
Pluribus: bets 125
ORen: folds
Uncalled bet (125) returned to Pluribus
Pluribus collected 500.0 from pot
*** SUMMARY ***
Total pot 500 | Rake 0
Board [Ah 8d Kc Jc]


PokerStars Hand #42192: Hold'em No Limit (50/100) - 2019/07/11 11:43:12 ET
Table 'Pluribus Session 42' 6-max (Play Money) Seat #6 is the button
Seat 1: ORen (10000 in chips)
Seat 2: Hattori (10000 in chips)
Seat 3: MrBlue (10000 in chips)
Seat 4: Bill (10000 in chips)
Seat 5: MrOrange (10000 in chips)
Seat 6: Pluribus (10000 in chips)
ORen: posts small blind 50
Hattori: posts big blind 100
*** HOLE CARDS ***
Dealt to ORen [3h 6c]
Dealt to Hattori [Td Kh]
Dealt to MrBlue [Ts Qc]
Dealt to Bill [Kd 5h]
Dealt to MrOrange [7h 2d]
Dealt to Pluribus [5s As]
MrBlue: folds
Bill: folds
MrOrange: folds
Pluribus: raises 125 to 225
ORen: folds
Hattori: calls 125
*** FLOP *** [Ks Qd 9h]
Hattori: checks
Pluribus: checks
*** TURN *** [Ks Qd 9h] [4c]
Hattori: bets 500
Pluribus: folds
Uncalled bet (500) returned to Hattori
Hattori collected 500.0 from pot
*** SUMMARY ***
Total pot 500 | Rake 0
Board [Ks Qd 9h 4c]


PokerStars Hand #42193: Hold'em No Limit (50/100) - 2019/07/11 11:43:13 ET
Table 'Pluribus Session 42' 6-max (Play Money) Seat #6 is the button
Seat 1: Hattori (10000 in chips)
Seat 2: MrBlue (10000 in chips)
Seat 3: Bill (10000 in chips)
Seat 4: MrOrange (10000 in chips)
Seat 5: Pluribus (10000 in chips)
Seat 6: ORen (10000 in chips)
Hattori: posts small blind 50
MrBlue: posts big blind 100
*** HOLE CARDS ***
Dealt to Hattori [7s 6s]
Dealt to MrBlue [4d 8c]
Dealt to Bill [5c 8h]
Dealt to MrOrange [9c Ks]
Dealt to Pluribus [8s 5s]
Dealt to ORen [Qs 9h]
Bill: folds
MrOrange: folds
Pluribus: folds
ORen: raises 100 to 200
Hattori: raises 800 to 1000
MrBlue: folds
ORen: folds
Uncalled bet (800) returned to Hattori
Hattori collected 500.0 from pot
*** SUMMARY ***
Total pot 500 | Rake 0


PokerStars Hand #42194: Hold'em No Limit (50/100) - 2019/07/11 11:43:14 ET
Table 'Pluribus Session 42' 6-max (Play Money) Seat #6 is the button
Seat 1: MrBlue (10000 in chips)
Seat 2: Bill (10000 in chips)
Seat 3: MrOrange (10000 in chips)
Seat 4: Pluribus (10000 in chips)
Seat 5: ORen (10000 in chips)
Seat 6: Hattori (10000 in chips)
MrBlue: posts small blind 50
Bill: posts big blind 100
*** HOLE CARDS ***
Dealt to MrBlue [6d 6h]
Dealt to Bill [Kc 4s]
Dealt to MrOrange [2c 8d]
Dealt to Pluribus [4d 8h]
Dealt to ORen [As 9c]
Dealt to Hattori [Tc 3c]
MrOrange: folds
Pluribus: folds
ORen: folds
Hattori: folds
MrBlue: raises 200 to 300
Bill: folds
Uncalled bet (200) returned to MrBlue
MrBlue collected 200.0 from pot
*** SUMMARY ***
Total pot 200 | Rake 0


PokerStars Hand #42195: Hold'em No Limit (50/100) - 2019/07/11 11:43:15 ET
Table 'Pluribus Session 42' 6-max (Play Money) Seat #6 is the button
Seat 1: Bill (10000 in chips)
Seat 2: MrOrange (10000 in chips)
Seat 3: Pluribus (10000 in chips)
Seat 4: ORen (10000 in chips)
Seat 5: Hattori (10000 in chips)
Seat 6: MrBlue (10000 in chips)
Bill: posts small blind 50
MrOrange: posts big blind 100
*** HOLE CARDS ***
Dealt to Bill [8c 3h]
Dealt to MrOrange [4d 3c]
Dealt to Pluribus [Jc Jh]
Dealt to ORen [Qd 6c]
Dealt to Hattori [7c Td]
Dealt to MrBlue [Kh 9d]
Pluribus: raises 125 to 225
ORen: folds
Hattori: folds
MrBlue: folds
Bill: folds
MrOrange: folds
Uncalled bet (125) returned to Pluribus
Pluribus collected 250.0 from pot
*** SUMMARY ***
Total pot 250 | Rake 0


PokerStars Hand #42196: Hold'em No Limit (50/100) - 2019/07/11 11:43:16 ET
Table 'Pluribus Session 42' 6-max (Play Money) Seat #6 is the button
Seat 1: MrOrange (10000 in chips)
Seat 2: Pluribus (10000 in chips)
Seat 3: ORen (10000 in chips)
Seat 4: Hattori (10000 in chips)
Seat 5: MrBlue (10000 in chips)
Seat 6: Bill (10000 in chips)
MrOrange: posts small blind 50
Pluribus: posts big blind 100
*** HOLE CARDS ***
Dealt to MrOrange [2d 3c]
Dealt to Pluribus [3d 5s]
Dealt to ORen [4s 8d]
Dealt to Hattori [5h Ad]
Dealt to MrBlue [7d 6d]
Dealt to Bill [Jh Qd]
ORen: folds
Hattori: folds
MrBlue: raises 125 to 225
Bill: folds
MrOrange: folds
Pluribus: folds
Uncalled bet (125) returned to MrBlue
MrBlue collected 250.0 from pot
*** SUMMARY ***
Total pot 250 | Rake 0


PokerStars Hand #42197: Hold'em No Limit (50/100) - 2019/07/11 11:43:17 ET
Table 'Pluribus Session 42' 6-max (Play Money) Seat #6 is the button
Seat 1: Pluribus (10000 in chips)
Seat 2: ORen (10000 in chips)
Seat 3: Hattori (10000 in chips)
Seat 4: MrBlue (10000 in chips)
Seat 5: Bill (10000 in chips)
Seat 6: MrOrange (10000 in chips)
Pluribus: posts small blind 50
ORen: posts big blind 100
*** HOLE CARDS ***
Dealt to Pluribus [4c 3d]
Dealt to ORen [3h 3s]
Dealt to Hattori [9s 7c]
Dealt to MrBlue [8c 9h]
Dealt to Bill [8s Js]
Dealt to MrOrange [4h 2d]
Hattori: folds
MrBlue: folds
Bill: raises 125 to 225
MrOrange: folds
Pluribus: folds
ORen: calls 125
*** FLOP *** [Kh Jc Ah]
ORen: checks
Bill: checks
*** TURN *** [Kh Jc Ah] [6s]
ORen: checks
Bill: checks
*** RIVER *** [Kh Jc Ah] [6s] [5s]
ORen: checks
Bill: checks
*** SHOWDOWN ***
Bill: shows [8s Js]
Bill collected 500.0 from pot
*** SUMMARY ***
Total pot 500 | Rake 0
Board [Kh Jc Ah 6s 5s]
Seat 2: ORen showed [3h 3s] and lost
Seat 5: Bill showed [8s Js] and won (500.0)


PokerStars Hand #42198: Hold'em No Limit (50/100) - 2019/07/11 11:43:18 ET
Table 'Pluribus Session 42' 6-max (Play Money) Seat #6 is the button
Seat 1: ORen (10000 in chips)
Seat 2: Hattori (10000 in chips)
Seat 3: MrBlue (10000 in chips)
Seat 4: Bill (10000 in chips)
Seat 5: MrOrange (10000 in chips)
Seat 6: Pluribus (10000 in chips)
ORen: posts small blind 50
Hattori: posts big blind 100
*** HOLE CARDS ***
Dealt to ORen [2c 9d]
Dealt to Hattori [7s Tc]
Dealt to MrBlue [Td As]
Dealt to Bill [2d Ad]
Dealt to MrOrange [Jc 3d]
Dealt to Pluribus [7h Ah]
MrBlue: folds
Bill: raises 125 to 225
MrOrange: folds
Pluribus: calls 225
ORen: folds
Hattori: folds
*** FLOP *** [Kh 3s Th]
Bill: checks
Pluribus: checks
*** TURN *** [Kh 3s Th] [8c]
Bill: checks
Pluribus: checks
*** RIVER *** [Kh 3s Th] [8c] [Jd]
Bill: bets 450
Pluribus: folds
Uncalled bet (450) returned to Bill
Bill collected 600.0 from pot
*** SUMMARY ***
Total pot 600 | Rake 0
Board [Kh 3s Th 8c Jd]


PokerStars Hand #42199: Hold'em No Limit (50/100) - 2019/07/11 11:43:19 ET
Table 'Pluribus Session 42' 6-max (Play Money) Seat #6 is the button
Seat 1: Hattori (10000 in chips)
Seat 2: MrBlue (10000 in chips)
Seat 3: Bill (10000 in chips)
Seat 4: MrOrange (10000 in chips)
Seat 5: Pluribus (10000 in chips)
Seat 6: ORen (10000 in chips)
Hattori: posts small blind 50
MrBlue: posts big blind 100
*** HOLE CARDS ***
Dealt to Hattori [Ah Kd]
Dealt to MrBlue [Jc 5s]
Dealt to Bill [7s Js]
Dealt to MrOrange [7c Td]
Dealt to Pluribus [2c 3d]
Dealt to ORen [8d Qd]
Bill: folds
MrOrange: folds
Pluribus: folds
ORen: raises 100 to 200
Hattori: raises 800 to 1000
MrBlue: folds
ORen: folds
Uncalled bet (800) returned to Hattori
Hattori collected 500.0 from pot
*** SUMMARY ***
Total pot 500 | Rake 0


PokerStars Hand #42200: Hold'em No Limit (50/100) - 2019/07/11 11:43:20 ET
Table 'Pluribus Session 42' 6-max (Play Money) Seat #6 is the button
Seat 1: MrBlue (10000 in chips)
Seat 2: Bill (10000 in chips)
Seat 3: MrOrange (10000 in chips)
Seat 4: Pluribus (10000 in chips)
Seat 5: ORen (10000 in chips)
Seat 6: Hattori (10000 in chips)
MrBlue: posts small blind 50
Bill: posts big blind 100
*** HOLE CARDS ***
Dealt to MrBlue [Ts Ah]
Dealt to Bill [7c Ac]
Dealt to MrOrange [7s 5h]
Dealt to Pluribus [Qd Jh]
Dealt to ORen [9s Ks]
Dealt to Hattori [Ad 4s]
MrOrange: folds
Pluribus: raises 150 to 250
ORen: folds
Hattori: folds
MrBlue: folds
Bill: calls 150
*** FLOP *** [6s 3s Kd]
Bill: checks
Pluribus: bets 275
Bill: folds
Uncalled bet (275) returned to Pluribus
Pluribus collected 550.0 from pot
*** SUMMARY ***
Total pot 550 | Rake 0
Board [6s 3s Kd]


PokerStars Hand #42201: Hold'em No Limit (50/100) - 2019/07/11 11:43:21 ET
Table 'Pluribus Session 42' 6-max (Play Money) Seat #6 is the button
Seat 1: Bill (10000 in chips)
Seat 2: MrOrange (10000 in chips)
Seat 3: Pluribus (10000 in chips)
Seat 4: ORen (10000 in chips)
Seat 5: Hattori (10000 in chips)
Seat 6: MrBlue (10000 in chips)
Bill: posts small blind 50
MrOrange: posts big blind 100
*** HOLE CARDS ***
Dealt to Bill [Ad 5h]
Dealt to MrOrange [Ah 9d]
Dealt to Pluribus [3d 9s]
Dealt to ORen [Jd 6h]
Dealt to Hattori [3c Kd]
Dealt to MrBlue [8c Js]
Pluribus: folds
ORen: folds
Hattori: folds
MrBlue: folds
Bill: raises 200 to 300
MrOrange: calls 200
*** FLOP *** [7c Jc Td]
Bill: checks
MrOrange: checks
*** TURN *** [7c Jc Td] [2s]
Bill: checks
MrOrange: checks
*** RIVER *** [7c Jc Td] [2s] [7s]
Bill: checks
MrOrange: checks
*** SHOWDOWN ***
Bill collected 300.0 from pot
MrOrange collected 300.0 from pot
*** SUMMARY ***
Total pot 600 | Rake 0
Board [7c Jc Td 2s 7s]
Seat 1: Bill showed [Ad 5h] and lost
Seat 2: MrOrange showed [Ah 9d] and lost


PokerStars Hand #42202: Hold'em No Limit (50/100) - 2019/07/11 11:43:22 ET
Table 'Pluribus Session 42' 6-max (Play Money) Seat #6 is the button
Seat 1: MrOrange (10000 in chips)
Seat 2: Pluribus (10000 in chips)
Seat 3: ORen (10000 in chips)
Seat 4: Hattori (10000 in chips)
Seat 5: MrBlue (10000 in chips)
Seat 6: Bill (10000 in chips)
MrOrange: posts small blind 50
Pluribus: posts big blind 100
*** HOLE CARDS ***
Dealt to MrOrange [6s Jd]
Dealt to Pluribus [Tc 4c]
Dealt to ORen [Th 4d]
Dealt to Hattori [2h 2d]
Dealt to MrBlue [8h 3c]
Dealt to Bill [Ad Qh]
ORen: folds
Hattori: raises 100 to 200
MrBlue: folds
Bill: calls 200
MrOrange: folds
Pluribus: calls 100
*** FLOP *** [8s 5h 8d]
Pluribus: checks
Hattori: bets 165
Bill: calls 165
Pluribus: folds
*** TURN *** [8s 5h 8d] [Qd]
Hattori: checks
Bill: bets 350
Hattori: folds
Uncalled bet (350) returned to Bill
Bill collected 980.0 from pot
*** SUMMARY ***
Total pot 980 | Rake 0
Board [8s 5h 8d Qd]


PokerStars Hand #42203: Hold'em No Limit (50/100) - 2019/07/11 11:43:23 ET
Table 'Pluribus Session 42' 6-max (Play Money) Seat #6 is the button
Seat 1: Pluribus (10000 in chips)
Seat 2: ORen (10000 in chips)
Seat 3: Hattori (10000 in chips)
Seat 4: MrBlue (10000 in chips)
Seat 5: Bill (10000 in chips)
Seat 6: MrOrange (10000 in chips)
Pluribus: posts small blind 50
ORen: posts big blind 100
*** HOLE CARDS ***
Dealt to Pluribus [Tc 8c]
Dealt to ORen [9c 7c]
Dealt to Hattori [Qs 5h]
Dealt to MrBlue [4c 5d]
Dealt to Bill [2s Ad]
Dealt to MrOrange [Ac 7s]
Hattori: folds
MrBlue: folds
Bill: folds
MrOrange: raises 100 to 200
Pluribus: calls 150
ORen: calls 100
*** FLOP *** [Jh 8d Ts]
Pluribus: checks
ORen: checks
MrOrange: checks
*** TURN *** [Jh 8d Ts] [4h]
Pluribus: checks
ORen: bets 900
MrOrange: folds
Pluribus: calls 900
*** RIVER *** [Jh 8d Ts] [4h] [6d]
Pluribus: checks
ORen: bets 3600
Pluribus: calls 3600
*** SHOWDOWN ***
ORen: shows [9c 7c]
ORen collected 9600.0 from pot
*** SUMMARY ***
Total pot 9600 | Rake 0
Board [Jh 8d Ts 4h 6d]
Seat 1: Pluribus showed [Tc 8c] and lost
Seat 2: ORen showed [9c 7c] and won (9600.0)


PokerStars Hand #42204: Hold'em No Limit (50/100) - 2019/07/11 11:43:24 ET
Table 'Pluribus Session 42' 6-max (Play Money) Seat #6 is the button
Seat 1: ORen (10000 in chips)
Seat 2: Hattori (10000 in chips)
Seat 3: MrBlue (10000 in chips)
Seat 4: Bill (10000 in chips)
Seat 5: MrOrange (10000 in chips)
Seat 6: Pluribus (10000 in chips)
ORen: posts small blind 50
Hattori: posts big blind 100
*** HOLE CARDS ***
Dealt to ORen [3d 4h]
Dealt to Hattori [4d 7h]
Dealt to MrBlue [2d 5s]
Dealt to Bill [As Qd]
Dealt to MrOrange [9s 3h]
Dealt to Pluribus [7c 6s]
MrBlue: folds
Bill: raises 125 to 225
MrOrange: folds
Pluribus: folds
ORen: folds
Hattori: folds
Uncalled bet (125) returned to Bill
Bill collected 250.0 from pot
*** SUMMARY ***
Total pot 250 | Rake 0


PokerStars Hand #42205: Hold'em No Limit (50/100) - 2019/07/11 11:43:25 ET
Table 'Pluribus Session 42' 6-max (Play Money) Seat #6 is the button
Seat 1: Hattori (10000 in chips)
Seat 2: MrBlue (10000 in chips)
Seat 3: Bill (10000 in chips)
Seat 4: MrOrange (10000 in chips)
Seat 5: Pluribus (10000 in chips)
Seat 6: ORen (10000 in chips)
Hattori: posts small blind 50
MrBlue: posts big blind 100
*** HOLE CARDS ***
Dealt to Hattori [7s 6s]
Dealt to MrBlue [Qh 5c]
Dealt to Bill [8s 9h]
Dealt to MrOrange [Jd 9c]
Dealt to Pluribus [Kh 3d]
Dealt to ORen [7d 7c]
Bill: folds
MrOrange: folds
Pluribus: folds
ORen: raises 100 to 200
Hattori: raises 800 to 1000
MrBlue: folds
ORen: calls 800
*** FLOP *** [6h Ac 3h]
Hattori: checks
ORen: checks
*** TURN *** [6h Ac 3h] [Jc]
Hattori: checks
ORen: checks
*** RIVER *** [6h Ac 3h] [Jc] [Kd]
Hattori: checks
ORen: checks
*** SHOWDOWN ***
ORen: shows [7d 7c]
ORen collected 2100.0 from pot
*** SUMMARY ***
Total pot 2100 | Rake 0
Board [6h Ac 3h Jc Kd]
Seat 1: Hattori showed [7s 6s] and lost
Seat 6: ORen showed [7d 7c] and won (2100.0)


PokerStars Hand #42206: Hold'em No Limit (50/100) - 2019/07/11 11:43:26 ET
Table 'Pluribus Session 42' 6-max (Play Money) Seat #6 is the button
Seat 1: MrBlue (10000 in chips)
Seat 2: Bill (10000 in chips)
Seat 3: MrOrange (10000 in chips)
Seat 4: Pluribus (10000 in chips)
Seat 5: ORen (10000 in chips)
Seat 6: Hattori (10000 in chips)
MrBlue: posts small blind 50
Bill: posts big blind 100
*** HOLE CARDS ***
Dealt to MrBlue [9d 4h]
Dealt to Bill [Kd 2h]
Dealt to MrOrange [3c 7c]
Dealt to Pluribus [8h 3d]
Dealt to ORen [9h Ks]
Dealt to Hattori [As 2c]
MrOrange: folds
Pluribus: folds
ORen: folds
Hattori: folds
MrBlue: calls 50
Bill: raises 250 to 350
MrBlue: folds
Uncalled bet (250) returned to Bill
Bill collected 200.0 from pot
*** SUMMARY ***
Total pot 200 | Rake 0


PokerStars Hand #42207: Hold'em No Limit (50/100) - 2019/07/11 11:43:27 ET
Table 'Pluribus Session 42' 6-max (Play Money) Seat #6 is the button
Seat 1: Bill (10000 in chips)
Seat 2: MrOrange (10000 in chips)
Seat 3: Pluribus (10000 in chips)
Seat 4: ORen (10000 in chips)
Seat 5: Hattori (10000 in chips)
Seat 6: MrBlue (10000 in chips)
Bill: posts small blind 50
MrOrange: posts big blind 100
*** HOLE CARDS ***
Dealt to Bill [5s Qs]
Dealt to MrOrange [Th Qh]
Dealt to Pluribus [7h Kd]
Dealt to ORen [9d 8h]
Dealt to Hattori [6d Kc]
Dealt to MrBlue [9c 4d]
Pluribus: folds
ORen: folds
Hattori: folds
MrBlue: folds
Bill: raises 200 to 300
MrOrange: calls 200
*** FLOP *** [Qd Ac Ad]
Bill: checks
MrOrange: checks
*** TURN *** [Qd Ac Ad] [6h]
Bill: checks
MrOrange: checks
*** RIVER *** [Qd Ac Ad] [6h] [Qc]
Bill: bets 450
MrOrange: calls 450
*** SHOWDOWN ***
Bill collected 750.0 from pot
MrOrange collected 750.0 from pot
*** SUMMARY ***
Total pot 1500 | Rake 0
Board [Qd Ac Ad 6h Qc]
Seat 1: Bill showed [5s Qs] and lost
Seat 2: MrOrange showed [Th Qh] and lost


PokerStars Hand #42208: Hold'em No Limit (50/100) - 2019/07/11 11:43:28 ET
Table 'Pluribus Session 42' 6-max (Play Money) Seat #6 is the button
Seat 1: MrOrange (10000 in chips)
Seat 2: Pluribus (10000 in chips)
Seat 3: ORen (10000 in chips)
Seat 4: Hattori (10000 in chips)
Seat 5: MrBlue (10000 in chips)
Seat 6: Bill (10000 in chips)
MrOrange: posts small blind 50
Pluribus: posts big blind 100
*** HOLE CARDS ***
Dealt to MrOrange [2c 5h]
Dealt to Pluribus [9c Jd]
Dealt to ORen [Kh Th]
Dealt to Hattori [4c 6d]
Dealt to MrBlue [Kd Qh]
Dealt to Bill [3s 7h]
ORen: raises 100 to 200
Hattori: folds
MrBlue: folds
Bill: folds
MrOrange: folds
Pluribus: calls 100
*** FLOP *** [6s 6h 3d]
Pluribus: checks
ORen: checks
*** TURN *** [6s 6h 3d] [5d]
Pluribus: checks
ORen: checks
*** RIVER *** [6s 6h 3d] [5d] [9d]
Pluribus: bets 225
ORen: folds
Uncalled bet (225) returned to Pluribus
Pluribus collected 450.0 from pot
*** SUMMARY ***
Total pot 450 | Rake 0
Board [6s 6h 3d 5d 9d]


PokerStars Hand #42209: Hold'em No Limit (50/100) - 2019/07/11 11:43:29 ET
Table 'Pluribus Session 42' 6-max (Play Money) Seat #6 is the button
Seat 1: Pluribus (10000 in chips)
Seat 2: ORen (10000 in chips)
Seat 3: Hattori (10000 in chips)
Seat 4: MrBlue (10000 in chips)
Seat 5: Bill (10000 in chips)
Seat 6: MrOrange (10000 in chips)
Pluribus: posts small blind 50
ORen: posts big blind 100
*** HOLE CARDS ***
Dealt to Pluribus [8s 3d]
Dealt to ORen [8d 4c]
Dealt to Hattori [5d 7c]
Dealt to MrBlue [9h 7s]
Dealt to Bill [Jh Ts]
Dealt to MrOrange [3c Js]
Hattori: folds
MrBlue: folds
Bill: raises 125 to 225
MrOrange: folds
Pluribus: folds
ORen: folds
Uncalled bet (125) returned to Bill
Bill collected 250.0 from pot
*** SUMMARY ***
Total pot 250 | Rake 0


PokerStars Hand #42210: Hold'em No Limit (50/100) - 2019/07/11 11:43:30 ET
Table 'Pluribus Session 42' 6-max (Play Money) Seat #6 is the button
Seat 1: ORen (10000 in chips)
Seat 2: Hattori (10000 in chips)
Seat 3: MrBlue (10000 in chips)
Seat 4: Bill (10000 in chips)
Seat 5: MrOrange (10000 in chips)
Seat 6: Pluribus (10000 in chips)
ORen: posts small blind 50
Hattori: posts big blind 100
*** HOLE CARDS ***
Dealt to ORen [9s 7d]
Dealt to Hattori [2d Th]
Dealt to MrBlue [As 4h]
Dealt to Bill [6s 8d]
Dealt to MrOrange [7h Td]
Dealt to Pluribus [9d 5h]
MrBlue: folds
Bill: folds
MrOrange: folds
Pluribus: folds
ORen: calls 50
Hattori: checks
*** FLOP *** [2s Jh 3d]
ORen: checks
Hattori: checks
*** TURN *** [2s Jh 3d] [4d]
ORen: checks
Hattori: checks
*** RIVER *** [2s Jh 3d] [4d] [Tc]
ORen: bets 150
Hattori: raises 520 to 670
ORen: folds
Uncalled bet (520) returned to Hattori
Hattori collected 500.0 from pot
*** SUMMARY ***
Total pot 500 | Rake 0
Board [2s Jh 3d 4d Tc]


PokerStars Hand #42211: Hold'em No Limit (50/100) - 2019/07/11 11:43:31 ET
Table 'Pluribus Session 42' 6-max (Play Money) Seat #6 is the button
Seat 1: Hattori (10000 in chips)
Seat 2: MrBlue (10000 in chips)
Seat 3: Bill (10000 in chips)
Seat 4: MrOrange (10000 in chips)
Seat 5: Pluribus (10000 in chips)
Seat 6: ORen (10000 in chips)
Hattori: posts small blind 50
MrBlue: posts big blind 100
*** HOLE CARDS ***
Dealt to Hattori [6s Td]
Dealt to MrBlue [Qs Jc]
Dealt to Bill [8c Ac]
Dealt to MrOrange [8h 8s]
Dealt to Pluribus [Th 5d]
Dealt to ORen [6h 9d]
Bill: raises 125 to 225
MrOrange: calls 225
Pluribus: folds
ORen: folds
Hattori: folds
MrBlue: calls 125
*** FLOP *** [5s 7h Ks]
MrBlue: checks
Bill: checks
MrOrange: checks
*** TURN *** [5s 7h Ks] [2c]
MrBlue: checks
Bill: bets 362
MrOrange: calls 362
MrBlue: folds
*** RIVER *** [5s 7h Ks] [2c] [9c]
Bill: bets 724
MrOrange: folds
Uncalled bet (724) returned to Bill
Bill collected 1449.0 from pot
*** SUMMARY ***
Total pot 1449 | Rake 0
Board [5s 7h Ks 2c 9c]


PokerStars Hand #42212: Hold'em No Limit (50/100) - 2019/07/11 11:43:32 ET
Table 'Pluribus Session 42' 6-max (Play Money) Seat #6 is the button
Seat 1: MrBlue (10000 in chips)
Seat 2: Bill (10000 in chips)
Seat 3: MrOrange (10000 in chips)
Seat 4: Pluribus (10000 in chips)
Seat 5: ORen (10000 in chips)
Seat 6: Hattori (10000 in chips)
MrBlue: posts small blind 50
Bill: posts big blind 100
*** HOLE CARDS ***
Dealt to MrBlue [Kh Kd]
Dealt to Bill [7c 2h]
Dealt to MrOrange [5s 8c]
Dealt to Pluribus [3d 6s]
Dealt to ORen [8s 2d]
Dealt to Hattori [5h 6d]
MrOrange: folds
Pluribus: folds
ORen: folds
Hattori: folds
MrBlue: calls 50
Bill: checks
*** FLOP *** [7d Qd 4h]
MrBlue: checks
Bill: checks
*** TURN *** [7d Qd 4h] [Qc]
MrBlue: bets 150
Bill: calls 150
*** RIVER *** [7d Qd 4h] [Qc] [3c]
MrBlue: bets 382
Bill: calls 382
*** SHOWDOWN ***
MrBlue: shows [Kh Kd]
MrBlue collected 1264.0 from pot
*** SUMMARY ***
Total pot 1264 | Rake 0
Board [7d Qd 4h Qc 3c]
Seat 1: MrBlue showed [Kh Kd] and won (1264.0)
Seat 2: Bill showed [7c 2h] and lost


PokerStars Hand #42213: Hold'em No Limit (50/100) - 2019/07/11 11:43:33 ET
Table 'Pluribus Session 42' 6-max (Play Money) Seat #6 is the button
Seat 1: Bill (10000 in chips)
Seat 2: MrOrange (10000 in chips)
Seat 3: Pluribus (10000 in chips)
Seat 4: ORen (10000 in chips)
Seat 5: Hattori (10000 in chips)
Seat 6: MrBlue (10000 in chips)
Bill: posts small blind 50
MrOrange: posts big blind 100
*** HOLE CARDS ***
Dealt to Bill [6d Kh]
Dealt to MrOrange [As 2d]
Dealt to Pluribus [4s 8d]
Dealt to ORen [Ah Th]
Dealt to Hattori [3h 9d]
Dealt to MrBlue [4h 5d]
Pluribus: folds
ORen: raises 100 to 200
Hattori: folds
MrBlue: folds
Bill: folds
MrOrange: calls 100
*** FLOP *** [Qd 9c 2s]
MrOrange: checks
ORen: checks
*** TURN *** [Qd 9c 2s] [4c]
MrOrange: checks
ORen: checks
*** RIVER *** [Qd 9c 2s] [4c] [Ts]
MrOrange: checks
ORen: bets 150
MrOrange: folds
Uncalled bet (150) returned to ORen
ORen collected 450.0 from pot
*** SUMMARY ***
Total pot 450 | Rake 0
Board [Qd 9c 2s 4c Ts]


PokerStars Hand #42214: Hold'em No Limit (50/100) - 2019/07/11 11:43:34 ET
Table 'Pluribus Session 42' 6-max (Play Money) Seat #6 is the button
Seat 1: MrOrange (10000 in chips)
Seat 2: Pluribus (10000 in chips)
Seat 3: ORen (10000 in chips)
Seat 4: Hattori (10000 in chips)
Seat 5: MrBlue (10000 in chips)
Seat 6: Bill (10000 in chips)
MrOrange: posts small blind 50
Pluribus: posts big blind 100
*** HOLE CARDS ***
Dealt to MrOrange [9h Qs]
Dealt to Pluribus [7h Ah]
Dealt to ORen [2c 8s]
Dealt to Hattori [5h 7c]
Dealt to MrBlue [9s Qh]
Dealt to Bill [Jd Js]
ORen: folds
Hattori: folds
MrBlue: folds
Bill: raises 150 to 250
MrOrange: folds
Pluribus: calls 150
*** FLOP *** [Jc 2h 7s]
Pluribus: checks
Bill: checks
*** TURN *** [Jc 2h 7s] [5c]
Pluribus: checks
Bill: bets 275
Pluribus: calls 275
*** RIVER *** [Jc 2h 7s] [5c] [3c]
Pluribus: checks
Bill: bets 550
Pluribus: calls 550
*** SHOWDOWN ***
Bill: shows [Jd Js]
Bill collected 2200.0 from pot
*** SUMMARY ***
Total pot 2200 | Rake 0
Board [Jc 2h 7s 5c 3c]
Seat 2: Pluribus showed [7h Ah] and lost
Seat 6: Bill showed [Jd Js] and won (2200.0)


PokerStars Hand #42215: Hold'em No Limit (50/100) - 2019/07/11 11:43:35 ET
Table 'Pluribus Session 42' 6-max (Play Money) Seat #6 is the button
Seat 1: Pluribus (10000 in chips)
Seat 2: ORen (10000 in chips)
Seat 3: Hattori (10000 in chips)
Seat 4: MrBlue (10000 in chips)
Seat 5: Bill (10000 in chips)
Seat 6: MrOrange (10000 in chips)
Pluribus: posts small blind 50
ORen: posts big blind 100
*** HOLE CARDS ***
Dealt to Pluribus [6d Ts]
Dealt to ORen [9h 8d]
Dealt to Hattori [2h 7s]
Dealt to MrBlue [3c 5h]
Dealt to Bill [Tc 5c]
Dealt to MrOrange [Kc Kd]
Hattori: folds
MrBlue: folds
Bill: folds
MrOrange: raises 100 to 200
Pluribus: folds
ORen: calls 100
*** FLOP *** [9c Ac Js]
ORen: checks
MrOrange: checks
*** TURN *** [9c Ac Js] [9s]
ORen: bets 300
MrOrange: folds
Uncalled bet (300) returned to ORen
ORen collected 450.0 from pot
*** SUMMARY ***
Total pot 450 | Rake 0
Board [9c Ac Js 9s]


PokerStars Hand #42216: Hold'em No Limit (50/100) - 2019/07/11 11:43:36 ET
Table 'Pluribus Session 42' 6-max (Play Money) Seat #6 is the button
Seat 1: ORen (10000 in chips)
Seat 2: Hattori (10000 in chips)
Seat 3: MrBlue (10000 in chips)
Seat 4: Bill (10000 in chips)
Seat 5: MrOrange (10000 in chips)
Seat 6: Pluribus (10000 in chips)
ORen: posts small blind 50
Hattori: posts big blind 100
*** HOLE CARDS ***
Dealt to ORen [6h Th]
Dealt to Hattori [Qh 5s]
Dealt to MrBlue [9c 9s]
Dealt to Bill [Ks 7h]
Dealt to MrOrange [Tc 9h]
Dealt to Pluribus [8s Ts]
MrBlue: raises 125 to 225
Bill: folds
MrOrange: folds
Pluribus: calls 225
ORen: folds
Hattori: folds
*** FLOP *** [Jh 3d As]
MrBlue: checks
Pluribus: bets 600
MrBlue: folds
Uncalled bet (600) returned to Pluribus
Pluribus collected 600.0 from pot
*** SUMMARY ***
Total pot 600 | Rake 0
Board [Jh 3d As]


PokerStars Hand #42217: Hold'em No Limit (50/100) - 2019/07/11 11:43:37 ET
Table 'Pluribus Session 42' 6-max (Play Money) Seat #6 is the button
Seat 1: Hattori (10000 in chips)
Seat 2: MrBlue (10000 in chips)
Seat 3: Bill (10000 in chips)
Seat 4: MrOrange (10000 in chips)
Seat 5: Pluribus (10000 in chips)
Seat 6: ORen (10000 in chips)
Hattori: posts small blind 50
MrBlue: posts big blind 100
*** HOLE CARDS ***
Dealt to Hattori [As 4h]
Dealt to MrBlue [Jc Jd]
Dealt to Bill [Kc Qd]
Dealt to MrOrange [8c 5c]
Dealt to Pluribus [6c 2h]
Dealt to ORen [Ks 3s]
Bill: raises 125 to 225
MrOrange: folds
Pluribus: folds
ORen: folds
Hattori: folds
MrBlue: calls 125
*** FLOP *** [Ad 9c Ts]
MrBlue: checks
Bill: bets 250
MrBlue: calls 250
*** TURN *** [Ad 9c Ts] [8h]
MrBlue: checks
Bill: checks
*** RIVER *** [Ad 9c Ts] [8h] [Js]
MrBlue: checks
Bill: bets 750
MrBlue: calls 750
*** SHOWDOWN ***
Bill: shows [Kc Qd]
Bill collected 2500.0 from pot
*** SUMMARY ***
Total pot 2500 | Rake 0
Board [Ad 9c Ts 8h Js]
Seat 2: MrBlue showed [Jc Jd] and lost
Seat 3: Bill showed [Kc Qd] and won (2500.0)


PokerStars Hand #42218: Hold'em No Limit (50/100) - 2019/07/11 11:43:38 ET
Table 'Pluribus Session 42' 6-max (Play Money) Seat #6 is the button
Seat 1: MrBlue (10000 in chips)
Seat 2: Bill (10000 in chips)
Seat 3: MrOrange (10000 in chips)
Seat 4: Pluribus (10000 in chips)
Seat 5: ORen (10000 in chips)
Seat 6: Hattori (10000 in chips)
MrBlue: posts small blind 50
Bill: posts big blind 100
*** HOLE CARDS ***
Dealt to MrBlue [5d Jc]
Dealt to Bill [2c 3h]
Dealt to MrOrange [6d 7d]
Dealt to Pluribus [5s 4d]
Dealt to ORen [9d 5h]
Dealt to Hattori [9h Qc]
MrOrange: raises 100 to 200
Pluribus: folds
ORen: folds
Hattori: folds
MrBlue: folds
Bill: folds
Uncalled bet (100) returned to MrOrange
MrOrange collected 250.0 from pot
*** SUMMARY ***
Total pot 250 | Rake 0


PokerStars Hand #42219: Hold'em No Limit (50/100) - 2019/07/11 11:43:39 ET
Table 'Pluribus Session 42' 6-max (Play Money) Seat #6 is the button
Seat 1: Bill (10000 in chips)
Seat 2: MrOrange (10000 in chips)
Seat 3: Pluribus (10000 in chips)
Seat 4: ORen (10000 in chips)
Seat 5: Hattori (10000 in chips)
Seat 6: MrBlue (10000 in chips)
Bill: posts small blind 50
MrOrange: posts big blind 100
*** HOLE CARDS ***
Dealt to Bill [8d 4s]
Dealt to MrOrange [3h 5c]
Dealt to Pluribus [Kh Th]
Dealt to ORen [4h Js]
Dealt to Hattori [Kc 8s]
Dealt to MrBlue [Tc 8h]
Pluribus: raises 100 to 200
ORen: folds
Hattori: folds
MrBlue: folds
Bill: folds
MrOrange: folds
Uncalled bet (100) returned to Pluribus
Pluribus collected 250.0 from pot
*** SUMMARY ***
Total pot 250 | Rake 0


PokerStars Hand #42220: Hold'em No Limit (50/100) - 2019/07/11 11:43:40 ET
Table 'Pluribus Session 42' 6-max (Play Money) Seat #6 is the button
Seat 1: MrOrange (10000 in chips)
Seat 2: Pluribus (10000 in chips)
Seat 3: ORen (10000 in chips)
Seat 4: Hattori (10000 in chips)
Seat 5: MrBlue (10000 in chips)
Seat 6: Bill (10000 in chips)
MrOrange: posts small blind 50
Pluribus: posts big blind 100
*** HOLE CARDS ***
Dealt to MrOrange [2h 8s]
Dealt to Pluribus [2c 4h]
Dealt to ORen [4c Js]
Dealt to Hattori [Jh Kh]
Dealt to MrBlue [Qh 2s]
Dealt to Bill [Ah Ks]
ORen: folds
Hattori: raises 100 to 200
MrBlue: folds
Bill: calls 200
MrOrange: folds
Pluribus: folds
*** FLOP *** [9s 4d Kc]
Hattori: checks
Bill: bets 275
Hattori: calls 275
*** TURN *** [9s 4d Kc] [Ac]
Hattori: checks
Bill: bets 825
Hattori: calls 825
*** RIVER *** [9s 4d Kc] [Ac] [As]
Hattori: checks
Bill: bets 2750
Hattori: folds
Uncalled bet (2750) returned to Bill
Bill collected 2750.0 from pot
*** SUMMARY ***
Total pot 2750 | Rake 0
Board [9s 4d Kc Ac As]


PokerStars Hand #42221: Hold'em No Limit (50/100) - 2019/07/11 11:43:41 ET
Table 'Pluribus Session 42' 6-max (Play Money) Seat #6 is the button
Seat 1: Pluribus (10000 in chips)
Seat 2: ORen (10000 in chips)
Seat 3: Hattori (10000 in chips)
Seat 4: MrBlue (10000 in chips)
Seat 5: Bill (10000 in chips)
Seat 6: MrOrange (10000 in chips)
Pluribus: posts small blind 50
ORen: posts big blind 100
*** HOLE CARDS ***
Dealt to Pluribus [8s 5s]
Dealt to ORen [7s 3d]
Dealt to Hattori [2d Qd]
Dealt to MrBlue [Ts 4c]
Dealt to Bill [3s 7h]
Dealt to MrOrange [Qh Js]
Hattori: folds
MrBlue: folds
Bill: folds
MrOrange: raises 100 to 200
Pluribus: folds
ORen: folds
Uncalled bet (100) returned to MrOrange
MrOrange collected 250.0 from pot
*** SUMMARY ***
Total pot 250 | Rake 0


PokerStars Hand #42222: Hold'em No Limit (50/100) - 2019/07/11 11:43:42 ET
Table 'Pluribus Session 42' 6-max (Play Money) Seat #6 is the button
Seat 1: ORen (10000 in chips)
Seat 2: Hattori (10000 in chips)
Seat 3: MrBlue (10000 in chips)
Seat 4: Bill (10000 in chips)
Seat 5: MrOrange (10000 in chips)
Seat 6: Pluribus (10000 in chips)
ORen: posts small blind 50
Hattori: posts big blind 100
*** HOLE CARDS ***
Dealt to ORen [7s Td]
Dealt to Hattori [Th Ac]
Dealt to MrBlue [2c 5c]
Dealt to Bill [Ad 4s]
Dealt to MrOrange [Jh 3d]
Dealt to Pluribus [2s 2h]
MrBlue: folds
Bill: folds
MrOrange: folds
Pluribus: raises 125 to 225
ORen: folds
Hattori: calls 125
*** FLOP *** [7d 5d 8s]
Hattori: checks
Pluribus: bets 500
Hattori: folds
Uncalled bet (500) returned to Pluribus
Pluribus collected 500.0 from pot
*** SUMMARY ***
Total pot 500 | Rake 0
Board [7d 5d 8s]


PokerStars Hand #42223: Hold'em No Limit (50/100) - 2019/07/11 11:43:43 ET
Table 'Pluribus Session 42' 6-max (Play Money) Seat #6 is the button
Seat 1: Hattori (10000 in chips)
Seat 2: MrBlue (10000 in chips)
Seat 3: Bill (10000 in chips)
Seat 4: MrOrange (10000 in chips)
Seat 5: Pluribus (10000 in chips)
Seat 6: ORen (10000 in chips)
Hattori: posts small blind 50
MrBlue: posts big blind 100
*** HOLE CARDS ***
Dealt to Hattori [Kh Tc]
Dealt to MrBlue [2c Ks]
Dealt to Bill [3c 7c]
Dealt to MrOrange [9s 7h]
Dealt to Pluribus [5d Qs]
Dealt to ORen [8s Kd]
Bill: folds
MrOrange: folds
Pluribus: folds
ORen: folds
Hattori: raises 150 to 250
MrBlue: calls 150
*** FLOP *** [9h 2d 7s]
Hattori: bets 400
MrBlue: calls 400
*** TURN *** [9h 2d 7s] [2s]
Hattori: checks
MrBlue: bets 975
Hattori: folds
Uncalled bet (975) returned to MrBlue
MrBlue collected 1300.0 from pot
*** SUMMARY ***
Total pot 1300 | Rake 0
Board [9h 2d 7s 2s]


PokerStars Hand #42224: Hold'em No Limit (50/100) - 2019/07/11 11:43:44 ET
Table 'Pluribus Session 42' 6-max (Play Money) Seat #6 is the button
Seat 1: MrBlue (10000 in chips)
Seat 2: Bill (10000 in chips)
Seat 3: MrOrange (10000 in chips)
Seat 4: Pluribus (10000 in chips)
Seat 5: ORen (10000 in chips)
Seat 6: Hattori (10000 in chips)
MrBlue: posts small blind 50
Bill: posts big blind 100
*** HOLE CARDS ***
Dealt to MrBlue [4h 3c]
Dealt to Bill [Qd 4s]
Dealt to MrOrange [6d 8h]
Dealt to Pluribus [9d 4c]
Dealt to ORen [2h 6c]
Dealt to Hattori [8s Kc]
MrOrange: folds
Pluribus: folds
ORen: folds
Hattori: raises 125 to 225
MrBlue: folds
Bill: folds
Uncalled bet (125) returned to Hattori
Hattori collected 250.0 from pot
*** SUMMARY ***
Total pot 250 | Rake 0


PokerStars Hand #42225: Hold'em No Limit (50/100) - 2019/07/11 11:43:45 ET
Table 'Pluribus Session 42' 6-max (Play Money) Seat #6 is the button
Seat 1: Bill (10000 in chips)
Seat 2: MrOrange (10000 in chips)
Seat 3: Pluribus (10000 in chips)
Seat 4: ORen (10000 in chips)
Seat 5: Hattori (10000 in chips)
Seat 6: MrBlue (10000 in chips)
Bill: posts small blind 50
MrOrange: posts big blind 100
*** HOLE CARDS ***
Dealt to Bill [2d 2h]
Dealt to MrOrange [3d 4s]
Dealt to Pluribus [8d 5h]
Dealt to ORen [Ad Kc]
Dealt to Hattori [Td 9s]
Dealt to MrBlue [9c 6s]
Pluribus: folds
ORen: raises 100 to 200
Hattori: folds
MrBlue: folds
Bill: folds
MrOrange: folds
Uncalled bet (100) returned to ORen
ORen collected 250.0 from pot
*** SUMMARY ***
Total pot 250 | Rake 0


PokerStars Hand #42226: Hold'em No Limit (50/100) - 2019/07/11 11:43:46 ET
Table 'Pluribus Session 42' 6-max (Play Money) Seat #6 is the button
Seat 1: MrOrange (10000 in chips)
Seat 2: Pluribus (10000 in chips)
Seat 3: ORen (10000 in chips)
Seat 4: Hattori (10000 in chips)
Seat 5: MrBlue (10000 in chips)
Seat 6: Bill (10000 in chips)
MrOrange: posts small blind 50
Pluribus: posts big blind 100
*** HOLE CARDS ***
Dealt to MrOrange [4h 9d]
Dealt to Pluribus [4s 7c]
Dealt to ORen [5c Qh]
Dealt to Hattori [8c 4d]
Dealt to MrBlue [Qd Tc]
Dealt to Bill [4c Ts]
ORen: folds
Hattori: folds
MrBlue: raises 125 to 225
Bill: folds
MrOrange: folds
Pluribus: folds
Uncalled bet (125) returned to MrBlue
MrBlue collected 250.0 from pot
*** SUMMARY ***
Total pot 250 | Rake 0


PokerStars Hand #42227: Hold'em No Limit (50/100) - 2019/07/11 11:43:47 ET
Table 'Pluribus Session 42' 6-max (Play Money) Seat #6 is the button
Seat 1: Pluribus (10000 in chips)
Seat 2: ORen (10000 in chips)
Seat 3: Hattori (10000 in chips)
Seat 4: MrBlue (10000 in chips)
Seat 5: Bill (10000 in chips)
Seat 6: MrOrange (10000 in chips)
Pluribus: posts small blind 50
ORen: posts big blind 100
*** HOLE CARDS ***
Dealt to Pluribus [Kd Ts]
Dealt to ORen [2s Qc]
Dealt to Hattori [8d 7d]
Dealt to MrBlue [6d Jh]
Dealt to Bill [3h 8h]
Dealt to MrOrange [Ks 3c]
Hattori: raises 100 to 200
MrBlue: folds
Bill: folds
MrOrange: folds
Pluribus: folds
ORen: folds
Uncalled bet (100) returned to Hattori
Hattori collected 250.0 from pot
*** SUMMARY ***
Total pot 250 | Rake 0


PokerStars Hand #42228: Hold'em No Limit (50/100) - 2019/07/11 11:43:48 ET
Table 'Pluribus Session 42' 6-max (Play Money) Seat #6 is the button
Seat 1: ORen (10000 in chips)
Seat 2: Hattori (10000 in chips)
Seat 3: MrBlue (10000 in chips)
Seat 4: Bill (10000 in chips)
Seat 5: MrOrange (10000 in chips)
Seat 6: Pluribus (10000 in chips)
ORen: posts small blind 50
Hattori: posts big blind 100
*** HOLE CARDS ***
Dealt to ORen [4h 8d]
Dealt to Hattori [Ts 6s]
Dealt to MrBlue [Td Qh]
Dealt to Bill [As 9h]
Dealt to MrOrange [5h Th]
Dealt to Pluribus [Kc 3s]
MrBlue: folds
Bill: folds
MrOrange: folds
Pluribus: folds
ORen: folds
Uncalled bet (50) returned to Hattori
Hattori collected 100.0 from pot
*** SUMMARY ***
Total pot 100 | Rake 0


PokerStars Hand #42229: Hold'em No Limit (50/100) - 2019/07/11 11:43:49 ET
Table 'Pluribus Session 42' 6-max (Play Money) Seat #6 is the button
Seat 1: Hattori (10000 in chips)
Seat 2: MrBlue (10000 in chips)
Seat 3: Bill (10000 in chips)
Seat 4: MrOrange (10000 in chips)
Seat 5: Pluribus (10000 in chips)
Seat 6: ORen (10000 in chips)
Hattori: posts small blind 50
MrBlue: posts big blind 100
*** HOLE CARDS ***
Dealt to Hattori [5d Tc]
Dealt to MrBlue [2s Jd]
Dealt to Bill [8h Ah]
Dealt to MrOrange [Th Qd]
Dealt to Pluribus [6h 3d]
Dealt to ORen [9d 6c]
Bill: raises 125 to 225
MrOrange: folds
Pluribus: folds
ORen: folds
Hattori: folds
MrBlue: folds
Uncalled bet (125) returned to Bill
Bill collected 250.0 from pot
*** SUMMARY ***
Total pot 250 | Rake 0


PokerStars Hand #42230: Hold'em No Limit (50/100) - 2019/07/11 11:43:50 ET
Table 'Pluribus Session 42' 6-max (Play Money) Seat #6 is the button
Seat 1: MrBlue (10000 in chips)
Seat 2: Bill (10000 in chips)
Seat 3: MrOrange (10000 in chips)
Seat 4: Pluribus (10000 in chips)
Seat 5: ORen (10000 in chips)
Seat 6: Hattori (10000 in chips)
MrBlue: posts small blind 50
Bill: posts big blind 100
*** HOLE CARDS ***
Dealt to MrBlue [2s Kh]
Dealt to Bill [Kd Ad]
Dealt to MrOrange [8h Td]
Dealt to Pluribus [6d 9c]
Dealt to ORen [3h 3d]
Dealt to Hattori [Qc Ah]
MrOrange: folds
Pluribus: folds
ORen: raises 100 to 200
Hattori: raises 570 to 770
MrBlue: folds
Bill: raises 1505 to 2275
ORen: folds
Hattori: folds
Uncalled bet (1505) returned to Bill
Bill collected 1790.0 from pot
*** SUMMARY ***
Total pot 1790 | Rake 0


PokerStars Hand #42231: Hold'em No Limit (50/100) - 2019/07/11 11:43:51 ET
Table 'Pluribus Session 42' 6-max (Play Money) Seat #6 is the button
Seat 1: Bill (10000 in chips)
Seat 2: MrOrange (10000 in chips)
Seat 3: Pluribus (10000 in chips)
Seat 4: ORen (10000 in chips)
Seat 5: Hattori (10000 in chips)
Seat 6: MrBlue (10000 in chips)
Bill: posts small blind 50
MrOrange: posts big blind 100
*** HOLE CARDS ***
Dealt to Bill [5s 8h]
Dealt to MrOrange [3c Ks]
Dealt to Pluribus [Qh 2d]
Dealt to ORen [8d 9c]
Dealt to Hattori [Qs 5c]
Dealt to MrBlue [3s 9h]
Pluribus: folds
ORen: folds
Hattori: folds
MrBlue: folds
Bill: folds
Uncalled bet (50) returned to MrOrange
MrOrange collected 100.0 from pot
*** SUMMARY ***
Total pot 100 | Rake 0


PokerStars Hand #42232: Hold'em No Limit (50/100) - 2019/07/11 11:43:52 ET
Table 'Pluribus Session 42' 6-max (Play Money) Seat #6 is the button
Seat 1: MrOrange (10000 in chips)
Seat 2: Pluribus (10000 in chips)
Seat 3: ORen (10000 in chips)
Seat 4: Hattori (10000 in chips)
Seat 5: MrBlue (10000 in chips)
Seat 6: Bill (10000 in chips)
MrOrange: posts small blind 50
Pluribus: posts big blind 100
*** HOLE CARDS ***
Dealt to MrOrange [Qh 6c]
Dealt to Pluribus [7s 9s]
Dealt to ORen [4h 8s]
Dealt to Hattori [Th Ts]
Dealt to MrBlue [6d 8h]
Dealt to Bill [3h Kd]
ORen: folds
Hattori: raises 100 to 200
MrBlue: folds
Bill: folds
MrOrange: folds
Pluribus: calls 100
*** FLOP *** [Qc 7h As]
Pluribus: checks
Hattori: checks
*** TURN *** [Qc 7h As] [4s]
Pluribus: checks
Hattori: checks
*** RIVER *** [Qc 7h As] [4s] [3s]
Pluribus: bets 900
Hattori: folds
Uncalled bet (900) returned to Pluribus
Pluribus collected 450.0 from pot
*** SUMMARY ***
Total pot 450 | Rake 0
Board [Qc 7h As 4s 3s]


PokerStars Hand #42233: Hold'em No Limit (50/100) - 2019/07/11 11:43:53 ET
Table 'Pluribus Session 42' 6-max (Play Money) Seat #6 is the button
Seat 1: Pluribus (10000 in chips)
Seat 2: ORen (10000 in chips)
Seat 3: Hattori (10000 in chips)
Seat 4: MrBlue (10000 in chips)
Seat 5: Bill (10000 in chips)
Seat 6: MrOrange (10000 in chips)
Pluribus: posts small blind 50
ORen: posts big blind 100
*** HOLE CARDS ***
Dealt to Pluribus [Qd 2h]
Dealt to ORen [Ah 2c]
Dealt to Hattori [4d 9h]
Dealt to MrBlue [Kh Td]
Dealt to Bill [2d Qh]
Dealt to MrOrange [3c Jh]
Hattori: folds
MrBlue: folds
Bill: folds
MrOrange: folds
Pluribus: folds
Uncalled bet (50) returned to ORen
ORen collected 100.0 from pot
*** SUMMARY ***
Total pot 100 | Rake 0


PokerStars Hand #42234: Hold'em No Limit (50/100) - 2019/07/11 11:43:54 ET
Table 'Pluribus Session 42' 6-max (Play Money) Seat #6 is the button
Seat 1: ORen (10000 in chips)
Seat 2: Hattori (10000 in chips)
Seat 3: MrBlue (10000 in chips)
Seat 4: Bill (10000 in chips)
Seat 5: MrOrange (10000 in chips)
Seat 6: Pluribus (10000 in chips)
ORen: posts small blind 50
Hattori: posts big blind 100
*** HOLE CARDS ***
Dealt to ORen [4h 4d]
Dealt to Hattori [8d Jc]
Dealt to MrBlue [Td 7s]
Dealt to Bill [Ad 9s]
Dealt to MrOrange [2s Ks]
Dealt to Pluribus [7d 6c]
MrBlue: folds
Bill: folds
MrOrange: folds
Pluribus: folds
ORen: raises 200 to 300
Hattori: calls 200
*** FLOP *** [6s Ac 3c]
ORen: checks
Hattori: checks
*** TURN *** [6s Ac 3c] [2c]
ORen: bets 350
Hattori: calls 350
*** RIVER *** [6s Ac 3c] [2c] [2d]
ORen: checks
Hattori: bets 1900
ORen: folds
Uncalled bet (1900) returned to Hattori
Hattori collected 1300.0 from pot
*** SUMMARY ***
Total pot 1300 | Rake 0
Board [6s Ac 3c 2c 2d]
