PokerStars Hand #75024: Hold'em No Limit (50/100) - 2019/07/11 20:50:24 ET
Table 'Pluribus Session 75' 6-max (Play Money) Seat #6 is the button
Seat 1: Budd (10000 in chips)
Seat 2: MrWhite (10000 in chips)
Seat 3: MrOrange (10000 in chips)
Seat 4: Hattori (10000 in chips)
Seat 5: MrBlue (10000 in chips)
Seat 6: Pluribus (10000 in chips)
Budd: posts small blind 50
MrWhite: posts big blind 100
*** HOLE CARDS ***
Dealt to Budd [3s 5c]
Dealt to MrWhite [Jc 5s]
Dealt to MrOrange [2d Ts]
Dealt to Hattori [Ac 4c]
Dealt to MrBlue [6c 4h]
Dealt to Pluribus [4d Jh]
MrOrange: folds
Hattori: raises 100 to 200
MrBlue: folds
Pluribus: folds
Budd: folds
MrWhite: calls 100
*** FLOP *** [2s 9s 6d]
MrWhite: checks
Hattori: checks
*** TURN *** [2s 9s 6d] [Js]
MrWhite: checks
Hattori: checks
*** RIVER *** [2s 9s 6d] [Js] [9c]
MrWhite: bets 337
Hattori: folds
Uncalled bet (337) returned to MrWhite
MrWhite collected 450.0 from pot
*** SUMMARY ***
Total pot 450 | Rake 0
Board [2s 9s 6d Js 9c]


PokerStars Hand #75025: Hold'em No Limit (50/100) - 2019/07/11 20:50:25 ET
Table 'Pluribus Session 75' 6-max (Play Money) Seat #6 is the button
Seat 1: MrWhite (10000 in chips)
Seat 2: MrOrange (10000 in chips)
Seat 3: Hattori (10000 in chips)
Seat 4: MrBlue (10000 in chips)
Seat 5: Pluribus (10000 in chips)
Seat 6: Budd (10000 in chips)
MrWhite: posts small blind 50
MrOrange: posts big blind 100
*** HOLE CARDS ***
Dealt to MrWhite [4s 9h]
Dealt to MrOrange [2c Th]
Dealt to Hattori [Kd Qh]
Dealt to MrBlue [As 7d]
Dealt to Pluribus [9c 8d]
Dealt to Budd [Ad 7s]
Hattori: raises 100 to 200
MrBlue: folds
Pluribus: folds
Budd: folds
MrWhite: folds
MrOrange: folds
Uncalled bet (100) returned to Hattori
Hattori collected 250.0 from pot
*** SUMMARY ***
Total pot 250 | Rake 0


PokerStars Hand #75026: Hold'em No Limit (50/100) - 2019/07/11 20:50:26 ET
Table 'Pluribus Session 75' 6-max (Play Money) Seat #6 is the button
Seat 1: MrOrange (10000 in chips)
Seat 2: Hattori (10000 in chips)
Seat 3: MrBlue (10000 in chips)
Seat 4: Pluribus (10000 in chips)
Seat 5: Budd (10000 in chips)
Seat 6: MrWhite (10000 in chips)
MrOrange: posts small blind 50
Hattori: posts big blind 100
*** HOLE CARDS ***
Dealt to MrOrange [Td 7c]
Dealt to Hattori [2h 6d]
Dealt to MrBlue [2c Kc]
Dealt to Pluribus [Ac Jc]
Dealt to Budd [Jh 8d]
Dealt to MrWhite [Ts 3h]
MrBlue: folds
Pluribus: raises 100 to 200
Budd: folds
MrWhite: folds
MrOrange: folds
Hattori: folds
Uncalled bet (100) returned to Pluribus
Pluribus collected 250.0 from pot
*** SUMMARY ***
Total pot 250 | Rake 0


PokerStars Hand #75027: Hold'em No Limit (50/100) - 2019/07/11 20:50:27 ET
Table 'Pluribus Session 75' 6-max (Play Money) Seat #6 is the button
Seat 1: Hattori (10000 in chips)
Seat 2: MrBlue (10000 in chips)
Seat 3: Pluribus (10000 in chips)
Seat 4: Budd (10000 in chips)
Seat 5: MrWhite (10000 in chips)
Seat 6: MrOrange (10000 in chips)
Hattori: posts small blind 50
MrBlue: posts big blind 100
*** HOLE CARDS ***
Dealt to Hattori [8s Js]
Dealt to MrBlue [9d As]
Dealt to Pluribus [2c 2h]
Dealt to Budd [2d 8h]
Dealt to MrWhite [6c 7s]
Dealt to MrOrange [5c 3h]
Pluribus: folds
Budd: folds
MrWhite: folds
MrOrange: folds
Hattori: raises 135 to 235
MrBlue: calls 135
*** FLOP *** [4h Th Kd]
Hattori: bets 118
MrBlue: calls 118
*** TURN *** [4h Th Kd] [3c]
Hattori: checks
MrBlue: checks
*** RIVER *** [4h Th Kd] [3c] [5s]
Hattori: checks
MrBlue: bets 529
Hattori: folds
Uncalled bet (529) returned to MrBlue
MrBlue collected 706.0 from pot
*** SUMMARY ***
Total pot 706 | Rake 0
Board [4h Th Kd 3c 5s]


PokerStars Hand #75028: Hold'em No Limit (50/100) - 2019/07/11 20:50:28 ET
Table 'Pluribus Session 75' 6-max (Play Money) Seat #6 is the button
Seat 1: MrBlue (10000 in chips)
Seat 2: Pluribus (10000 in chips)
Seat 3: Budd (10000 in chips)
Seat 4: MrWhite (10000 in chips)
Seat 5: MrOrange (10000 in chips)
Seat 6: Hattori (10000 in chips)
MrBlue: posts small blind 50
Pluribus: posts big blind 100
*** HOLE CARDS ***
Dealt to MrBlue [2h Kc]
Dealt to Pluribus [Qs 6c]
Dealt to Budd [3d Qh]
Dealt to MrWhite [2s 7d]
Dealt to MrOrange [5h 9d]
Dealt to Hattori [Td Jh]
Budd: folds
MrWhite: folds
MrOrange: folds
Hattori: raises 125 to 225
MrBlue: folds
Pluribus: calls 125
*** FLOP *** [Qc 4s Tc]
Pluribus: checks
Hattori: checks
*** TURN *** [Qc 4s Tc] [8s]
Pluribus: checks
Hattori: checks
*** RIVER *** [Qc 4s Tc] [8s] [3h]
Pluribus: bets 1500
Hattori: calls 1500
*** SHOWDOWN ***
Pluribus: shows [Qs 6c]
Pluribus collected 3500.0 from pot
*** SUMMARY ***
Total pot 3500 | Rake 0
Board [Qc 4s Tc 8s 3h]
Seat 2: Pluribus showed [Qs 6c] and won (3500.0)
Seat 6: Hattori showed [Td Jh] and lost


PokerStars Hand #75029: Hold'em No Limit (50/100) - 2019/07/11 20:50:29 ET
Table 'Pluribus Session 75' 6-max (Play Money) Seat #6 is the button
Seat 1: Pluribus (10000 in chips)
Seat 2: Budd (10000 in chips)
Seat 3: MrWhite (10000 in chips)
Seat 4: MrOrange (10000 in chips)
Seat 5: Hattori (10000 in chips)
Seat 6: MrBlue (10000 in chips)
Pluribus: posts small blind 50
Budd: posts big blind 100
*** HOLE CARDS ***
Dealt to Pluribus [5s Th]
Dealt to Budd [9h 2c]
Dealt to MrWhite [Ah 3h]
Dealt to MrOrange [7s Ts]
Dealt to Hattori [8s Qd]
Dealt to MrBlue [2d 6c]
MrWhite: raises 125 to 225
MrOrange: folds
Hattori: folds
MrBlue: folds
Pluribus: folds
Budd: folds
Uncalled bet (125) returned to MrWhite
MrWhite collected 250.0 from pot
*** SUMMARY ***
Total pot 250 | Rake 0


PokerStars Hand #75030: Hold'em No Limit (50/100) - 2019/07/11 20:50:30 ET
Table 'Pluribus Session 75' 6-max (Play Money) Seat #6 is the button
Seat 1: Budd (10000 in chips)
Seat 2: MrWhite (10000 in chips)
Seat 3: MrOrange (10000 in chips)
Seat 4: Hattori (10000 in chips)
Seat 5: MrBlue (10000 in chips)
Seat 6: Pluribus (10000 in chips)
Budd: posts small blind 50
MrWhite: posts big blind 100
*** HOLE CARDS ***
Dealt to Budd [Ks Jc]
Dealt to MrWhite [3d 9c]
Dealt to MrOrange [4d 6d]
Dealt to Hattori [Td Tc]
Dealt to MrBlue [9d 6c]
Dealt to Pluribus [Ac 7h]
MrOrange: folds
Hattori: raises 100 to 200
MrBlue: folds
Pluribus: folds
Budd: folds
MrWhite: folds
Uncalled bet (100) returned to Hattori
Hattori collected 250.0 from pot
*** SUMMARY ***
Total pot 250 | Rake 0


PokerStars Hand #75031: Hold'em No Limit (50/100) - 2019/07/11 20:50:31 ET
Table 'Pluribus Session 75' 6-max (Play Money) Seat #6 is the button
Seat 1: MrWhite (10000 in chips)
Seat 2: MrOrange (10000 in chips)
Seat 3: Hattori (10000 in chips)
Seat 4: MrBlue (10000 in chips)
Seat 5: Pluribus (10000 in chips)
Seat 6: Budd (10000 in chips)
MrWhite: posts small blind 50
MrOrange: posts big blind 100
*** HOLE CARDS ***
Dealt to MrWhite [Ah Jh]
Dealt to MrOrange [Jc Js]
Dealt to Hattori [6c Tc]
Dealt to MrBlue [Jd 9s]
Dealt to Pluribus [8s Qs]
Dealt to Budd [4s Qd]
Hattori: folds
MrBlue: folds
Pluribus: raises 125 to 225
Budd: folds
MrWhite: raises 550 to 775
MrOrange: raises 825 to 1600
Pluribus: folds
MrWhite: calls 825
*** FLOP *** [6s Qc 2c]
MrWhite: checks
MrOrange: checks
*** TURN *** [6s Qc 2c] [Th]
MrWhite: checks
MrOrange: checks
*** RIVER *** [6s Qc 2c] [Th] [4d]
MrWhite: checks
MrOrange: checks
*** SHOWDOWN ***
MrOrange: shows [Jc Js]
MrOrange collected 3425.0 from pot
*** SUMMARY ***
Total pot 3425 | Rake 0
Board [6s Qc 2c Th 4d]
Seat 1: MrWhite showed [Ah Jh] and lost
Seat 2: MrOrange showed [Jc Js] and won (3425.0)


PokerStars Hand #75032: Hold'em No Limit (50/100) - 2019/07/11 20:50:32 ET
Table 'Pluribus Session 75' 6-max (Play Money) Seat #6 is the button
Seat 1: MrOrange (10000 in chips)
Seat 2: Hattori (10000 in chips)
Seat 3: MrBlue (10000 in chips)
Seat 4: Pluribus (10000 in chips)
Seat 5: Budd (10000 in chips)
Seat 6: MrWhite (10000 in chips)
MrOrange: posts small blind 50
Hattori: posts big blind 100
*** HOLE CARDS ***
Dealt to MrOrange [6c 3c]
Dealt to Hattori [5d Qd]
Dealt to MrBlue [5h Jd]
Dealt to Pluribus [4d 4s]
Dealt to Budd [2s Tc]
Dealt to MrWhite [Ah Qc]
MrBlue: folds
Pluribus: raises 125 to 225
Budd: folds
MrWhite: raises 300 to 525
MrOrange: folds
Hattori: folds
Pluribus: calls 300
*** FLOP *** [Qh 6d Th]
Pluribus: checks
MrWhite: bets 999
Pluribus: folds
Uncalled bet (999) returned to MrWhite
MrWhite collected 1200.0 from pot
*** SUMMARY ***
Total pot 1200 | Rake 0
Board [Qh 6d Th]


PokerStars Hand #75033: Hold'em No Limit (50/100) - 2019/07/11 20:50:33 ET
Table 'Pluribus Session 75' 6-max (Play Money) Seat #6 is the button
Seat 1: Hattori (10000 in chips)
Seat 2: MrBlue (10000 in chips)
Seat 3: Pluribus (10000 in chips)
Seat 4: Budd (10000 in chips)
Seat 5: MrWhite (10000 in chips)
Seat 6: MrOrange (10000 in chips)
Hattori: posts small blind 50
MrBlue: posts big blind 100
*** HOLE CARDS ***
Dealt to Hattori [Qs 7s]
Dealt to MrBlue [Kd 3h]
Dealt to Pluribus [4h 4s]
Dealt to Budd [7c 9c]
Dealt to MrWhite [9d Ah]
Dealt to MrOrange [5s Ts]
Pluribus: raises 100 to 200
Budd: folds
MrWhite: folds
MrOrange: folds
Hattori: folds
MrBlue: folds
Uncalled bet (100) returned to Pluribus
Pluribus collected 250.0 from pot
*** SUMMARY ***
Total pot 250 | Rake 0


PokerStars Hand #75034: Hold'em No Limit (50/100) - 2019/07/11 20:50:34 ET
Table 'Pluribus Session 75' 6-max (Play Money) Seat #6 is the button
Seat 1: MrBlue (10000 in chips)
Seat 2: Pluribus (10000 in chips)
Seat 3: Budd (10000 in chips)
Seat 4: MrWhite (10000 in chips)
Seat 5: MrOrange (10000 in chips)
Seat 6: Hattori (10000 in chips)
MrBlue: posts small blind 50
Pluribus: posts big blind 100
*** HOLE CARDS ***
Dealt to MrBlue [3h Jh]
Dealt to Pluribus [9c 6s]
Dealt to Budd [Tc 3c]
Dealt to MrWhite [7d Kh]
Dealt to MrOrange [4h 9s]
Dealt to Hattori [9h 4s]
Budd: folds
MrWhite: folds
MrOrange: folds
Hattori: folds
MrBlue: raises 200 to 300
Pluribus: folds
Uncalled bet (200) returned to MrBlue
MrBlue collected 200.0 from pot
*** SUMMARY ***
Total pot 200 | Rake 0


PokerStars Hand #75035: Hold'em No Limit (50/100) - 2019/07/11 20:50:35 ET
Table 'Pluribus Session 75' 6-max (Play Money) Seat #6 is the button
Seat 1: Pluribus (10000 in chips)
Seat 2: Budd (10000 in chips)
Seat 3: MrWhite (10000 in chips)
Seat 4: MrOrange (10000 in chips)
Seat 5: Hattori (10000 in chips)
Seat 6: MrBlue (10000 in chips)
Pluribus: posts small blind 50
Budd: posts big blind 100
*** HOLE CARDS ***
Dealt to Pluribus [Qs 8d]
Dealt to Budd [Kh 9c]
Dealt to MrWhite [Ts Ac]
Dealt to MrOrange [Kd 9d]
Dealt to Hattori [Ad 4s]
Dealt to MrBlue [Kc 2c]
MrWhite: raises 125 to 225
MrOrange: folds
Hattori: folds
MrBlue: folds
Pluribus: folds
Budd: folds
Uncalled bet (125) returned to MrWhite
MrWhite collected 250.0 from pot
*** SUMMARY ***
Total pot 250 | Rake 0


PokerStars Hand #75036: Hold'em No Limit (50/100) - 2019/07/11 20:50:36 ET
Table 'Pluribus Session 75' 6-max (Play Money) Seat #6 is the button
Seat 1: Budd (10000 in chips)
Seat 2: MrWhite (10000 in chips)
Seat 3: MrOrange (10000 in chips)
Seat 4: Hattori (10000 in chips)
Seat 5: MrBlue (10000 in chips)
Seat 6: Pluribus (10000 in chips)
Budd: posts small blind 50
MrWhite: posts big blind 100
*** HOLE CARDS ***
Dealt to Budd [2s 2h]
Dealt to MrWhite [5d 9c]
Dealt to MrOrange [8s Kh]
Dealt to Hattori [7c 8h]
Dealt to MrBlue [6s Jc]
Dealt to Pluribus [9d 4c]
MrOrange: folds
Hattori: folds
MrBlue: folds
Pluribus: folds
Budd: raises 200 to 300
MrWhite: calls 200
*** FLOP *** [8d 6h 4h]
Budd: checks
MrWhite: bets 450
Budd: folds
Uncalled bet (450) returned to MrWhite
MrWhite collected 600.0 from pot
*** SUMMARY ***
Total pot 600 | Rake 0
Board [8d 6h 4h]


PokerStars Hand #75037: Hold'em No Limit (50/100) - 2019/07/11 20:50:37 ET
Table 'Pluribus Session 75' 6-max (Play Money) Seat #6 is the button
Seat 1: MrWhite (10000 in chips)
Seat 2: MrOrange (10000 in chips)
Seat 3: Hattori (10000 in chips)
Seat 4: MrBlue (10000 in chips)
Seat 5: Pluribus (10000 in chips)
Seat 6: Budd (10000 in chips)
MrWhite: posts small blind 50
MrOrange: posts big blind 100
*** HOLE CARDS ***
Dealt to MrWhite [9d Td]
Dealt to MrOrange [5h Kc]
Dealt to Hattori [4c Qd]
Dealt to MrBlue [Ts 4s]
Dealt to Pluribus [Kd Ah]
Dealt to Budd [6c 9s]
Hattori: folds
MrBlue: folds
Pluribus: raises 100 to 200
Budd: folds
MrWhite: raises 477 to 677
MrOrange: folds
Pluribus: calls 477
*** FLOP *** [Jd 7c 9c]
MrWhite: checks
Pluribus: checks
*** TURN *** [Jd 7c 9c] [Jc]
MrWhite: checks
Pluribus: checks
*** RIVER *** [Jd 7c 9c] [Jc] [Qh]
MrWhite: checks
Pluribus: checks
*** SHOWDOWN ***
MrWhite: shows [9d Td]
MrWhite collected 1454.0 from pot
*** SUMMARY ***
Total pot 1454 | Rake 0
Board [Jd 7c 9c Jc Qh]
Seat 1: MrWhite showed [9d Td] and won (1454.0)
Seat 5: Pluribus showed [Kd Ah] and lost


PokerStars Hand #75038: Hold'em No Limit (50/100) - 2019/07/11 20:50:38 ET
Table 'Pluribus Session 75' 6-max (Play Money) Seat #6 is the button
Seat 1: MrOrange (10000 in chips)
Seat 2: Hattori (10000 in chips)
Seat 3: MrBlue (10000 in chips)
Seat 4: Pluribus (10000 in chips)
Seat 5: Budd (10000 in chips)
Seat 6: MrWhite (10000 in chips)
MrOrange: posts small blind 50
Hattori: posts big blind 100
*** HOLE CARDS ***
Dealt to MrOrange [5s Js]
Dealt to Hattori [Kd 2h]
Dealt to MrBlue [7s As]
Dealt to Pluribus [4h Th]
Dealt to Budd [5h 9h]
Dealt to MrWhite [9s 4c]
MrBlue: raises 125 to 225
Pluribus: folds
Budd: folds
MrWhite: folds
MrOrange: folds
Hattori: folds
Uncalled bet (125) returned to MrBlue
MrBlue collected 250.0 from pot
*** SUMMARY ***
Total pot 250 | Rake 0


PokerStars Hand #75039: Hold'em No Limit (50/100) - 2019/07/11 20:50:39 ET
Table 'Pluribus Session 75' 6-max (Play Money) Seat #6 is the button
Seat 1: Hattori (10000 in chips)
Seat 2: MrBlue (10000 in chips)
Seat 3: Pluribus (10000 in chips)
Seat 4: Budd (10000 in chips)
Seat 5: MrWhite (10000 in chips)
Seat 6: MrOrange (10000 in chips)
Hattori: posts small blind 50
MrBlue: posts big blind 100
*** HOLE CARDS ***
Dealt to Hattori [7d Kc]
Dealt to MrBlue [Js 5h]
Dealt to Pluribus [5d 9h]
Dealt to Budd [Jc 3d]
Dealt to MrWhite [3s Th]
Dealt to MrOrange [3c Ts]
Pluribus: folds
Budd: folds
MrWhite: folds
MrOrange: folds
Hattori: raises 135 to 235
MrBlue: calls 135
*** FLOP *** [9s 7s Ah]
Hattori: checks
MrBlue: checks
*** TURN *** [9s 7s Ah] [8d]
Hattori: checks
MrBlue: bets 352
Hattori: calls 352
*** RIVER *** [9s 7s Ah] [8d] [2c]
Hattori: checks
MrBlue: bets 880
Hattori: folds
Uncalled bet (880) returned to MrBlue
MrBlue collected 1174.0 from pot
*** SUMMARY ***
Total pot 1174 | Rake 0
Board [9s 7s Ah 8d 2c]


PokerStars Hand #75040: Hold'em No Limit (50/100) - 2019/07/11 20:50:40 ET
Table 'Pluribus Session 75' 6-max (Play Money) Seat #6 is the button
Seat 1: MrBlue (10000 in chips)
Seat 2: Pluribus (10000 in chips)
Seat 3: Budd (10000 in chips)
Seat 4: MrWhite (10000 in chips)
Seat 5: MrOrange (10000 in chips)
Seat 6: Hattori (10000 in chips)
MrBlue: posts small blind 50
Pluribus: posts big blind 100
*** HOLE CARDS ***
Dealt to MrBlue [2s 2c]
Dealt to Pluribus [7d 8c]
Dealt to Budd [9h 9s]
Dealt to MrWhite [8h 2d]
Dealt to MrOrange [Ah 3s]
Dealt to Hattori [5s 5d]
Budd: raises 125 to 225
MrWhite: folds
MrOrange: folds
Hattori: calls 225
MrBlue: calls 175
Pluribus: folds
*** FLOP *** [As 3h Kd]
MrBlue: checks
Budd: checks
Hattori: checks
*** TURN *** [As 3h Kd] [6d]
MrBlue: checks
Budd: checks
Hattori: checks
*** RIVER *** [As 3h Kd] [6d] [Js]
MrBlue: checks
Budd: checks
Hattori: checks
*** SHOWDOWN ***
Budd: shows [9h 9s]
Budd collected 775.0 from pot
*** SUMMARY ***
Total pot 775 | Rake 0
Board [As 3h Kd 6d Js]
Seat 1: MrBlue showed [2s 2c] and lost
Seat 3: Budd showed [9h 9s] and won (775.0)
Seat 6: Hattori showed [5s 5d] and lost


PokerStars Hand #75041: Hold'em No Limit (50/100) - 2019/07/11 20:50:41 ET
Table 'Pluribus Session 75' 6-max (Play Money) Seat #6 is the button
Seat 1: Pluribus (10000 in chips)
Seat 2: Budd (10000 in chips)
Seat 3: MrWhite (10000 in chips)
Seat 4: MrOrange (10000 in chips)
Seat 5: Hattori (10000 in chips)
Seat 6: MrBlue (10000 in chips)
Pluribus: posts small blind 50
Budd: posts big blind 100
*** HOLE CARDS ***
Dealt to Pluribus [Qs 9d]
Dealt to Budd [3c Jc]
Dealt to MrWhite [Kc 4h]
Dealt to MrOrange [6s 4c]
Dealt to Hattori [Ac Jh]
Dealt to MrBlue [8s 2d]
MrWhite: folds
MrOrange: folds
Hattori: raises 111 to 211
MrBlue: folds
Pluribus: folds
Budd: calls 111
*** FLOP *** [Qd 2h 5c]
Budd: checks
Hattori: checks
*** TURN *** [Qd 2h 5c] [8h]
Budd: checks
Hattori: checks
*** RIVER *** [Qd 2h 5c] [8h] [Kd]
Budd: checks
Hattori: checks
*** SHOWDOWN ***
Hattori: shows [Ac Jh]
Hattori collected 472.0 from pot
*** SUMMARY ***
Total pot 472 | Rake 0
Board [Qd 2h 5c 8h Kd]
Seat 2: Budd showed [3c Jc] and lost
Seat 5: Hattori showed [Ac Jh] and won (472.0)


PokerStars Hand #75042: Hold'em No Limit (50/100) - 2019/07/11 20:50:42 ET
Table 'Pluribus Session 75' 6-max (Play Money) Seat #6 is the button
Seat 1: Budd (10000 in chips)
Seat 2: MrWhite (10000 in chips)
Seat 3: MrOrange (10000 in chips)
Seat 4: Hattori (10000 in chips)
Seat 5: MrBlue (10000 in chips)
Seat 6: Pluribus (10000 in chips)
Budd: posts small blind 50
MrWhite: posts big blind 100
*** HOLE CARDS ***
Dealt to Budd [Ks 5d]
Dealt to MrWhite [9s 6h]
Dealt to MrOrange [3c 6c]
Dealt to Hattori [8h 4c]
Dealt to MrBlue [4d Jd]
Dealt to Pluribus [3d 3s]
MrOrange: folds
Hattori: folds
MrBlue: raises 125 to 225
Pluribus: calls 225
Budd: folds
MrWhite: folds
*** FLOP *** [Kd 6d Ac]
MrBlue: bets 250
Pluribus: calls 250
*** TURN *** [Kd 6d Ac] [8s]
MrBlue: bets 1875
Pluribus: folds
Uncalled bet (1875) returned to MrBlue
MrBlue collected 1100.0 from pot
*** SUMMARY ***
Total pot 1100 | Rake 0
Board [Kd 6d Ac 8s]


PokerStars Hand #75043: Hold'em No Limit (50/100) - 2019/07/11 20:50:43 ET
Table 'Pluribus Session 75' 6-max (Play Money) Seat #6 is the button
Seat 1: MrWhite (10000 in chips)
Seat 2: MrOrange (10000 in chips)
Seat 3: Hattori (10000 in chips)
Seat 4: MrBlue (10000 in chips)
Seat 5: Pluribus (10000 in chips)
Seat 6: Budd (10000 in chips)
MrWhite: posts small blind 50
MrOrange: posts big blind 100
*** HOLE CARDS ***
Dealt to MrWhite [As Ac]
Dealt to MrOrange [4h 5d]
Dealt to Hattori [Qd Jh]
Dealt to MrBlue [4s 9c]
Dealt to Pluribus [Qh Th]
Dealt to Budd [8s Js]
Hattori: folds
MrBlue: folds
Pluribus: raises 100 to 200
Budd: raises 520 to 720
MrWhite: raises 1305 to 2025
MrOrange: folds
Pluribus: folds
Budd: folds
Uncalled bet (1305) returned to MrWhite
MrWhite collected 1740.0 from pot
*** SUMMARY ***
Total pot 1740 | Rake 0


PokerStars Hand #75044: Hold'em No Limit (50/100) - 2019/07/11 20:50:44 ET
Table 'Pluribus Session 75' 6-max (Play Money) Seat #6 is the button
Seat 1: MrOrange (10000 in chips)
Seat 2: Hattori (10000 in chips)
Seat 3: MrBlue (10000 in chips)
Seat 4: Pluribus (10000 in chips)
Seat 5: Budd (10000 in chips)
Seat 6: MrWhite (10000 in chips)
MrOrange: posts small blind 50
Hattori: posts big blind 100
*** HOLE CARDS ***
Dealt to MrOrange [Ts 5c]
Dealt to Hattori [7c 5h]
Dealt to MrBlue [7h 5d]
Dealt to Pluribus [Qc Ad]
Dealt to Budd [5s 2c]
Dealt to MrWhite [Jd Kc]
MrBlue: folds
Pluribus: raises 125 to 225
Budd: folds
MrWhite: folds
MrOrange: folds
Hattori: calls 125
*** FLOP *** [4s 9c 9d]
Hattori: checks
Pluribus: checks
*** TURN *** [4s 9c 9d] [Qs]
Hattori: checks
Pluribus: bets 250
Hattori: folds
Uncalled bet (250) returned to Pluribus
Pluribus collected 500.0 from pot
*** SUMMARY ***
Total pot 500 | Rake 0
Board [4s 9c 9d Qs]


PokerStars Hand #75045: Hold'em No Limit (50/100) - 2019/07/11 20:50:45 ET
Table 'Pluribus Session 75' 6-max (Play Money) Seat #6 is the button
Seat 1: Hattori (10000 in chips)
Seat 2: MrBlue (10000 in chips)
Seat 3: Pluribus (10000 in chips)
Seat 4: Budd (10000 in chips)
Seat 5: MrWhite (10000 in chips)
Seat 6: MrOrange (10000 in chips)
Hattori: posts small blind 50
MrBlue: posts big blind 100
*** HOLE CARDS ***
Dealt to Hattori [7c Ac]
Dealt to MrBlue [Js Ks]
Dealt to Pluribus [Qd 4s]
Dealt to Budd [Qc Jh]
Dealt to MrWhite [Kd 8d]
Dealt to MrOrange [7s 4d]
Pluribus: folds
Budd: raises 125 to 225
MrWhite: folds
MrOrange: folds
Hattori: calls 175
MrBlue: calls 125
*** FLOP *** [Kh Tc 6c]
Hattori: checks
MrBlue: checks
Budd: bets 506
Hattori: raises 1144 to 1650
MrBlue: folds
Budd: calls 1144
*** TURN *** [Kh Tc 6c] [6h]
Hattori: checks
Budd: checks
*** RIVER *** [Kh Tc 6c] [6h] [3s]
Hattori: checks
Budd: checks
*** SHOWDOWN ***
Hattori: shows [7c Ac]
Hattori collected 3975.0 from pot
*** SUMMARY ***
Total pot 3975 | Rake 0
Board [Kh Tc 6c 6h 3s]
Seat 1: Hattori showed [7c Ac] and won (3975.0)
Seat 4: Budd showed [Qc Jh] and lost


PokerStars Hand #75046: Hold'em No Limit (50/100) - 2019/07/11 20:50:46 ET
Table 'Pluribus Session 75' 6-max (Play Money) Seat #6 is the button
Seat 1: MrBlue (10000 in chips)
Seat 2: Pluribus (10000 in chips)
Seat 3: Budd (10000 in chips)
Seat 4: MrWhite (10000 in chips)
Seat 5: MrOrange (10000 in chips)
Seat 6: Hattori (10000 in chips)
MrBlue: posts small blind 50
Pluribus: posts big blind 100
*** HOLE CARDS ***
Dealt to MrBlue [6s 4d]
Dealt to Pluribus [Kd Jh]
Dealt to Budd [2s Ac]
Dealt to MrWhite [6c Ah]
Dealt to MrOrange [Ad Jd]
Dealt to Hattori [2d Js]
Budd: folds
MrWhite: folds
MrOrange: raises 122 to 222
Hattori: folds
MrBlue: folds
Pluribus: calls 122
*** FLOP *** [8s As Jc]
Pluribus: checks
MrOrange: bets 275
Pluribus: calls 275
*** TURN *** [8s As Jc] [Ts]
Pluribus: checks
MrOrange: checks
*** RIVER *** [8s As Jc] [Ts] [8c]
Pluribus: checks
MrOrange: checks
*** SHOWDOWN ***
MrOrange: shows [Ad Jd]
MrOrange collected 1044.0 from pot
*** SUMMARY ***
Total pot 1044 | Rake 0
Board [8s As Jc Ts 8c]
Seat 2: Pluribus showed [Kd Jh] and lost
Seat 5: MrOrange showed [Ad Jd] and won (1044.0)


PokerStars Hand #75047: Hold'em No Limit (50/100) - 2019/07/11 20:50:47 ET
Table 'Pluribus Session 75' 6-max (Play Money) Seat #6 is the button
Seat 1: Pluribus (10000 in chips)
Seat 2: Budd (10000 in chips)
Seat 3: MrWhite (10000 in chips)
Seat 4: MrOrange (10000 in chips)
Seat 5: Hattori (10000 in chips)
Seat 6: MrBlue (10000 in chips)
Pluribus: posts small blind 50
Budd: posts big blind 100
*** HOLE CARDS ***
Dealt to Pluribus [4c Kh]
Dealt to Budd [Qh Ah]
Dealt to MrWhite [Th Jh]
Dealt to MrOrange [9c 5s]
Dealt to Hattori [Qc Jd]
Dealt to MrBlue [6c 7s]
MrWhite: raises 125 to 225
MrOrange: folds
Hattori: folds
MrBlue: folds
Pluribus: folds
Budd: calls 125
*** FLOP *** [5h 2h 8s]
Budd: checks
MrWhite: bets 375
Budd: raises 937 to 1312
MrWhite: folds
Uncalled bet (937) returned to Budd
Budd collected 1250.0 from pot
*** SUMMARY ***
Total pot 1250 | Rake 0
Board [5h 2h 8s]


PokerStars Hand #75048: Hold'em No Limit (50/100) - 2019/07/11 20:50:48 ET
Table 'Pluribus Session 75' 6-max (Play Money) Seat #6 is the button
Seat 1: Budd (10000 in chips)
Seat 2: MrWhite (10000 in chips)
Seat 3: MrOrange (10000 in chips)
Seat 4: Hattori (10000 in chips)
Seat 5: MrBlue (10000 in chips)
Seat 6: Pluribus (10000 in chips)
Budd: posts small blind 50
MrWhite: posts big blind 100
*** HOLE CARDS ***
Dealt to Budd [Qc 7s]
Dealt to MrWhite [3h 4s]
Dealt to MrOrange [9c Kc]
Dealt to Hattori [Td 2c]
Dealt to MrBlue [9d 4d]
Dealt to Pluribus [As 6c]
MrOrange: folds
Hattori: folds
MrBlue: folds
Pluribus: raises 150 to 250
Budd: folds
MrWhite: folds
Uncalled bet (150) returned to Pluribus
Pluribus collected 250.0 from pot
*** SUMMARY ***
Total pot 250 | Rake 0


PokerStars Hand #75049: Hold'em No Limit (50/100) - 2019/07/11 20:50:49 ET
Table 'Pluribus Session 75' 6-max (Play Money) Seat #6 is the button
Seat 1: MrWhite (10000 in chips)
Seat 2: MrOrange (10000 in chips)
Seat 3: Hattori (10000 in chips)
Seat 4: MrBlue (10000 in chips)
Seat 5: Pluribus (10000 in chips)
Seat 6: Budd (10000 in chips)
MrWhite: posts small blind 50
MrOrange: posts big blind 100
*** HOLE CARDS ***
Dealt to MrWhite [8c 8h]
Dealt to MrOrange [9s 2c]
Dealt to Hattori [Jc 4h]
Dealt to MrBlue [Jd 3h]
Dealt to Pluribus [7h 2h]
Dealt to Budd [Qd Ad]
Hattori: folds
MrBlue: folds
Pluribus: folds
Budd: raises 150 to 250
MrWhite: raises 600 to 850
MrOrange: folds
Budd: calls 600
*** FLOP *** [8s 6d 7d]
MrWhite: bets 1350
Budd: calls 1350
*** TURN *** [8s 6d 7d] [5s]
MrWhite: checks
Budd: bets 1950
MrWhite: calls 1950
*** RIVER *** [8s 6d 7d] [5s] [3s]
MrWhite: checks
Budd: bets 5850 and is all-in
MrWhite: folds
Uncalled bet (5850) returned to Budd
Budd collected 8400.0 from pot
*** SUMMARY ***
Total pot 8400 | Rake 0
Board [8s 6d 7d 5s 3s]


PokerStars Hand #75050: Hold'em No Limit (50/100) - 2019/07/11 20:50:50 ET
Table 'Pluribus Session 75' 6-max (Play Money) Seat #6 is the button
Seat 1: MrOrange (10000 in chips)
Seat 2: Hattori (10000 in chips)
Seat 3: MrBlue (10000 in chips)
Seat 4: Pluribus (10000 in chips)
Seat 5: Budd (10000 in chips)
Seat 6: MrWhite (10000 in chips)
MrOrange: posts small blind 50
Hattori: posts big blind 100
*** HOLE CARDS ***
Dealt to MrOrange [2c 7c]
Dealt to Hattori [3h 9s]
Dealt to MrBlue [5c 3c]
Dealt to Pluribus [4c 6h]
Dealt to Budd [2d Qs]
Dealt to MrWhite [7d 4d]
MrBlue: raises 125 to 225
Pluribus: folds
Budd: folds
MrWhite: folds
MrOrange: folds
Hattori: folds
Uncalled bet (125) returned to MrBlue
MrBlue collected 250.0 from pot
*** SUMMARY ***
Total pot 250 | Rake 0


PokerStars Hand #75051: Hold'em No Limit (50/100) - 2019/07/11 20:50:51 ET
Table 'Pluribus Session 75' 6-max (Play Money) Seat #6 is the button
Seat 1: Hattori (10000 in chips)
Seat 2: MrBlue (10000 in chips)
Seat 3: Pluribus (10000 in chips)
Seat 4: Budd (10000 in chips)
Seat 5: MrWhite (10000 in chips)
Seat 6: MrOrange (10000 in chips)
Hattori: posts small blind 50
MrBlue: posts big blind 100
*** HOLE CARDS ***
Dealt to Hattori [5s As]
Dealt to MrBlue [5h Jd]
Dealt to Pluribus [Qd 4h]
Dealt to Budd [Ac Td]
Dealt to MrWhite [Qc Ks]
Dealt to MrOrange [2h 7d]
Pluribus: folds
Budd: raises 125 to 225
MrWhite: calls 225
MrOrange: folds
Hattori: raises 1075 to 1300
MrBlue: folds
Budd: folds
MrWhite: folds
Uncalled bet (1075) returned to Hattori
Hattori collected 775.0 from pot
*** SUMMARY ***
Total pot 775 | Rake 0


PokerStars Hand #75052: Hold'em No Limit (50/100) - 2019/07/11 20:50:52 ET
Table 'Pluribus Session 75' 6-max (Play Money) Seat #6 is the button
Seat 1: MrBlue (10000 in chips)
Seat 2: Pluribus (10000 in chips)
Seat 3: Budd (10000 in chips)
Seat 4: MrWhite (10000 in chips)
Seat 5: MrOrange (10000 in chips)
Seat 6: Hattori (10000 in chips)
MrBlue: posts small blind 50
Pluribus: posts big blind 100
*** HOLE CARDS ***
Dealt to MrBlue [9s 4c]
Dealt to Pluribus [9d 3d]
Dealt to Budd [Ad 6s]
Dealt to MrWhite [4h 5h]
Dealt to MrOrange [Jh Tc]
Dealt to Hattori [Kh 7d]
Budd: folds
MrWhite: raises 125 to 225
MrOrange: folds
Hattori: folds
MrBlue: folds
Pluribus: folds
Uncalled bet (125) returned to MrWhite
MrWhite collected 250.0 from pot
*** SUMMARY ***
Total pot 250 | Rake 0


PokerStars Hand #75053: Hold'em No Limit (50/100) - 2019/07/11 20:50:53 ET
Table 'Pluribus Session 75' 6-max (Play Money) Seat #6 is the button
Seat 1: Pluribus (10000 in chips)
Seat 2: Budd (10000 in chips)
Seat 3: MrWhite (10000 in chips)
Seat 4: MrOrange (10000 in chips)
Seat 5: Hattori (10000 in chips)
Seat 6: MrBlue (10000 in chips)
Pluribus: posts small blind 50
Budd: posts big blind 100
*** HOLE CARDS ***
Dealt to Pluribus [8c 9s]
Dealt to Budd [7h 9d]
Dealt to MrWhite [6s Jh]
Dealt to MrOrange [8h Ad]
Dealt to Hattori [6c Qs]
Dealt to MrBlue [Jc 4d]
MrWhite: folds
MrOrange: folds
Hattori: folds
MrBlue: folds
Pluribus: raises 175 to 275
Budd: calls 175
*** FLOP *** [Kc 8s 4c]
Pluribus: checks
Budd: checks
*** TURN *** [Kc 8s 4c] [Qd]
Pluribus: checks
Budd: checks
*** RIVER *** [Kc 8s 4c] [Qd] [5c]
Pluribus: checks
Budd: checks
*** SHOWDOWN ***
Pluribus: shows [8c 9s]
Pluribus collected 550.0 from pot
*** SUMMARY ***
Total pot 550 | Rake 0
Board [Kc 8s 4c Qd 5c]
Seat 1: Pluribus showed [8c 9s] and won (550.0)
Seat 2: Budd showed [7h 9d] and lost


PokerStars Hand #75054: Hold'em No Limit (50/100) - 2019/07/11 20:50:54 ET
Table 'Pluribus Session 75' 6-max (Play Money) Seat #6 is the button
Seat 1: Budd (10000 in chips)
Seat 2: MrWhite (10000 in chips)
Seat 3: MrOrange (10000 in chips)
Seat 4: Hattori (10000 in chips)
Seat 5: MrBlue (10000 in chips)
Seat 6: Pluribus (10000 in chips)
Budd: posts small blind 50
MrWhite: posts big blind 100
*** HOLE CARDS ***
Dealt to Budd [9d Qs]
Dealt to MrWhite [6s Jh]
Dealt to MrOrange [6d 8s]
Dealt to Hattori [7h Kd]
Dealt to MrBlue [3d 2d]
Dealt to Pluribus [3c 9c]
MrOrange: folds
Hattori: folds
MrBlue: raises 125 to 225
Pluribus: folds
Budd: folds
MrWhite: folds
Uncalled bet (125) returned to MrBlue
MrBlue collected 250.0 from pot
*** SUMMARY ***
Total pot 250 | Rake 0


PokerStars Hand #75055: Hold'em No Limit (50/100) - 2019/07/11 20:50:55 ET
Table 'Pluribus Session 75' 6-max (Play Money) Seat #6 is the button
Seat 1: MrWhite (10000 in chips)
Seat 2: MrOrange (10000 in chips)
Seat 3: Hattori (10000 in chips)
Seat 4: MrBlue (10000 in chips)
Seat 5: Pluribus (10000 in chips)
Seat 6: Budd (10000 in chips)
MrWhite: posts small blind 50
MrOrange: posts big blind 100
*** HOLE CARDS ***
Dealt to MrWhite [Ks Jh]
Dealt to MrOrange [7h Ah]
Dealt to Hattori [5s 5h]
Dealt to MrBlue [Kc 6d]
Dealt to Pluribus [6s 8d]
Dealt to Budd [Th Kd]
Hattori: raises 100 to 200
MrBlue: folds
Pluribus: folds
Budd: folds
MrWhite: folds
MrOrange: calls 100
*** FLOP *** [8c Jc Ac]
MrOrange: checks
Hattori: checks
*** TURN *** [8c Jc Ac] [Jd]
MrOrange: checks
Hattori: checks
*** RIVER *** [8c Jc Ac] [Jd] [9d]
MrOrange: bets 385
Hattori: folds
Uncalled bet (385) returned to MrOrange
MrOrange collected 450.0 from pot
*** SUMMARY ***
Total pot 450 | Rake 0
Board [8c Jc Ac Jd 9d]


PokerStars Hand #75056: Hold'em No Limit (50/100) - 2019/07/11 20:50:56 ET
Table 'Pluribus Session 75' 6-max (Play Money) Seat #6 is the button
Seat 1: MrOrange (10000 in chips)
Seat 2: Hattori (10000 in chips)
Seat 3: MrBlue (10000 in chips)
Seat 4: Pluribus (10000 in chips)
Seat 5: Budd (10000 in chips)
Seat 6: MrWhite (10000 in chips)
MrOrange: posts small blind 50
Hattori: posts big blind 100
*** HOLE CARDS ***
Dealt to MrOrange [4d 6d]
Dealt to Hattori [2d Tc]
Dealt to MrBlue [9s Js]
Dealt to Pluribus [9d 6s]
Dealt to Budd [5c Qc]
Dealt to MrWhite [8s 7c]
MrBlue: raises 125 to 225
Pluribus: folds
Budd: folds
MrWhite: folds
MrOrange: folds
Hattori: folds
Uncalled bet (125) returned to MrBlue
MrBlue collected 250.0 from pot
*** SUMMARY ***
Total pot 250 | Rake 0


PokerStars Hand #75057: Hold'em No Limit (50/100) - 2019/07/11 20:50:57 ET
Table 'Pluribus Session 75' 6-max (Play Money) Seat #6 is the button
Seat 1: Hattori (10000 in chips)
Seat 2: MrBlue (10000 in chips)
Seat 3: Pluribus (10000 in chips)
Seat 4: Budd (10000 in chips)
Seat 5: MrWhite (10000 in chips)
Seat 6: MrOrange (10000 in chips)
Hattori: posts small blind 50
MrBlue: posts big blind 100
*** HOLE CARDS ***
Dealt to Hattori [Qc Qh]
Dealt to MrBlue [Kc 2c]
Dealt to Pluribus [7h Jh]
Dealt to Budd [9c 2d]
Dealt to MrWhite [4s 4c]
Dealt to MrOrange [5s 2s]
Pluribus: folds
Budd: folds
MrWhite: raises 125 to 225
MrOrange: folds
Hattori: raises 925 to 1150
MrBlue: folds
MrWhite: folds
Uncalled bet (925) returned to Hattori
Hattori collected 550.0 from pot
*** SUMMARY ***
Total pot 550 | Rake 0


PokerStars Hand #75058: Hold'em No Limit (50/100) - 2019/07/11 20:50:58 ET
Table 'Pluribus Session 75' 6-max (Play Money) Seat #6 is the button
Seat 1: MrBlue (10000 in chips)
Seat 2: Pluribus (10000 in chips)
Seat 3: Budd (10000 in chips)
Seat 4: MrWhite (10000 in chips)
Seat 5: MrOrange (10000 in chips)
Seat 6: Hattori (10000 in chips)
MrBlue: posts small blind 50
Pluribus: posts big blind 100
*** HOLE CARDS ***
Dealt to MrBlue [9s 4h]
Dealt to Pluribus [Js Kc]
Dealt to Budd [Ad 5c]
Dealt to MrWhite [Kh 4d]
Dealt to MrOrange [7c Qs]
Dealt to Hattori [9h 4c]
Budd: folds
MrWhite: folds
MrOrange: folds
Hattori: folds
MrBlue: folds
Uncalled bet (50) returned to Pluribus
Pluribus collected 100.0 from pot
*** SUMMARY ***
Total pot 100 | Rake 0


PokerStars Hand #75059: Hold'em No Limit (50/100) - 2019/07/11 20:50:59 ET
Table 'Pluribus Session 75' 6-max (Play Money) Seat #6 is the button
Seat 1: Pluribus (10000 in chips)
Seat 2: Budd (10000 in chips)
Seat 3: MrWhite (10000 in chips)
Seat 4: MrOrange (10000 in chips)
Seat 5: Hattori (10000 in chips)
Seat 6: MrBlue (10000 in chips)
Pluribus: posts small blind 50
Budd: posts big blind 100
*** HOLE CARDS ***
Dealt to Pluribus [8s 7c]
Dealt to Budd [Kh 3d]
Dealt to MrWhite [4c 3s]
Dealt to MrOrange [6s 2h]
Dealt to Hattori [4s 9s]
Dealt to MrBlue [Ac 7d]
MrWhite: folds
MrOrange: folds
Hattori: folds
MrBlue: raises 125 to 225
Pluribus: folds
Budd: folds
Uncalled bet (125) returned to MrBlue
MrBlue collected 250.0 from pot
*** SUMMARY ***
Total pot 250 | Rake 0


PokerStars Hand #75060: Hold'em No Limit (50/100) - 2019/07/11 20:51:00 ET
Table 'Pluribus Session 75' 6-max (Play Money) Seat #6 is the button
Seat 1: Budd (10000 in chips)
Seat 2: MrWhite (10000 in chips)
Seat 3: MrOrange (10000 in chips)
Seat 4: Hattori (10000 in chips)
Seat 5: MrBlue (10000 in chips)
Seat 6: Pluribus (10000 in chips)
Budd: posts small blind 50
MrWhite: posts big blind 100
*** HOLE CARDS ***
Dealt to Budd [6s 8c]
Dealt to MrWhite [5h Js]
Dealt to MrOrange [4d Qs]
Dealt to Hattori [3s 3h]
Dealt to MrBlue [Jc 9s]
Dealt to Pluribus [As Td]
MrOrange: folds
Hattori: raises 100 to 200
MrBlue: folds
Pluribus: raises 412 to 612
Budd: folds
MrWhite: folds
Hattori: calls 412
*** FLOP *** [7c Ad 7s]
Hattori: checks
Pluribus: checks
*** TURN *** [7c Ad 7s] [2d]
Hattori: checks
Pluribus: checks
*** RIVER *** [7c Ad 7s] [2d] [7d]
Hattori: bets 130
Pluribus: calls 130
*** SHOWDOWN ***
Pluribus: shows [As Td]
Pluribus collected 1634.0 from pot
*** SUMMARY ***
Total pot 1634 | Rake 0
Board [7c Ad 7s 2d 7d]
Seat 4: Hattori showed [3s 3h] and lost
Seat 6: Pluribus showed [As Td] and won (1634.0)


PokerStars Hand #75061: Hold'em No Limit (50/100) - 2019/07/11 20:51:01 ET
Table 'Pluribus Session 75' 6-max (Play Money) Seat #6 is the button
Seat 1: MrWhite (10000 in chips)
Seat 2: MrOrange (10000 in chips)
Seat 3: Hattori (10000 in chips)
Seat 4: MrBlue (10000 in chips)
Seat 5: Pluribus (10000 in chips)
Seat 6: Budd (10000 in chips)
MrWhite: posts small blind 50
MrOrange: posts big blind 100
*** HOLE CARDS ***
Dealt to MrWhite [Th Js]
Dealt to MrOrange [6c 5d]
Dealt to Hattori [Qs Ac]
Dealt to MrBlue [5s 5h]
Dealt to Pluribus [7c 9d]
Dealt to Budd [Kd 2d]
Hattori: raises 100 to 200
MrBlue: calls 200
Pluribus: folds
Budd: folds
MrWhite: folds
MrOrange: folds
*** FLOP *** [Ks 4d 3h]
Hattori: checks
MrBlue: checks
*** TURN *** [Ks 4d 3h] [Td]
Hattori: bets 425
MrBlue: folds
Uncalled bet (425) returned to Hattori
Hattori collected 550.0 from pot
*** SUMMARY ***
Total pot 550 | Rake 0
Board [Ks 4d 3h Td]


PokerStars Hand #75062: Hold'em No Limit (50/100) - 2019/07/11 20:51:02 ET
Table 'Pluribus Session 75' 6-max (Play Money) Seat #6 is the button
Seat 1: MrOrange (10000 in chips)
Seat 2: Hattori (10000 in chips)
Seat 3: MrBlue (10000 in chips)
Seat 4: Pluribus (10000 in chips)
Seat 5: Budd (10000 in chips)
Seat 6: MrWhite (10000 in chips)
MrOrange: posts small blind 50
Hattori: posts big blind 100
*** HOLE CARDS ***
Dealt to MrOrange [Td Ad]
Dealt to Hattori [Ks 2h]
Dealt to MrBlue [6s Tc]
Dealt to Pluribus [9d 7h]
Dealt to Budd [7s Kd]
Dealt to MrWhite [Kc Qs]
MrBlue: folds
Pluribus: folds
Budd: folds
MrWhite: raises 125 to 225
MrOrange: raises 875 to 1100
Hattori: folds
MrWhite: folds
Uncalled bet (875) returned to MrOrange
MrOrange collected 550.0 from pot
*** SUMMARY ***
Total pot 550 | Rake 0


PokerStars Hand #75063: Hold'em No Limit (50/100) - 2019/07/11 20:51:03 ET
Table 'Pluribus Session 75' 6-max (Play Money) Seat #6 is the button
Seat 1: Hattori (10000 in chips)
Seat 2: MrBlue (10000 in chips)
Seat 3: Pluribus (10000 in chips)
Seat 4: Budd (10000 in chips)
Seat 5: MrWhite (10000 in chips)
Seat 6: MrOrange (10000 in chips)
Hattori: posts small blind 50
MrBlue: posts big blind 100
*** HOLE CARDS ***
Dealt to Hattori [6d 7h]
Dealt to MrBlue [Kh Qh]
Dealt to Pluribus [As Td]
Dealt to Budd [Js 4c]
Dealt to MrWhite [2s 9c]
Dealt to MrOrange [Qs 3h]
Pluribus: raises 125 to 225
Budd: folds
MrWhite: folds
MrOrange: folds
Hattori: folds
MrBlue: calls 125
*** FLOP *** [5h Ks Jh]
MrBlue: checks
Pluribus: bets 500
MrBlue: calls 500
*** TURN *** [5h Ks Jh] [8h]
MrBlue: checks
Pluribus: checks
*** RIVER *** [5h Ks Jh] [8h] [Th]
MrBlue: checks
Pluribus: checks
*** SHOWDOWN ***
MrBlue: shows [Kh Qh]
MrBlue collected 1500.0 from pot
*** SUMMARY ***
Total pot 1500 | Rake 0
Board [5h Ks Jh 8h Th]
Seat 2: MrBlue showed [Kh Qh] and won (1500.0)
Seat 3: Pluribus showed [As Td] and lost


PokerStars Hand #75064: Hold'em No Limit (50/100) - 2019/07/11 20:51:04 ET
Table 'Pluribus Session 75' 6-max (Play Money) Seat #6 is the button
Seat 1: MrBlue (10000 in chips)
Seat 2: Pluribus (10000 in chips)
Seat 3: Budd (10000 in chips)
Seat 4: MrWhite (10000 in chips)
Seat 5: MrOrange (10000 in chips)
Seat 6: Hattori (10000 in chips)
MrBlue: posts small blind 50
Pluribus: posts big blind 100
*** HOLE CARDS ***
Dealt to MrBlue [7c 2c]
Dealt to Pluribus [4h Td]
Dealt to Budd [Th 6d]
Dealt to MrWhite [Ad Js]
Dealt to MrOrange [5s 5c]
Dealt to Hattori [Qd 8d]
Budd: folds
MrWhite: raises 125 to 225
MrOrange: folds
Hattori: folds
MrBlue: folds
Pluribus: folds
Uncalled bet (125) returned to MrWhite
MrWhite collected 250.0 from pot
*** SUMMARY ***
Total pot 250 | Rake 0


PokerStars Hand #75065: Hold'em No Limit (50/100) - 2019/07/11 20:51:05 ET
Table 'Pluribus Session 75' 6-max (Play Money) Seat #6 is the button
Seat 1: Pluribus (10000 in chips)
Seat 2: Budd (10000 in chips)
Seat 3: MrWhite (10000 in chips)
Seat 4: MrOrange (10000 in chips)
Seat 5: Hattori (10000 in chips)
Seat 6: MrBlue (10000 in chips)
Pluribus: posts small blind 50
Budd: posts big blind 100
*** HOLE CARDS ***
Dealt to Pluribus [Ts 3s]
Dealt to Budd [6d 7s]
Dealt to MrWhite [3d Jh]
Dealt to MrOrange [8d Kc]
Dealt to Hattori [5s 2c]
Dealt to MrBlue [2s Tc]
MrWhite: folds
MrOrange: folds
Hattori: folds
MrBlue: folds
Pluribus: calls 50
Budd: checks
*** FLOP *** [Ah 9c 6s]
Pluribus: bets 200
Budd: calls 200
*** TURN *** [Ah 9c 6s] [8c]
Pluribus: checks
Budd: checks
*** RIVER *** [Ah 9c 6s] [8c] [Jc]
Pluribus: bets 300
Budd: folds
Uncalled bet (300) returned to Pluribus
Pluribus collected 600.0 from pot
*** SUMMARY ***
Total pot 600 | Rake 0
Board [Ah 9c 6s 8c Jc]


PokerStars Hand #75066: Hold'em No Limit (50/100) - 2019/07/11 20:51:06 ET
Table 'Pluribus Session 75' 6-max (Play Money) Seat #6 is the button
Seat 1: Budd (10000 in chips)
Seat 2: MrWhite (10000 in chips)
Seat 3: MrOrange (10000 in chips)
Seat 4: Hattori (10000 in chips)
Seat 5: MrBlue (10000 in chips)
Seat 6: Pluribus (10000 in chips)
Budd: posts small blind 50
MrWhite: posts big blind 100
*** HOLE CARDS ***
Dealt to Budd [Tc 5h]
Dealt to MrWhite [6s Js]
Dealt to MrOrange [2c 3h]
Dealt to Hattori [7h Qh]
Dealt to MrBlue [3c Jh]
Dealt to Pluribus [9d Ks]
MrOrange: folds
Hattori: folds
MrBlue: folds
Pluribus: raises 125 to 225
Budd: folds
MrWhite: calls 125
*** FLOP *** [Td Th Kc]
MrWhite: checks
Pluribus: checks
*** TURN *** [Td Th Kc] [Qd]
MrWhite: bets 375
Pluribus: calls 375
*** RIVER *** [Td Th Kc] [Qd] [9h]
MrWhite: bets 625
Pluribus: folds
Uncalled bet (625) returned to MrWhite
MrWhite collected 1250.0 from pot
*** SUMMARY ***
Total pot 1250 | Rake 0
Board [Td Th Kc Qd 9h]


PokerStars Hand #75067: Hold'em No Limit (50/100) - 2019/07/11 20:51:07 ET
Table 'Pluribus Session 75' 6-max (Play Money) Seat #6 is the button
Seat 1: MrWhite (10000 in chips)
Seat 2: MrOrange (10000 in chips)
Seat 3: Hattori (10000 in chips)
Seat 4: MrBlue (10000 in chips)
Seat 5: Pluribus (10000 in chips)
Seat 6: Budd (10000 in chips)
MrWhite: posts small blind 50
MrOrange: posts big blind 100
*** HOLE CARDS ***
Dealt to MrWhite [5c 6d]
Dealt to MrOrange [Qd Qs]
Dealt to Hattori [Kh As]
Dealt to MrBlue [Jd 8d]
Dealt to Pluribus [7h Ah]
Dealt to Budd [4d 9c]
Hattori: raises 100 to 200
MrBlue: folds
Pluribus: calls 200
Budd: folds
MrWhite: folds
MrOrange: raises 1100 to 1300
Hattori: raises 8700 to 10000 and is all-in
Pluribus: folds
MrOrange: calls 8700 and is all-in
*** FLOP *** [Ks 3h Th]
*** TURN *** [Ks 3h Th] [6h]
*** RIVER *** [Ks 3h Th] [6h] [3c]
*** SHOWDOWN ***
Hattori: shows [Kh As]
Hattori collected 20250.0 from pot
*** SUMMARY ***
Total pot 20250 | Rake 0
Board [Ks 3h Th 6h 3c]
Seat 2: MrOrange showed [Qd Qs] and lost
Seat 3: Hattori showed [Kh As] and won (20250.0)


PokerStars Hand #75068: Hold'em No Limit (50/100) - 2019/07/11 20:51:08 ET
Table 'Pluribus Session 75' 6-max (Play Money) Seat #6 is the button
Seat 1: MrOrange (10000 in chips)
Seat 2: Hattori (10000 in chips)
Seat 3: MrBlue (10000 in chips)
Seat 4: Pluribus (10000 in chips)
Seat 5: Budd (10000 in chips)
Seat 6: MrWhite (10000 in chips)
MrOrange: posts small blind 50
Hattori: posts big blind 100
*** HOLE CARDS ***
Dealt to MrOrange [Ah Ks]
Dealt to Hattori [8s 9s]
Dealt to MrBlue [9d 2c]
Dealt to Pluribus [Jd 7h]
Dealt to Budd [9h Td]
Dealt to MrWhite [4d 5s]
MrBlue: folds
Pluribus: folds
Budd: raises 125 to 225
MrWhite: folds
MrOrange: raises 875 to 1100
Hattori: folds
Budd: folds
Uncalled bet (875) returned to MrOrange
MrOrange collected 550.0 from pot
*** SUMMARY ***
Total pot 550 | Rake 0


PokerStars Hand #75069: Hold'em No Limit (50/100) - 2019/07/11 20:51:09 ET
Table 'Pluribus Session 75' 6-max (Play Money) Seat #6 is the button
Seat 1: Hattori (10000 in chips)
Seat 2: MrBlue (10000 in chips)
Seat 3: Pluribus (10000 in chips)
Seat 4: Budd (10000 in chips)
Seat 5: MrWhite (10000 in chips)
Seat 6: MrOrange (10000 in chips)
Hattori: posts small blind 50
MrBlue: posts big blind 100
*** HOLE CARDS ***
Dealt to Hattori [Ah 3c]
Dealt to MrBlue [Ts 4c]
Dealt to Pluribus [Qh 4h]
Dealt to Budd [Ad 5s]
Dealt to MrWhite [Td 8d]
Dealt to MrOrange [7s 2h]
Pluribus: folds
Budd: folds
MrWhite: raises 125 to 225
MrOrange: folds
Hattori: folds
MrBlue: folds
Uncalled bet (125) returned to MrWhite
MrWhite collected 250.0 from pot
*** SUMMARY ***
Total pot 250 | Rake 0


PokerStars Hand #75070: Hold'em No Limit (50/100) - 2019/07/11 20:51:10 ET
Table 'Pluribus Session 75' 6-max (Play Money) Seat #6 is the button
Seat 1: MrBlue (10000 in chips)
Seat 2: Pluribus (10000 in chips)
Seat 3: Budd (10000 in chips)
Seat 4: MrWhite (10000 in chips)
Seat 5: MrOrange (10000 in chips)
Seat 6: Hattori (10000 in chips)
MrBlue: posts small blind 50
Pluribus: posts big blind 100
*** HOLE CARDS ***
Dealt to MrBlue [Ac 5c]
Dealt to Pluribus [3h Ts]
Dealt to Budd [Kh Td]
Dealt to MrWhite [8d 6d]
Dealt to MrOrange [Jc Qs]
Dealt to Hattori [4s 2c]
Budd: folds
MrWhite: folds
MrOrange: folds
Hattori: folds
MrBlue: calls 50
Pluribus: raises 250 to 350
MrBlue: calls 250
*** FLOP *** [3d Kd 2s]
MrBlue: checks
Pluribus: checks
*** TURN *** [3d Kd 2s] [9h]
MrBlue: checks
Pluribus: checks
*** RIVER *** [3d Kd 2s] [9h] [3s]
MrBlue: checks
Pluribus: bets 350
MrBlue: folds
Uncalled bet (350) returned to Pluribus
Pluribus collected 700.0 from pot
*** SUMMARY ***
Total pot 700 | Rake 0
Board [3d Kd 2s 9h 3s]


PokerStars Hand #75071: Hold'em No Limit (50/100) - 2019/07/11 20:51:11 ET
Table 'Pluribus Session 75' 6-max (Play Money) Seat #6 is the button
Seat 1: Pluribus (10000 in chips)
Seat 2: Budd (10000 in chips)
Seat 3: MrWhite (10000 in chips)
Seat 4: MrOrange (10000 in chips)
Seat 5: Hattori (10000 in chips)
Seat 6: MrBlue (10000 in chips)
Pluribus: posts small blind 50
Budd: posts big blind 100
*** HOLE CARDS ***
Dealt to Pluribus [8d Ks]
Dealt to Budd [Js 5s]
Dealt to MrWhite [Jc Qc]
Dealt to MrOrange [Th 8s]
Dealt to Hattori [Ac Jh]
Dealt to MrBlue [Tc 2h]
MrWhite: raises 125 to 225
MrOrange: folds
Hattori: folds
MrBlue: folds
Pluribus: folds
Budd: calls 125
*** FLOP *** [9s 8h 3h]
Budd: checks
MrWhite: bets 375
Budd: folds
Uncalled bet (375) returned to MrWhite
MrWhite collected 500.0 from pot
*** SUMMARY ***
Total pot 500 | Rake 0
Board [9s 8h 3h]


PokerStars Hand #75072: Hold'em No Limit (50/100) - 2019/07/11 20:51:12 ET
Table 'Pluribus Session 75' 6-max (Play Money) Seat #6 is the button
Seat 1: Budd (10000 in chips)
Seat 2: MrWhite (10000 in chips)
Seat 3: MrOrange (10000 in chips)
Seat 4: Hattori (10000 in chips)
Seat 5: MrBlue (10000 in chips)
Seat 6: Pluribus (10000 in chips)
Budd: posts small blind 50
MrWhite: posts big blind 100
*** HOLE CARDS ***
Dealt to Budd [8s 4d]
Dealt to MrWhite [2c Jd]
Dealt to MrOrange [7d Jc]
Dealt to Hattori [Ah Kc]
Dealt to MrBlue [9d 6h]
Dealt to Pluribus [8d 6s]
MrOrange: folds
Hattori: raises 100 to 200
MrBlue: folds
Pluribus: folds
Budd: folds
MrWhite: folds
Uncalled bet (100) returned to Hattori
Hattori collected 250.0 from pot
*** SUMMARY ***
Total pot 250 | Rake 0


PokerStars Hand #75073: Hold'em No Limit (50/100) - 2019/07/11 20:51:13 ET
Table 'Pluribus Session 75' 6-max (Play Money) Seat #6 is the button
Seat 1: MrWhite (10000 in chips)
Seat 2: MrOrange (10000 in chips)
Seat 3: Hattori (10000 in chips)
Seat 4: MrBlue (10000 in chips)
Seat 5: Pluribus (10000 in chips)
Seat 6: Budd (10000 in chips)
MrWhite: posts small blind 50
MrOrange: posts big blind 100
*** HOLE CARDS ***
Dealt to MrWhite [Ks 4s]
Dealt to MrOrange [2d Td]
Dealt to Hattori [Jc 6d]
Dealt to MrBlue [4h Ts]
Dealt to Pluribus [Ad 9s]
Dealt to Budd [2h Ac]
Hattori: folds
MrBlue: folds
Pluribus: raises 125 to 225
Budd: folds
MrWhite: folds
MrOrange: folds
Uncalled bet (125) returned to Pluribus
Pluribus collected 250.0 from pot
*** SUMMARY ***
Total pot 250 | Rake 0


PokerStars Hand #75074: Hold'em No Limit (50/100) - 2019/07/11 20:51:14 ET
Table 'Pluribus Session 75' 6-max (Play Money) Seat #6 is the button
Seat 1: MrOrange (10000 in chips)
Seat 2: Hattori (10000 in chips)
Seat 3: MrBlue (10000 in chips)
Seat 4: Pluribus (10000 in chips)
Seat 5: Budd (10000 in chips)
Seat 6: MrWhite (10000 in chips)
MrOrange: posts small blind 50
Hattori: posts big blind 100
*** HOLE CARDS ***
Dealt to MrOrange [Qs 8c]
Dealt to Hattori [2h 5c]
Dealt to MrBlue [Jc Ah]
Dealt to Pluribus [4c Kh]
Dealt to Budd [6h 8s]
Dealt to MrWhite [2s 7c]
MrBlue: folds
Pluribus: folds
Budd: folds
MrWhite: folds
MrOrange: folds
Uncalled bet (50) returned to Hattori
Hattori collected 100.0 from pot
*** SUMMARY ***
Total pot 100 | Rake 0


PokerStars Hand #75075: Hold'em No Limit (50/100) - 2019/07/11 20:51:15 ET
Table 'Pluribus Session 75' 6-max (Play Money) Seat #6 is the button
Seat 1: Hattori (10000 in chips)
Seat 2: MrBlue (10000 in chips)
Seat 3: Pluribus (10000 in chips)
Seat 4: Budd (10000 in chips)
Seat 5: MrWhite (10000 in chips)
Seat 6: MrOrange (10000 in chips)
Hattori: posts small blind 50
MrBlue: posts big blind 100
*** HOLE CARDS ***
Dealt to Hattori [Ac Jc]
Dealt to MrBlue [Js Ah]
Dealt to Pluribus [4c 7h]
Dealt to Budd [3d 7c]
Dealt to MrWhite [5h Qh]
Dealt to MrOrange [9d 6d]
Pluribus: folds
Budd: folds
MrWhite: folds
MrOrange: folds
Hattori: raises 135 to 235
MrBlue: calls 135
*** FLOP *** [As Td 4d]
Hattori: bets 125
MrBlue: calls 125
*** TURN *** [As Td 4d] [7s]
Hattori: bets 720
MrBlue: calls 720
*** RIVER *** [As Td 4d] [7s] [Kd]
Hattori: checks
MrBlue: checks
*** SHOWDOWN ***
Hattori collected 1080.0 from pot
MrBlue collected 1080.0 from pot
*** SUMMARY ***
Total pot 2160 | Rake 0
Board [As Td 4d 7s Kd]
Seat 1: Hattori showed [Ac Jc] and lost
Seat 2: MrBlue showed [Js Ah] and lost


PokerStars Hand #75076: Hold'em No Limit (50/100) - 2019/07/11 20:51:16 ET
Table 'Pluribus Session 75' 6-max (Play Money) Seat #6 is the button
Seat 1: MrBlue (10000 in chips)
Seat 2: Pluribus (10000 in chips)
Seat 3: Budd (10000 in chips)
Seat 4: MrWhite (10000 in chips)
Seat 5: MrOrange (10000 in chips)
Seat 6: Hattori (10000 in chips)
MrBlue: posts small blind 50
Pluribus: posts big blind 100
*** HOLE CARDS ***
Dealt to MrBlue [3d 3s]
Dealt to Pluribus [6h 5d]
Dealt to Budd [2s As]
Dealt to MrWhite [Kc 2h]
Dealt to MrOrange [Ks 6d]
Dealt to Hattori [3c Ac]
Budd: raises 125 to 225
MrWhite: folds
MrOrange: folds
Hattori: calls 225
MrBlue: calls 175
Pluribus: folds
*** FLOP *** [Ad 9c Js]
MrBlue: checks
Budd: checks
Hattori: checks
*** TURN *** [Ad 9c Js] [Kd]
MrBlue: checks
Budd: checks
Hattori: checks
*** RIVER *** [Ad 9c Js] [Kd] [Jd]
MrBlue: checks
Budd: checks
Hattori: checks
*** SHOWDOWN ***
Budd: shows [2s As]
Hattori: shows [3c Ac]
Budd collected 387.5 from pot
Hattori collected 387.5 from pot
*** SUMMARY ***
Total pot 775 | Rake 0
Board [Ad 9c Js Kd Jd]
Seat 1: MrBlue showed [3d 3s] and lost
Seat 3: Budd showed [2s As] and won (387.5)
Seat 6: Hattori showed [3c Ac] and won (387.5)


PokerStars Hand #75077: Hold'em No Limit (50/100) - 2019/07/11 20:51:17 ET
Table 'Pluribus Session 75' 6-max (Play Money) Seat #6 is the button
Seat 1: Pluribus (10000 in chips)
Seat 2: Budd (10000 in chips)
Seat 3: MrWhite (10000 in chips)
Seat 4: MrOrange (10000 in chips)
Seat 5: Hattori (10000 in chips)
Seat 6: MrBlue (10000 in chips)
Pluribus: posts small blind 50
Budd: posts big blind 100
*** HOLE CARDS ***
Dealt to Pluribus [5d 5h]
Dealt to Budd [Ks 3c]
Dealt to MrWhite [2h 9h]
Dealt to MrOrange [3s As]
Dealt to Hattori [7s 4d]
Dealt to MrBlue [Qs 4c]
MrWhite: folds
MrOrange: folds
Hattori: folds
MrBlue: folds
Pluribus: raises 175 to 275
Budd: folds
Uncalled bet (175) returned to Pluribus
Pluribus collected 200.0 from pot
*** SUMMARY ***
Total pot 200 | Rake 0


PokerStars Hand #75078: Hold'em No Limit (50/100) - 2019/07/11 20:51:18 ET
Table 'Pluribus Session 75' 6-max (Play Money) Seat #6 is the button
Seat 1: Budd (10000 in chips)
Seat 2: MrWhite (10000 in chips)
Seat 3: MrOrange (10000 in chips)
Seat 4: Hattori (10000 in chips)
Seat 5: MrBlue (10000 in chips)
Seat 6: Pluribus (10000 in chips)
Budd: posts small blind 50
MrWhite: posts big blind 100
*** HOLE CARDS ***
Dealt to Budd [Kd Ac]
Dealt to MrWhite [Kh Qh]
Dealt to MrOrange [Qc 9d]
Dealt to Hattori [7c Tc]
Dealt to MrBlue [Ah Ad]
Dealt to Pluribus [Jc 8s]
MrOrange: folds
Hattori: folds
MrBlue: raises 125 to 225
Pluribus: folds
Budd: raises 675 to 900
MrWhite: calls 800
MrBlue: raises 1785 to 2685
Budd: raises 7315 to 10000 and is all-in
MrWhite: folds
MrBlue: calls 7315 and is all-in
*** FLOP *** [9h As 4c]
*** TURN *** [9h As 4c] [4s]
*** RIVER *** [9h As 4c] [4s] [Js]
*** SHOWDOWN ***
MrBlue: shows [Ah Ad]
MrBlue collected 20900.0 from pot
*** SUMMARY ***
Total pot 20900 | Rake 0
Board [9h As 4c 4s Js]
Seat 1: Budd showed [Kd Ac] and lost
Seat 5: MrBlue showed [Ah Ad] and won (20900.0)


PokerStars Hand #75079: Hold'em No Limit (50/100) - 2019/07/11 20:51:19 ET
Table 'Pluribus Session 75' 6-max (Play Money) Seat #6 is the button
Seat 1: MrWhite (10000 in chips)
Seat 2: MrOrange (10000 in chips)
Seat 3: Hattori (10000 in chips)
Seat 4: MrBlue (10000 in chips)
Seat 5: Pluribus (10000 in chips)
Seat 6: Budd (10000 in chips)
MrWhite: posts small blind 50
MrOrange: posts big blind 100
*** HOLE CARDS ***
Dealt to MrWhite [7s 6d]
Dealt to MrOrange [Qs 5s]
Dealt to Hattori [5d 3c]
Dealt to MrBlue [7c Tc]
Dealt to Pluribus [Kd As]
Dealt to Budd [Jh Ks]
Hattori: folds
MrBlue: folds
Pluribus: raises 150 to 250
Budd: raises 550 to 800
MrWhite: folds
MrOrange: folds
Pluribus: raises 1580 to 2380
Budd: folds
Uncalled bet (1580) returned to Pluribus
Pluribus collected 1750.0 from pot
*** SUMMARY ***
Total pot 1750 | Rake 0


PokerStars Hand #75080: Hold'em No Limit (50/100) - 2019/07/11 20:51:20 ET
Table 'Pluribus Session 75' 6-max (Play Money) Seat #6 is the button
Seat 1: MrOrange (10000 in chips)
Seat 2: Hattori (10000 in chips)
Seat 3: MrBlue (10000 in chips)
Seat 4: Pluribus (10000 in chips)
Seat 5: Budd (10000 in chips)
Seat 6: MrWhite (10000 in chips)
MrOrange: posts small blind 50
Hattori: posts big blind 100
*** HOLE CARDS ***
Dealt to MrOrange [2h As]
Dealt to Hattori [3s Ks]
Dealt to MrBlue [6s 9h]
Dealt to Pluribus [6d 4d]
Dealt to Budd [3h 6c]
Dealt to MrWhite [2d 5d]
MrBlue: folds
Pluribus: folds
Budd: folds
MrWhite: folds
MrOrange: raises 150 to 250
Hattori: calls 150
*** FLOP *** [7s 7c Kh]
MrOrange: checks
Hattori: checks
*** TURN *** [7s 7c Kh] [8s]
MrOrange: checks
Hattori: checks
*** RIVER *** [7s 7c Kh] [8s] [Tc]
MrOrange: checks
Hattori: bets 500
MrOrange: folds
Uncalled bet (500) returned to Hattori
Hattori collected 500.0 from pot
*** SUMMARY ***
Total pot 500 | Rake 0
Board [7s 7c Kh 8s Tc]


PokerStars Hand #75081: Hold'em No Limit (50/100) - 2019/07/11 20:51:21 ET
Table 'Pluribus Session 75' 6-max (Play Money) Seat #6 is the button
Seat 1: Hattori (10000 in chips)
Seat 2: MrBlue (10000 in chips)
Seat 3: Pluribus (10000 in chips)
Seat 4: Budd (10000 in chips)
Seat 5: MrWhite (10000 in chips)
Seat 6: MrOrange (10000 in chips)
Hattori: posts small blind 50
MrBlue: posts big blind 100
*** HOLE CARDS ***
Dealt to Hattori [7c 6s]
Dealt to MrBlue [9c Js]
Dealt to Pluribus [5d 6c]
Dealt to Budd [7h 9h]
Dealt to MrWhite [As 3h]
Dealt to MrOrange [4s Tc]
Pluribus: folds
Budd: folds
MrWhite: folds
MrOrange: folds
Hattori: calls 50
MrBlue: checks
*** FLOP *** [4d 6d 8d]
Hattori: checks
MrBlue: checks
*** TURN *** [4d 6d 8d] [8h]
Hattori: bets 100
MrBlue: folds
Uncalled bet (100) returned to Hattori
Hattori collected 200.0 from pot
*** SUMMARY ***
Total pot 200 | Rake 0
Board [4d 6d 8d 8h]


PokerStars Hand #75082: Hold'em No Limit (50/100) - 2019/07/11 20:51:22 ET
Table 'Pluribus Session 75' 6-max (Play Money) Seat #6 is the button
Seat 1: MrBlue (10000 in chips)
Seat 2: Pluribus (10000 in chips)
Seat 3: Budd (10000 in chips)
Seat 4: MrWhite (10000 in chips)
Seat 5: MrOrange (10000 in chips)
Seat 6: Hattori (10000 in chips)
MrBlue: posts small blind 50
Pluribus: posts big blind 100
*** HOLE CARDS ***
Dealt to MrBlue [3s 9d]
Dealt to Pluribus [5c Tc]
Dealt to Budd [Th 9s]
Dealt to MrWhite [7c Qs]
Dealt to MrOrange [8d 2s]
Dealt to Hattori [7h 2h]
Budd: folds
MrWhite: folds
MrOrange: folds
Hattori: folds
MrBlue: folds
Uncalled bet (50) returned to Pluribus
Pluribus collected 100.0 from pot
*** SUMMARY ***
Total pot 100 | Rake 0


PokerStars Hand #75083: Hold'em No Limit (50/100) - 2019/07/11 20:51:23 ET
Table 'Pluribus Session 75' 6-max (Play Money) Seat #6 is the button
Seat 1: Pluribus (10000 in chips)
Seat 2: Budd (10000 in chips)
Seat 3: MrWhite (10000 in chips)
Seat 4: MrOrange (10000 in chips)
Seat 5: Hattori (10000 in chips)
Seat 6: MrBlue (10000 in chips)
Pluribus: posts small blind 50
Budd: posts big blind 100
*** HOLE CARDS ***
Dealt to Pluribus [4s Qs]
Dealt to Budd [6d Kd]
Dealt to MrWhite [2s Ad]
Dealt to MrOrange [Td 4d]
Dealt to Hattori [9c 6h]
Dealt to MrBlue [5h 6s]
MrWhite: folds
MrOrange: folds
Hattori: folds
MrBlue: raises 125 to 225
Pluribus: folds
Budd: raises 875 to 1100
MrBlue: folds
Uncalled bet (875) returned to Budd
Budd collected 500.0 from pot
*** SUMMARY ***
Total pot 500 | Rake 0


PokerStars Hand #75084: Hold'em No Limit (50/100) - 2019/07/11 20:51:24 ET
Table 'Pluribus Session 75' 6-max (Play Money) Seat #6 is the button
Seat 1: Budd (10000 in chips)
Seat 2: MrWhite (10000 in chips)
Seat 3: MrOrange (10000 in chips)
Seat 4: Hattori (10000 in chips)
Seat 5: MrBlue (10000 in chips)
Seat 6: Pluribus (10000 in chips)
Budd: posts small blind 50
MrWhite: posts big blind 100
*** HOLE CARDS ***
Dealt to Budd [Qc Kd]
Dealt to MrWhite [8d 6h]
Dealt to MrOrange [5d Kc]
Dealt to Hattori [2s 7c]
Dealt to MrBlue [3s 3c]
Dealt to Pluribus [8h Jc]
MrOrange: folds
Hattori: folds
MrBlue: raises 125 to 225
Pluribus: folds
Budd: folds
MrWhite: folds
Uncalled bet (125) returned to MrBlue
MrBlue collected 250.0 from pot
*** SUMMARY ***
Total pot 250 | Rake 0


PokerStars Hand #75085: Hold'em No Limit (50/100) - 2019/07/11 20:51:25 ET
Table 'Pluribus Session 75' 6-max (Play Money) Seat #6 is the button
Seat 1: MrWhite (10000 in chips)
Seat 2: MrOrange (10000 in chips)
Seat 3: Hattori (10000 in chips)
Seat 4: MrBlue (10000 in chips)
Seat 5: Pluribus (10000 in chips)
Seat 6: Budd (10000 in chips)
MrWhite: posts small blind 50
MrOrange: posts big blind 100
*** HOLE CARDS ***
Dealt to MrWhite [2d 9h]
Dealt to MrOrange [5s Kh]
Dealt to Hattori [7d Qh]
Dealt to MrBlue [8d Ac]
Dealt to Pluribus [Td Jc]
Dealt to Budd [As 9s]
Hattori: folds
MrBlue: folds
Pluribus: raises 100 to 200
Budd: raises 500 to 700
MrWhite: folds
MrOrange: folds
Pluribus: folds
Uncalled bet (500) returned to Budd
Budd collected 550.0 from pot
*** SUMMARY ***
Total pot 550 | Rake 0


PokerStars Hand #75086: Hold'em No Limit (50/100) - 2019/07/11 20:51:26 ET
Table 'Pluribus Session 75' 6-max (Play Money) Seat #6 is the button
Seat 1: MrOrange (10000 in chips)
Seat 2: Hattori (10000 in chips)
Seat 3: MrBlue (10000 in chips)
Seat 4: Pluribus (10000 in chips)
Seat 5: Budd (10000 in chips)
Seat 6: MrWhite (10000 in chips)
MrOrange: posts small blind 50
Hattori: posts big blind 100
*** HOLE CARDS ***
Dealt to MrOrange [Th 7s]
Dealt to Hattori [8h Qc]
Dealt to MrBlue [7c Js]
Dealt to Pluribus [8c Qs]
Dealt to Budd [3h 6d]
Dealt to MrWhite [Kh 6h]
MrBlue: folds
Pluribus: folds
Budd: folds
MrWhite: raises 125 to 225
MrOrange: folds
Hattori: calls 125
*** FLOP *** [9s Tc Qh]
Hattori: checks
MrWhite: checks
*** TURN *** [9s Tc Qh] [3d]
Hattori: bets 400
MrWhite: folds
Uncalled bet (400) returned to Hattori
Hattori collected 500.0 from pot
*** SUMMARY ***
Total pot 500 | Rake 0
Board [9s Tc Qh 3d]


PokerStars Hand #75087: Hold'em No Limit (50/100) - 2019/07/11 20:51:27 ET
Table 'Pluribus Session 75' 6-max (Play Money) Seat #6 is the button
Seat 1: Hattori (10000 in chips)
Seat 2: MrBlue (10000 in chips)
Seat 3: Pluribus (10000 in chips)
Seat 4: Budd (10000 in chips)
Seat 5: MrWhite (10000 in chips)
Seat 6: MrOrange (10000 in chips)
Hattori: posts small blind 50
MrBlue: posts big blind 100
*** HOLE CARDS ***
Dealt to Hattori [Ts 7h]
Dealt to MrBlue [4h 7s]
Dealt to Pluribus [Th 8d]
Dealt to Budd [3h 9d]
Dealt to MrWhite [Qc Qd]
Dealt to MrOrange [Tc 9h]
Pluribus: folds
Budd: folds
MrWhite: raises 125 to 225
MrOrange: folds
Hattori: folds
MrBlue: folds
Uncalled bet (125) returned to MrWhite
MrWhite collected 250.0 from pot
*** SUMMARY ***
Total pot 250 | Rake 0


PokerStars Hand #75088: Hold'em No Limit (50/100) - 2019/07/11 20:51:28 ET
Table 'Pluribus Session 75' 6-max (Play Money) Seat #6 is the button
Seat 1: MrBlue (10000 in chips)
Seat 2: Pluribus (10000 in chips)
Seat 3: Budd (10000 in chips)
Seat 4: MrWhite (10000 in chips)
Seat 5: MrOrange (10000 in chips)
Seat 6: Hattori (10000 in chips)
MrBlue: posts small blind 50
Pluribus: posts big blind 100
*** HOLE CARDS ***
Dealt to MrBlue [3c 3s]
Dealt to Pluribus [4d 5h]
Dealt to Budd [8s 2h]
Dealt to MrWhite [Js 4h]
Dealt to MrOrange [Kc 6s]
Dealt to Hattori [Ks 9s]
Budd: folds
MrWhite: folds
MrOrange: folds
Hattori: raises 125 to 225
MrBlue: raises 850 to 1075
Pluribus: folds
Hattori: calls 850
*** FLOP *** [Td 6c 7d]
MrBlue: checks
Hattori: bets 525
MrBlue: folds
Uncalled bet (525) returned to Hattori
Hattori collected 2250.0 from pot
*** SUMMARY ***
Total pot 2250 | Rake 0
Board [Td 6c 7d]


PokerStars Hand #75089: Hold'em No Limit (50/100) - 2019/07/11 20:51:29 ET
Table 'Pluribus Session 75' 6-max (Play Money) Seat #6 is the button
Seat 1: Pluribus (10000 in chips)
Seat 2: Budd (10000 in chips)
Seat 3: MrWhite (10000 in chips)
Seat 4: MrOrange (10000 in chips)
Seat 5: Hattori (10000 in chips)
Seat 6: MrBlue (10000 in chips)
Pluribus: posts small blind 50
Budd: posts big blind 100
*** HOLE CARDS ***
Dealt to Pluribus [4d Ad]
Dealt to Budd [Qs 7c]
Dealt to MrWhite [Tc 5h]
Dealt to MrOrange [Ts 7s]
Dealt to Hattori [Kc 5c]
Dealt to MrBlue [8c 6d]
MrWhite: folds
MrOrange: folds
Hattori: raises 111 to 211
MrBlue: folds
Pluribus: raises 989 to 1200
Budd: folds
Hattori: folds
Uncalled bet (989) returned to Pluribus
Pluribus collected 522.0 from pot
*** SUMMARY ***
Total pot 522 | Rake 0


PokerStars Hand #75090: Hold'em No Limit (50/100) - 2019/07/11 20:51:30 ET
Table 'Pluribus Session 75' 6-max (Play Money) Seat #6 is the button
Seat 1: Budd (10000 in chips)
Seat 2: MrWhite (10000 in chips)
Seat 3: MrOrange (10000 in chips)
Seat 4: Hattori (10000 in chips)
Seat 5: MrBlue (10000 in chips)
Seat 6: Pluribus (10000 in chips)
Budd: posts small blind 50
MrWhite: posts big blind 100
*** HOLE CARDS ***
Dealt to Budd [4h Jc]
Dealt to MrWhite [6s Tc]
Dealt to MrOrange [5h 5d]
Dealt to Hattori [8d 2h]
Dealt to MrBlue [Ad Jd]
Dealt to Pluribus [2d Ts]
MrOrange: raises 100 to 200
Hattori: folds
MrBlue: calls 200
Pluribus: folds
Budd: folds
MrWhite: folds
*** FLOP *** [Ks 7c 3h]
MrOrange: checks
MrBlue: checks
*** TURN *** [Ks 7c 3h] [4s]
MrOrange: checks
MrBlue: checks
*** RIVER *** [Ks 7c 3h] [4s] [6c]
MrOrange: bets 222
MrBlue: folds
Uncalled bet (222) returned to MrOrange
MrOrange collected 550.0 from pot
*** SUMMARY ***
Total pot 550 | Rake 0
Board [Ks 7c 3h 4s 6c]


PokerStars Hand #75091: Hold'em No Limit (50/100) - 2019/07/11 20:51:31 ET
Table 'Pluribus Session 75' 6-max (Play Money) Seat #6 is the button
Seat 1: MrWhite (10000 in chips)
Seat 2: MrOrange (10000 in chips)
Seat 3: Hattori (10000 in chips)
Seat 4: MrBlue (10000 in chips)
Seat 5: Pluribus (10000 in chips)
Seat 6: Budd (10000 in chips)
MrWhite: posts small blind 50
MrOrange: posts big blind 100
*** HOLE CARDS ***
Dealt to MrWhite [5c 9s]
Dealt to MrOrange [6c 4s]
Dealt to Hattori [3h 7d]
Dealt to MrBlue [Js 9h]
Dealt to Pluribus [2s Th]
Dealt to Budd [Qc 6s]
Hattori: folds
MrBlue: folds
Pluribus: folds
Budd: folds
MrWhite: folds
Uncalled bet (50) returned to MrOrange
MrOrange collected 100.0 from pot
*** SUMMARY ***
Total pot 100 | Rake 0


PokerStars Hand #75092: Hold'em No Limit (50/100) - 2019/07/11 20:51:32 ET
Table 'Pluribus Session 75' 6-max (Play Money) Seat #6 is the button
Seat 1: MrOrange (10000 in chips)
Seat 2: Hattori (10000 in chips)
Seat 3: MrBlue (10000 in chips)
Seat 4: Pluribus (10000 in chips)
Seat 5: Budd (10000 in chips)
Seat 6: MrWhite (10000 in chips)
MrOrange: posts small blind 50
Hattori: posts big blind 100
*** HOLE CARDS ***
Dealt to MrOrange [2d Ah]
Dealt to Hattori [5d Th]
Dealt to MrBlue [Jc 3h]
Dealt to Pluribus [Ac 3s]
Dealt to Budd [Jh Td]
Dealt to MrWhite [6c Kh]
MrBlue: folds
Pluribus: folds
Budd: raises 125 to 225
MrWhite: folds
MrOrange: folds
Hattori: folds
Uncalled bet (125) returned to Budd
Budd collected 250.0 from pot
*** SUMMARY ***
Total pot 250 | Rake 0


PokerStars Hand #75093: Hold'em No Limit (50/100) - 2019/07/11 20:51:33 ET
Table 'Pluribus Session 75' 6-max (Play Money) Seat #6 is the button
Seat 1: Hattori (10000 in chips)
Seat 2: MrBlue (10000 in chips)
Seat 3: Pluribus (10000 in chips)
Seat 4: Budd (10000 in chips)
Seat 5: MrWhite (10000 in chips)
Seat 6: MrOrange (10000 in chips)
Hattori: posts small blind 50
MrBlue: posts big blind 100
*** HOLE CARDS ***
Dealt to Hattori [Ks Th]
Dealt to MrBlue [Kd 6h]
Dealt to Pluribus [Ah Qh]
Dealt to Budd [Jh Js]
Dealt to MrWhite [9d 4s]
Dealt to MrOrange [5c 6s]
Pluribus: raises 100 to 200
Budd: raises 520 to 720
MrWhite: folds
MrOrange: folds
Hattori: folds
MrBlue: folds
Pluribus: calls 520
*** FLOP *** [7c 8d Td]
Pluribus: bets 397
Budd: calls 397
*** TURN *** [7c 8d Td] [9s]
Pluribus: bets 596
Budd: raises 2682 to 3278
Pluribus: folds
Uncalled bet (2682) returned to Budd
Budd collected 3576.0 from pot
*** SUMMARY ***
Total pot 3576 | Rake 0
Board [7c 8d Td 9s]


PokerStars Hand #75094: Hold'em No Limit (50/100) - 2019/07/11 20:51:34 ET
Table 'Pluribus Session 75' 6-max (Play Money) Seat #6 is the button
Seat 1: MrBlue (10000 in chips)
Seat 2: Pluribus (10000 in chips)
Seat 3: Budd (10000 in chips)
Seat 4: MrWhite (10000 in chips)
Seat 5: MrOrange (10000 in chips)
Seat 6: Hattori (10000 in chips)
MrBlue: posts small blind 50
Pluribus: posts big blind 100
*** HOLE CARDS ***
Dealt to MrBlue [6d Qc]
Dealt to Pluribus [8s Kd]
Dealt to Budd [Ah 6h]
Dealt to MrWhite [3h 9h]
Dealt to MrOrange [6s 9s]
Dealt to Hattori [3d 9c]
Budd: raises 125 to 225
MrWhite: folds
MrOrange: folds
Hattori: folds
MrBlue: folds
Pluribus: folds
Uncalled bet (125) returned to Budd
Budd collected 250.0 from pot
*** SUMMARY ***
Total pot 250 | Rake 0


PokerStars Hand #75095: Hold'em No Limit (50/100) - 2019/07/11 20:51:35 ET
Table 'Pluribus Session 75' 6-max (Play Money) Seat #6 is the button
Seat 1: Pluribus (10000 in chips)
Seat 2: Budd (10000 in chips)
Seat 3: MrWhite (10000 in chips)
Seat 4: MrOrange (10000 in chips)
Seat 5: Hattori (10000 in chips)
Seat 6: MrBlue (10000 in chips)
Pluribus: posts small blind 50
Budd: posts big blind 100
*** HOLE CARDS ***
Dealt to Pluribus [Ks Ad]
Dealt to Budd [Jd 7d]
Dealt to MrWhite [6s Ac]
Dealt to MrOrange [9c 8d]
Dealt to Hattori [9s 6d]
Dealt to MrBlue [4s 2c]
MrWhite: folds
MrOrange: folds
Hattori: folds
MrBlue: folds
Pluribus: raises 175 to 275
Budd: calls 175
*** FLOP *** [4d Qd Td]
Pluribus: checks
Budd: bets 275
Pluribus: calls 275
*** TURN *** [4d Qd Td] [Tc]
Pluribus: checks
Budd: bets 1100
Pluribus: calls 1100
*** RIVER *** [4d Qd Td] [Tc] [As]
Pluribus: checks
Budd: bets 3300
Pluribus: calls 3300
*** SHOWDOWN ***
Budd: shows [Jd 7d]
Budd collected 9900.0 from pot
*** SUMMARY ***
Total pot 9900 | Rake 0
Board [4d Qd Td Tc As]
Seat 1: Pluribus showed [Ks Ad] and lost
Seat 2: Budd showed [Jd 7d] and won (9900.0)


PokerStars Hand #75096: Hold'em No Limit (50/100) - 2019/07/11 20:51:36 ET
Table 'Pluribus Session 75' 6-max (Play Money) Seat #6 is the button
Seat 1: Budd (10000 in chips)
Seat 2: MrWhite (10000 in chips)
Seat 3: MrOrange (10000 in chips)
Seat 4: Hattori (10000 in chips)
Seat 5: MrBlue (10000 in chips)
Seat 6: Pluribus (10000 in chips)
Budd: posts small blind 50
MrWhite: posts big blind 100
*** HOLE CARDS ***
Dealt to Budd [2d 5h]
Dealt to MrWhite [9c Th]
Dealt to MrOrange [4d 7c]
Dealt to Hattori [Tc 4h]
Dealt to MrBlue [Kc 7h]
Dealt to Pluribus [9h 2h]
MrOrange: folds
Hattori: folds
MrBlue: folds
Pluribus: folds
Budd: folds
Uncalled bet (50) returned to MrWhite
MrWhite collected 100.0 from pot
*** SUMMARY ***
Total pot 100 | Rake 0


PokerStars Hand #75097: Hold'em No Limit (50/100) - 2019/07/11 20:51:37 ET
Table 'Pluribus Session 75' 6-max (Play Money) Seat #6 is the button
Seat 1: MrWhite (10000 in chips)
Seat 2: MrOrange (10000 in chips)
Seat 3: Hattori (10000 in chips)
Seat 4: MrBlue (10000 in chips)
Seat 5: Pluribus (10000 in chips)
Seat 6: Budd (10000 in chips)
MrWhite: posts small blind 50
MrOrange: posts big blind 100
*** HOLE CARDS ***
Dealt to MrWhite [Tc Kh]
Dealt to MrOrange [9h 3s]
Dealt to Hattori [Qc 3d]
Dealt to MrBlue [Js 3h]
Dealt to Pluribus [Td 2s]
Dealt to Budd [9d 4s]
Hattori: folds
MrBlue: folds
Pluribus: folds
Budd: folds
MrWhite: raises 200 to 300
MrOrange: folds
Uncalled bet (200) returned to MrWhite
MrWhite collected 200.0 from pot
*** SUMMARY ***
Total pot 200 | Rake 0


PokerStars Hand #75098: Hold'em No Limit (50/100) - 2019/07/11 20:51:38 ET
Table 'Pluribus Session 75' 6-max (Play Money) Seat #6 is the button
Seat 1: MrOrange (10000 in chips)
Seat 2: Hattori (10000 in chips)
Seat 3: MrBlue (10000 in chips)
Seat 4: Pluribus (10000 in chips)
Seat 5: Budd (10000 in chips)
Seat 6: MrWhite (10000 in chips)
MrOrange: posts small blind 50
Hattori: posts big blind 100
*** HOLE CARDS ***
Dealt to MrOrange [As Jd]
Dealt to Hattori [Jh 3c]
Dealt to MrBlue [Ad 6s]
Dealt to Pluribus [7c 2d]
Dealt to Budd [Jc 5d]
Dealt to MrWhite [8c 9h]
MrBlue: folds
Pluribus: folds
Budd: folds
MrWhite: folds
MrOrange: raises 150 to 250
Hattori: folds
Uncalled bet (150) returned to MrOrange
MrOrange collected 200.0 from pot
*** SUMMARY ***
Total pot 200 | Rake 0


PokerStars Hand #75099: Hold'em No Limit (50/100) - 2019/07/11 20:51:39 ET
Table 'Pluribus Session 75' 6-max (Play Money) Seat #6 is the button
Seat 1: Hattori (10000 in chips)
Seat 2: MrBlue (10000 in chips)
Seat 3: Pluribus (10000 in chips)
Seat 4: Budd (10000 in chips)
Seat 5: MrWhite (10000 in chips)
Seat 6: MrOrange (10000 in chips)
Hattori: posts small blind 50
MrBlue: posts big blind 100
*** HOLE CARDS ***
Dealt to Hattori [6c 6d]
Dealt to MrBlue [9s Kc]
Dealt to Pluribus [Kd Qd]
Dealt to Budd [As 6h]
Dealt to MrWhite [4s 5h]
Dealt to MrOrange [Kh 8d]
Pluribus: raises 100 to 200
Budd: folds
MrWhite: folds
MrOrange: folds
Hattori: calls 150
MrBlue: calls 100
*** FLOP *** [2c Ts 5s]
Hattori: checks
MrBlue: checks
Pluribus: checks
*** TURN *** [2c Ts 5s] [7h]
Hattori: checks
MrBlue: checks
Pluribus: checks
*** RIVER *** [2c Ts 5s] [7h] [9c]
Hattori: checks
MrBlue: checks
Pluribus: checks
*** SHOWDOWN ***
MrBlue: shows [9s Kc]
MrBlue collected 600.0 from pot
*** SUMMARY ***
Total pot 600 | Rake 0
Board [2c Ts 5s 7h 9c]
Seat 1: Hattori showed [6c 6d] and lost
Seat 2: MrBlue showed [9s Kc] and won (600.0)
Seat 3: Pluribus showed [Kd Qd] and lost


PokerStars Hand #75100: Hold'em No Limit (50/100) - 2019/07/11 20:51:40 ET
Table 'Pluribus Session 75' 6-max (Play Money) Seat #6 is the button
Seat 1: MrBlue (10000 in chips)
Seat 2: Pluribus (10000 in chips)
Seat 3: Budd (10000 in chips)
Seat 4: MrWhite (10000 in chips)
Seat 5: MrOrange (10000 in chips)
Seat 6: Hattori (10000 in chips)
MrBlue: posts small blind 50
Pluribus: posts big blind 100
*** HOLE CARDS ***
Dealt to MrBlue [Tc 5d]
Dealt to Pluribus [3s 3d]
Dealt to Budd [As 8d]
Dealt to MrWhite [Th 6d]
Dealt to MrOrange [Ts Jh]
Dealt to Hattori [Qh 2c]
Budd: folds
MrWhite: folds
MrOrange: folds
Hattori: folds
MrBlue: folds
Uncalled bet (50) returned to Pluribus
Pluribus collected 100.0 from pot
*** SUMMARY ***
Total pot 100 | Rake 0


PokerStars Hand #75101: Hold'em No Limit (50/100) - 2019/07/11 20:51:41 ET
Table 'Pluribus Session 75' 6-max (Play Money) Seat #6 is the button
Seat 1: Pluribus (10000 in chips)
Seat 2: Budd (10000 in chips)
Seat 3: MrWhite (10000 in chips)
Seat 4: MrOrange (10000 in chips)
Seat 5: Hattori (10000 in chips)
Seat 6: MrBlue (10000 in chips)
Pluribus: posts small blind 50
Budd: posts big blind 100
*** HOLE CARDS ***
Dealt to Pluribus [4s Kh]
Dealt to Budd [4h Ts]
Dealt to MrWhite [Jc Qc]
Dealt to MrOrange [2d 5d]
Dealt to Hattori [9d Ad]
Dealt to MrBlue [Jh Ks]
MrWhite: raises 125 to 225
MrOrange: folds
Hattori: calls 225
MrBlue: folds
Pluribus: folds
Budd: folds
*** FLOP *** [6s Ac 3d]
MrWhite: bets 300
Hattori: calls 300
*** TURN *** [6s Ac 3d] [Ah]
MrWhite: checks
Hattori: checks
*** RIVER *** [6s Ac 3d] [Ah] [Qh]
MrWhite: bets 600
Hattori: raises 1680 to 2280
MrWhite: folds
Uncalled bet (1680) returned to Hattori
Hattori collected 2400.0 from pot
*** SUMMARY ***
Total pot 2400 | Rake 0
Board [6s Ac 3d Ah Qh]


PokerStars Hand #75102: Hold'em No Limit (50/100) - 2019/07/11 20:51:42 ET
Table 'Pluribus Session 75' 6-max (Play Money) Seat #6 is the button
Seat 1: Budd (10000 in chips)
Seat 2: MrWhite (10000 in chips)
Seat 3: MrOrange (10000 in chips)
Seat 4: Hattori (10000 in chips)
Seat 5: MrBlue (10000 in chips)
Seat 6: Pluribus (10000 in chips)
Budd: posts small blind 50
MrWhite: posts big blind 100
*** HOLE CARDS ***
Dealt to Budd [As 8s]
Dealt to MrWhite [Jh 2d]
Dealt to MrOrange [3h 5c]
Dealt to Hattori [Kd Ts]
Dealt to MrBlue [Qc Ah]
Dealt to Pluribus [6s 6c]
MrOrange: folds
Hattori: raises 100 to 200
MrBlue: raises 500 to 700
Pluribus: folds
Budd: folds
MrWhite: folds
Hattori: folds
Uncalled bet (500) returned to MrBlue
MrBlue collected 550.0 from pot
*** SUMMARY ***
Total pot 550 | Rake 0


PokerStars Hand #75103: Hold'em No Limit (50/100) - 2019/07/11 20:51:43 ET
Table 'Pluribus Session 75' 6-max (Play Money) Seat #6 is the button
Seat 1: MrWhite (10000 in chips)
Seat 2: MrOrange (10000 in chips)
Seat 3: Hattori (10000 in chips)
Seat 4: MrBlue (10000 in chips)
Seat 5: Pluribus (10000 in chips)
Seat 6: Budd (10000 in chips)
MrWhite: posts small blind 50
MrOrange: posts big blind 100
*** HOLE CARDS ***
Dealt to MrWhite [8d 9d]
Dealt to MrOrange [Js 2d]
Dealt to Hattori [4s 5d]
Dealt to MrBlue [3s 4d]
Dealt to Pluribus [6s 8s]
Dealt to Budd [5h 7h]
Hattori: folds
MrBlue: folds
Pluribus: raises 150 to 250
Budd: folds
MrWhite: raises 600 to 850
MrOrange: folds
Pluribus: folds
Uncalled bet (600) returned to MrWhite
MrWhite collected 600.0 from pot
*** SUMMARY ***
Total pot 600 | Rake 0


PokerStars Hand #75104: Hold'em No Limit (50/100) - 2019/07/11 20:51:44 ET
Table 'Pluribus Session 75' 6-max (Play Money) Seat #6 is the button
Seat 1: MrOrange (10000 in chips)
Seat 2: Hattori (10000 in chips)
Seat 3: MrBlue (10000 in chips)
Seat 4: Pluribus (10000 in chips)
Seat 5: Budd (10000 in chips)
Seat 6: MrWhite (10000 in chips)
MrOrange: posts small blind 50
Hattori: posts big blind 100
*** HOLE CARDS ***
Dealt to MrOrange [Qs Ts]
Dealt to Hattori [4c 8c]
Dealt to MrBlue [5c 8h]
Dealt to Pluribus [2c 9h]
Dealt to Budd [Jc 4s]
Dealt to MrWhite [6d Kh]
MrBlue: folds
Pluribus: folds
Budd: folds
MrWhite: folds
MrOrange: raises 150 to 250
Hattori: calls 150
*** FLOP *** [4h 9c 8d]
MrOrange: bets 175
Hattori: raises 625 to 800
MrOrange: calls 625
*** TURN *** [4h 9c 8d] [6h]
MrOrange: checks
Hattori: bets 2500
MrOrange: folds
Uncalled bet (2500) returned to Hattori
Hattori collected 2100.0 from pot
*** SUMMARY ***
Total pot 2100 | Rake 0
Board [4h 9c 8d 6h]


PokerStars Hand #75105: Hold'em No Limit (50/100) - 2019/07/11 20:51:45 ET
Table 'Pluribus Session 75' 6-max (Play Money) Seat #6 is the button
Seat 1: Hattori (10000 in chips)
Seat 2: MrBlue (10000 in chips)
Seat 3: Pluribus (10000 in chips)
Seat 4: Budd (10000 in chips)
Seat 5: MrWhite (10000 in chips)
Seat 6: MrOrange (10000 in chips)
Hattori: posts small blind 50
MrBlue: posts big blind 100
*** HOLE CARDS ***
Dealt to Hattori [6d 9c]
Dealt to MrBlue [Qs Kc]
Dealt to Pluribus [9s Qh]
Dealt to Budd [5d Tc]
Dealt to MrWhite [8s Ah]
Dealt to MrOrange [Th 7s]
Pluribus: folds
Budd: folds
MrWhite: folds
MrOrange: folds
Hattori: folds
Uncalled bet (50) returned to MrBlue
MrBlue collected 100.0 from pot
*** SUMMARY ***
Total pot 100 | Rake 0


PokerStars Hand #75106: Hold'em No Limit (50/100) - 2019/07/11 20:51:46 ET
Table 'Pluribus Session 75' 6-max (Play Money) Seat #6 is the button
Seat 1: MrBlue (10000 in chips)
Seat 2: Pluribus (10000 in chips)
Seat 3: Budd (10000 in chips)
Seat 4: MrWhite (10000 in chips)
Seat 5: MrOrange (10000 in chips)
Seat 6: Hattori (10000 in chips)
MrBlue: posts small blind 50
Pluribus: posts big blind 100
*** HOLE CARDS ***
Dealt to MrBlue [Jd 9c]
Dealt to Pluribus [5d 2s]
Dealt to Budd [Kc 9d]
Dealt to MrWhite [4h Qh]
Dealt to MrOrange [Ks As]
Dealt to Hattori [3d Th]
Budd: folds
MrWhite: folds
MrOrange: raises 115 to 215
Hattori: folds
MrBlue: calls 165
Pluribus: folds
*** FLOP *** [Kd 3c Jh]
MrBlue: checks
MrOrange: bets 150
MrBlue: calls 150
*** TURN *** [Kd 3c Jh] [Ac]
MrBlue: checks
MrOrange: bets 400
MrBlue: folds
Uncalled bet (400) returned to MrOrange
MrOrange collected 830.0 from pot
*** SUMMARY ***
Total pot 830 | Rake 0
Board [Kd 3c Jh Ac]


PokerStars Hand #75107: Hold'em No Limit (50/100) - 2019/07/11 20:51:47 ET
Table 'Pluribus Session 75' 6-max (Play Money) Seat #6 is the button
Seat 1: Pluribus (10000 in chips)
Seat 2: Budd (10000 in chips)
Seat 3: MrWhite (10000 in chips)
Seat 4: MrOrange (10000 in chips)
Seat 5: Hattori (10000 in chips)
Seat 6: MrBlue (10000 in chips)
Pluribus: posts small blind 50
Budd: posts big blind 100
*** HOLE CARDS ***
Dealt to Pluribus [5h Qc]
Dealt to Budd [3s Th]
Dealt to MrWhite [As 9c]
Dealt to MrOrange [Qh 5s]
Dealt to Hattori [Jh 5c]
Dealt to MrBlue [Kh 8s]
MrWhite: folds
MrOrange: folds
Hattori: folds
MrBlue: raises 125 to 225
Pluribus: folds
Budd: folds
Uncalled bet (125) returned to MrBlue
MrBlue collected 250.0 from pot
*** SUMMARY ***
Total pot 250 | Rake 0


PokerStars Hand #75108: Hold'em No Limit (50/100) - 2019/07/11 20:51:48 ET
Table 'Pluribus Session 75' 6-max (Play Money) Seat #6 is the button
Seat 1: Budd (10000 in chips)
Seat 2: MrWhite (10000 in chips)
Seat 3: MrOrange (10000 in chips)
Seat 4: Hattori (10000 in chips)
Seat 5: MrBlue (10000 in chips)
Seat 6: Pluribus (10000 in chips)
Budd: posts small blind 50
MrWhite: posts big blind 100
*** HOLE CARDS ***
Dealt to Budd [6c 3h]
Dealt to MrWhite [Qs Qd]
Dealt to MrOrange [Jc 2h]
Dealt to Hattori [8c 5d]
Dealt to MrBlue [Jd 8s]
Dealt to Pluribus [9h 7s]
MrOrange: folds
Hattori: folds
MrBlue: folds
Pluribus: folds
Budd: folds
Uncalled bet (50) returned to MrWhite
MrWhite collected 100.0 from pot
*** SUMMARY ***
Total pot 100 | Rake 0


PokerStars Hand #75109: Hold'em No Limit (50/100) - 2019/07/11 20:51:49 ET
Table 'Pluribus Session 75' 6-max (Play Money) Seat #6 is the button
Seat 1: MrWhite (10000 in chips)
Seat 2: MrOrange (10000 in chips)
Seat 3: Hattori (10000 in chips)
Seat 4: MrBlue (10000 in chips)
Seat 5: Pluribus (10000 in chips)
Seat 6: Budd (10000 in chips)
MrWhite: posts small blind 50
MrOrange: posts big blind 100
*** HOLE CARDS ***
Dealt to MrWhite [Th 4h]
Dealt to MrOrange [4s As]
Dealt to Hattori [6s 7s]
Dealt to MrBlue [2d 8c]
Dealt to Pluribus [7h Ts]
Dealt to Budd [2s 5h]
Hattori: raises 100 to 200
MrBlue: folds
Pluribus: folds
Budd: folds
MrWhite: folds
MrOrange: calls 100
*** FLOP *** [8h 4d 3s]
MrOrange: checks
Hattori: bets 500
MrOrange: calls 500
*** TURN *** [8h 4d 3s] [Jc]
MrOrange: checks
Hattori: checks
*** RIVER *** [8h 4d 3s] [Jc] [Qc]
MrOrange: checks
Hattori: bets 1450
MrOrange: folds
Uncalled bet (1450) returned to Hattori
Hattori collected 1450.0 from pot
*** SUMMARY ***
Total pot 1450 | Rake 0
Board [8h 4d 3s Jc Qc]


PokerStars Hand #75110: Hold'em No Limit (50/100) - 2019/07/11 20:51:50 ET
Table 'Pluribus Session 75' 6-max (Play Money) Seat #6 is the button
Seat 1: MrOrange (10000 in chips)
Seat 2: Hattori (10000 in chips)
Seat 3: MrBlue (10000 in chips)
Seat 4: Pluribus (10000 in chips)
Seat 5: Budd (10000 in chips)
Seat 6: MrWhite (10000 in chips)
MrOrange: posts small blind 50
Hattori: posts big blind 100
*** HOLE CARDS ***
Dealt to MrOrange [4s Qd]
Dealt to Hattori [Kc 6s]
Dealt to MrBlue [Jh Qh]
Dealt to Pluribus [Ks 8c]
Dealt to Budd [4h Kh]
Dealt to MrWhite [2h 8h]
MrBlue: raises 125 to 225
Pluribus: folds
Budd: folds
MrWhite: folds
MrOrange: folds
Hattori: folds
Uncalled bet (125) returned to MrBlue
MrBlue collected 250.0 from pot
*** SUMMARY ***
Total pot 250 | Rake 0


PokerStars Hand #75111: Hold'em No Limit (50/100) - 2019/07/11 20:51:51 ET
Table 'Pluribus Session 75' 6-max (Play Money) Seat #6 is the button
Seat 1: Hattori (10000 in chips)
Seat 2: MrBlue (10000 in chips)
Seat 3: Pluribus (10000 in chips)
Seat 4: Budd (10000 in chips)
Seat 5: MrWhite (10000 in chips)
Seat 6: MrOrange (10000 in chips)
Hattori: posts small blind 50
MrBlue: posts big blind 100
*** HOLE CARDS ***
Dealt to Hattori [2h Kc]
Dealt to MrBlue [Kh 3h]
Dealt to Pluribus [Th 9h]
Dealt to Budd [3c 7c]
Dealt to MrWhite [2c Jh]
Dealt to MrOrange [2d Ac]
Pluribus: raises 125 to 225
Budd: folds
MrWhite: folds
MrOrange: folds
Hattori: folds
MrBlue: calls 125
*** FLOP *** [7s 4c 5d]
MrBlue: checks
Pluribus: checks
*** TURN *** [7s 4c 5d] [Qs]
MrBlue: checks
Pluribus: bets 125
MrBlue: folds
Uncalled bet (125) returned to Pluribus
Pluribus collected 500.0 from pot
*** SUMMARY ***
Total pot 500 | Rake 0
Board [7s 4c 5d Qs]


PokerStars Hand #75112: Hold'em No Limit (50/100) - 2019/07/11 20:51:52 ET
Table 'Pluribus Session 75' 6-max (Play Money) Seat #6 is the button
Seat 1: MrBlue (10000 in chips)
Seat 2: Pluribus (10000 in chips)
Seat 3: Budd (10000 in chips)
Seat 4: MrWhite (10000 in chips)
Seat 5: MrOrange (10000 in chips)
Seat 6: Hattori (10000 in chips)
MrBlue: posts small blind 50
Pluribus: posts big blind 100
*** HOLE CARDS ***
Dealt to MrBlue [5c 3s]
Dealt to Pluribus [9h Th]
Dealt to Budd [8c 4s]
Dealt to MrWhite [Kh 7h]
Dealt to MrOrange [Js 4d]
Dealt to Hattori [2s 3d]
Budd: folds
MrWhite: folds
MrOrange: folds
Hattori: folds
MrBlue: calls 50
Pluribus: raises 175 to 275
MrBlue: calls 175
*** FLOP *** [5h Td 7d]
MrBlue: checks
Pluribus: bets 275
MrBlue: calls 275
*** TURN *** [5h Td 7d] [8h]
MrBlue: checks
Pluribus: bets 550
MrBlue: folds
Uncalled bet (550) returned to Pluribus
Pluribus collected 1100.0 from pot
*** SUMMARY ***
Total pot 1100 | Rake 0
Board [5h Td 7d 8h]


PokerStars Hand #75113: Hold'em No Limit (50/100) - 2019/07/11 20:51:53 ET
Table 'Pluribus Session 75' 6-max (Play Money) Seat #6 is the button
Seat 1: Pluribus (10000 in chips)
Seat 2: Budd (10000 in chips)
Seat 3: MrWhite (10000 in chips)
Seat 4: MrOrange (10000 in chips)
Seat 5: Hattori (10000 in chips)
Seat 6: MrBlue (10000 in chips)
Pluribus: posts small blind 50
Budd: posts big blind 100
*** HOLE CARDS ***
Dealt to Pluribus [Ks 9c]
Dealt to Budd [3s Jh]
Dealt to MrWhite [Qh Th]
Dealt to MrOrange [3c 4h]
Dealt to Hattori [7s 2s]
Dealt to MrBlue [8s Jc]
MrWhite: raises 125 to 225
MrOrange: folds
Hattori: folds
MrBlue: folds
Pluribus: folds
Budd: folds
Uncalled bet (125) returned to MrWhite
MrWhite collected 250.0 from pot
*** SUMMARY ***
Total pot 250 | Rake 0


PokerStars Hand #75114: Hold'em No Limit (50/100) - 2019/07/11 20:51:54 ET
Table 'Pluribus Session 75' 6-max (Play Money) Seat #6 is the button
Seat 1: Budd (10000 in chips)
Seat 2: MrWhite (10000 in chips)
Seat 3: MrOrange (10000 in chips)
Seat 4: Hattori (10000 in chips)
Seat 5: MrBlue (10000 in chips)
Seat 6: Pluribus (10000 in chips)
Budd: posts small blind 50
MrWhite: posts big blind 100
*** HOLE CARDS ***
Dealt to Budd [2c Qh]
Dealt to MrWhite [5h 9h]
Dealt to MrOrange [4d Tc]
Dealt to Hattori [Th Td]
Dealt to MrBlue [8d Ah]
Dealt to Pluribus [Ks 3d]
MrOrange: folds
Hattori: raises 100 to 200
MrBlue: folds
Pluribus: folds
Budd: folds
MrWhite: calls 100
*** FLOP *** [Qc 7h As]
MrWhite: checks
Hattori: checks
*** TURN *** [Qc 7h As] [9c]
MrWhite: checks
Hattori: checks
*** RIVER *** [Qc 7h As] [9c] [2h]
MrWhite: checks
Hattori: checks
*** SHOWDOWN ***
Hattori: shows [Th Td]
Hattori collected 450.0 from pot
*** SUMMARY ***
Total pot 450 | Rake 0
Board [Qc 7h As 9c 2h]
Seat 2: MrWhite showed [5h 9h] and lost
Seat 4: Hattori showed [Th Td] and won (450.0)


PokerStars Hand #75115: Hold'em No Limit (50/100) - 2019/07/11 20:51:55 ET
Table 'Pluribus Session 75' 6-max (Play Money) Seat #6 is the button
Seat 1: MrWhite (10000 in chips)
Seat 2: MrOrange (10000 in chips)
Seat 3: Hattori (10000 in chips)
Seat 4: MrBlue (10000 in chips)
Seat 5: Pluribus (10000 in chips)
Seat 6: Budd (10000 in chips)
MrWhite: posts small blind 50
MrOrange: posts big blind 100
*** HOLE CARDS ***
Dealt to MrWhite [5d Qh]
Dealt to MrOrange [5s 9c]
Dealt to Hattori [Ac Tc]
Dealt to MrBlue [Qd 6d]
Dealt to Pluribus [3h 6h]
Dealt to Budd [4h 6c]
Hattori: raises 100 to 200
MrBlue: folds
Pluribus: folds
Budd: folds
MrWhite: folds
MrOrange: folds
Uncalled bet (100) returned to Hattori
Hattori collected 250.0 from pot
*** SUMMARY ***
Total pot 250 | Rake 0


PokerStars Hand #75116: Hold'em No Limit (50/100) - 2019/07/11 20:51:56 ET
Table 'Pluribus Session 75' 6-max (Play Money) Seat #6 is the button
Seat 1: MrOrange (10000 in chips)
Seat 2: Hattori (10000 in chips)
Seat 3: MrBlue (10000 in chips)
Seat 4: Pluribus (10000 in chips)
Seat 5: Budd (10000 in chips)
Seat 6: MrWhite (10000 in chips)
MrOrange: posts small blind 50
Hattori: posts big blind 100
*** HOLE CARDS ***
Dealt to MrOrange [8s Js]
Dealt to Hattori [Th 2s]
Dealt to MrBlue [7h 6s]
Dealt to Pluribus [7c 9s]
Dealt to Budd [7s Qh]
Dealt to MrWhite [5h Ts]
MrBlue: folds
Pluribus: folds
Budd: folds
MrWhite: folds
MrOrange: raises 150 to 250
Hattori: folds
Uncalled bet (150) returned to MrOrange
MrOrange collected 200.0 from pot
*** SUMMARY ***
Total pot 200 | Rake 0


PokerStars Hand #75117: Hold'em No Limit (50/100) - 2019/07/11 20:51:57 ET
Table 'Pluribus Session 75' 6-max (Play Money) Seat #6 is the button
Seat 1: Hattori (10000 in chips)
Seat 2: MrBlue (10000 in chips)
Seat 3: Pluribus (10000 in chips)
Seat 4: Budd (10000 in chips)
Seat 5: MrWhite (10000 in chips)
Seat 6: MrOrange (10000 in chips)
Hattori: posts small blind 50
MrBlue: posts big blind 100
*** HOLE CARDS ***
Dealt to Hattori [6c Jh]
Dealt to MrBlue [Ac 7s]
Dealt to Pluribus [8h Ts]
Dealt to Budd [5c 2c]
Dealt to MrWhite [9c 5s]
Dealt to MrOrange [4s 6s]
Pluribus: folds
Budd: folds
MrWhite: folds
MrOrange: folds
Hattori: folds
Uncalled bet (50) returned to MrBlue
MrBlue collected 100.0 from pot
*** SUMMARY ***
Total pot 100 | Rake 0


PokerStars Hand #75118: Hold'em No Limit (50/100) - 2019/07/11 20:51:58 ET
Table 'Pluribus Session 75' 6-max (Play Money) Seat #6 is the button
Seat 1: MrBlue (10000 in chips)
Seat 2: Pluribus (10000 in chips)
Seat 3: Budd (10000 in chips)
Seat 4: MrWhite (10000 in chips)
Seat 5: MrOrange (10000 in chips)
Seat 6: Hattori (10000 in chips)
MrBlue: posts small blind 50
Pluribus: posts big blind 100
*** HOLE CARDS ***
Dealt to MrBlue [3h 7c]
Dealt to Pluribus [Td 9d]
Dealt to Budd [6h 6d]
Dealt to MrWhite [2d Ts]
Dealt to MrOrange [5c Ad]
Dealt to Hattori [Qc 4c]
Budd: raises 125 to 225
MrWhite: folds
MrOrange: folds
Hattori: folds
MrBlue: folds
Pluribus: calls 125
*** FLOP *** [As 9s 4d]
Pluribus: checks
Budd: bets 125
Pluribus: calls 125
*** TURN *** [As 9s 4d] [5s]
Pluribus: checks
Budd: checks
*** RIVER *** [As 9s 4d] [5s] [8h]
Pluribus: checks
Budd: checks
*** SHOWDOWN ***
Pluribus: shows [Td 9d]
Pluribus collected 750.0 from pot
*** SUMMARY ***
Total pot 750 | Rake 0
Board [As 9s 4d 5s 8h]
Seat 2: Pluribus showed [Td 9d] and won (750.0)
Seat 3: Budd showed [6h 6d] and lost


PokerStars Hand #75119: Hold'em No Limit (50/100) - 2019/07/11 20:51:59 ET
Table 'Pluribus Session 75' 6-max (Play Money) Seat #6 is the button
Seat 1: Pluribus (10000 in chips)
Seat 2: Budd (10000 in chips)
Seat 3: MrWhite (10000 in chips)
Seat 4: MrOrange (10000 in chips)
Seat 5: Hattori (10000 in chips)
Seat 6: MrBlue (10000 in chips)
Pluribus: posts small blind 50
Budd: posts big blind 100
*** HOLE CARDS ***
Dealt to Pluribus [Th Ac]
Dealt to Budd [As 9h]
Dealt to MrWhite [Ks 9c]
Dealt to MrOrange [Kc Jh]
Dealt to Hattori [4s 2d]
Dealt to MrBlue [Kh 9s]
MrWhite: folds
MrOrange: folds
Hattori: folds
MrBlue: raises 125 to 225
Pluribus: calls 175
Budd: raises 975 to 1200
MrBlue: folds
Pluribus: folds
Uncalled bet (975) returned to Budd
Budd collected 675.0 from pot
*** SUMMARY ***
Total pot 675 | Rake 0


PokerStars Hand #75120: Hold'em No Limit (50/100) - 2019/07/11 20:52:00 ET
Table 'Pluribus Session 75' 6-max (Play Money) Seat #6 is the button
Seat 1: Budd (10000 in chips)
Seat 2: MrWhite (10000 in chips)
Seat 3: MrOrange (10000 in chips)
Seat 4: Hattori (10000 in chips)
Seat 5: MrBlue (10000 in chips)
Seat 6: Pluribus (10000 in chips)
Budd: posts small blind 50
MrWhite: posts big blind 100
*** HOLE CARDS ***
Dealt to Budd [7d 5h]
Dealt to MrWhite [Ks Js]
Dealt to MrOrange [As 5s]
Dealt to Hattori [Ts Ah]
Dealt to MrBlue [Kh 7h]
Dealt to Pluribus [2d Th]
MrOrange: raises 100 to 200
Hattori: folds
MrBlue: folds
Pluribus: folds
Budd: folds
MrWhite: calls 100
*** FLOP *** [Jd Tc 3c]
MrWhite: checks
MrOrange: checks
*** TURN *** [Jd Tc 3c] [7s]
MrWhite: checks
MrOrange: checks
*** RIVER *** [Jd Tc 3c] [7s] [6s]
MrWhite: bets 337
MrOrange: folds
Uncalled bet (337) returned to MrWhite
MrWhite collected 450.0 from pot
*** SUMMARY ***
Total pot 450 | Rake 0
Board [Jd Tc 3c 7s 6s]


PokerStars Hand #75121: Hold'em No Limit (50/100) - 2019/07/11 20:52:01 ET
Table 'Pluribus Session 75' 6-max (Play Money) Seat #6 is the button
Seat 1: MrWhite (10000 in chips)
Seat 2: MrOrange (10000 in chips)
Seat 3: Hattori (10000 in chips)
Seat 4: MrBlue (10000 in chips)
Seat 5: Pluribus (10000 in chips)
Seat 6: Budd (10000 in chips)
MrWhite: posts small blind 50
MrOrange: posts big blind 100
*** HOLE CARDS ***
Dealt to MrWhite [Qh 6c]
Dealt to MrOrange [7h 8d]
Dealt to Hattori [4d Td]
Dealt to MrBlue [7d Jh]
Dealt to Pluribus [Kd Th]
Dealt to Budd [6s 5s]
Hattori: folds
MrBlue: folds
Pluribus: raises 100 to 200
Budd: raises 500 to 700
MrWhite: folds
MrOrange: folds
Pluribus: folds
Uncalled bet (500) returned to Budd
Budd collected 550.0 from pot
*** SUMMARY ***
Total pot 550 | Rake 0


PokerStars Hand #75122: Hold'em No Limit (50/100) - 2019/07/11 20:52:02 ET
Table 'Pluribus Session 75' 6-max (Play Money) Seat #6 is the button
Seat 1: MrOrange (10000 in chips)
Seat 2: Hattori (10000 in chips)
Seat 3: MrBlue (10000 in chips)
Seat 4: Pluribus (10000 in chips)
Seat 5: Budd (10000 in chips)
Seat 6: MrWhite (10000 in chips)
MrOrange: posts small blind 50
Hattori: posts big blind 100
*** HOLE CARDS ***
Dealt to MrOrange [Jc 6s]
Dealt to Hattori [2s Qc]
Dealt to MrBlue [Qh Jh]
Dealt to Pluribus [9s 3s]
Dealt to Budd [Ac Qd]
Dealt to MrWhite [8h 8c]
MrBlue: raises 125 to 225
Pluribus: folds
Budd: calls 225
MrWhite: calls 225
MrOrange: folds
Hattori: folds
*** FLOP *** [4h Tc 4s]
MrBlue: checks
Budd: bets 300
MrWhite: calls 300
MrBlue: folds
*** TURN *** [4h Tc 4s] [7d]
Budd: checks
MrWhite: checks
*** RIVER *** [4h Tc 4s] [7d] [8s]
Budd: checks
MrWhite: bets 712
Budd: folds
Uncalled bet (712) returned to MrWhite
MrWhite collected 1425.0 from pot
*** SUMMARY ***
Total pot 1425 | Rake 0
Board [4h Tc 4s 7d 8s]


PokerStars Hand #75123: Hold'em No Limit (50/100) - 2019/07/11 20:52:03 ET
Table 'Pluribus Session 75' 6-max (Play Money) Seat #6 is the button
Seat 1: Hattori (10000 in chips)
Seat 2: MrBlue (10000 in chips)
Seat 3: Pluribus (10000 in chips)
Seat 4: Budd (10000 in chips)
Seat 5: MrWhite (10000 in chips)
Seat 6: MrOrange (10000 in chips)
Hattori: posts small blind 50
MrBlue: posts big blind 100
*** HOLE CARDS ***
Dealt to Hattori [2d 8s]
Dealt to MrBlue [Kh Kd]
Dealt to Pluribus [Ad 7d]
Dealt to Budd [As 3d]
Dealt to MrWhite [5d 9s]
Dealt to MrOrange [5c 7c]
Pluribus: raises 100 to 200
Budd: folds
MrWhite: folds
MrOrange: folds
Hattori: folds
MrBlue: raises 750 to 950
Pluribus: folds
Uncalled bet (750) returned to MrBlue
MrBlue collected 450.0 from pot
*** SUMMARY ***
Total pot 450 | Rake 0


PokerStars Hand #75124: Hold'em No Limit (50/100) - 2019/07/11 20:52:04 ET
Table 'Pluribus Session 75' 6-max (Play Money) Seat #6 is the button
Seat 1: MrBlue (10000 in chips)
Seat 2: Pluribus (10000 in chips)
Seat 3: Budd (10000 in chips)
Seat 4: MrWhite (10000 in chips)
Seat 5: MrOrange (10000 in chips)
Seat 6: Hattori (10000 in chips)
MrBlue: posts small blind 50
Pluribus: posts big blind 100
*** HOLE CARDS ***
Dealt to MrBlue [2h Qc]
Dealt to Pluribus [5h Qd]
Dealt to Budd [2c Jd]
Dealt to MrWhite [Ad Kd]
Dealt to MrOrange [9c Th]
Dealt to Hattori [8c 9h]
Budd: folds
MrWhite: raises 125 to 225
MrOrange: folds
Hattori: folds
MrBlue: folds
Pluribus: folds
Uncalled bet (125) returned to MrWhite
MrWhite collected 250.0 from pot
*** SUMMARY ***
Total pot 250 | Rake 0


PokerStars Hand #75125: Hold'em No Limit (50/100) - 2019/07/11 20:52:05 ET
Table 'Pluribus Session 75' 6-max (Play Money) Seat #6 is the button
Seat 1: Pluribus (10000 in chips)
Seat 2: Budd (10000 in chips)
Seat 3: MrWhite (10000 in chips)
Seat 4: MrOrange (10000 in chips)
Seat 5: Hattori (10000 in chips)
Seat 6: MrBlue (10000 in chips)
Pluribus: posts small blind 50
Budd: posts big blind 100
*** HOLE CARDS ***
Dealt to Pluribus [Ks 3h]
Dealt to Budd [Js 6d]
Dealt to MrWhite [As 5d]
Dealt to MrOrange [4h 3d]
Dealt to Hattori [7s Qs]
Dealt to MrBlue [2h Qc]
MrWhite: folds
MrOrange: folds
Hattori: raises 111 to 211
MrBlue: folds
Pluribus: folds
Budd: folds
Uncalled bet (111) returned to Hattori
Hattori collected 250.0 from pot
*** SUMMARY ***
Total pot 250 | Rake 0


PokerStars Hand #75126: Hold'em No Limit (50/100) - 2019/07/11 20:52:06 ET
Table 'Pluribus Session 75' 6-max (Play Money) Seat #6 is the button
Seat 1: Budd (10000 in chips)
Seat 2: MrWhite (10000 in chips)
Seat 3: MrOrange (10000 in chips)
Seat 4: Hattori (10000 in chips)
Seat 5: MrBlue (10000 in chips)
Seat 6: Pluribus (10000 in chips)
Budd: posts small blind 50
MrWhite: posts big blind 100
*** HOLE CARDS ***
Dealt to Budd [8s 3d]
Dealt to MrWhite [9c 6s]
Dealt to MrOrange [7d 9s]
Dealt to Hattori [5h Qs]
Dealt to MrBlue [3c Ac]
Dealt to Pluribus [4c Tc]
MrOrange: folds
Hattori: folds
MrBlue: raises 125 to 225
Pluribus: folds
Budd: folds
MrWhite: calls 125
*** FLOP *** [4h Kd Th]
MrWhite: checks
MrBlue: bets 250
MrWhite: folds
Uncalled bet (250) returned to MrBlue
MrBlue collected 500.0 from pot
*** SUMMARY ***
Total pot 500 | Rake 0
Board [4h Kd Th]


PokerStars Hand #75127: Hold'em No Limit (50/100) - 2019/07/11 20:52:07 ET
Table 'Pluribus Session 75' 6-max (Play Money) Seat #6 is the button
Seat 1: MrWhite (10000 in chips)
Seat 2: MrOrange (10000 in chips)
Seat 3: Hattori (10000 in chips)
Seat 4: MrBlue (10000 in chips)
Seat 5: Pluribus (10000 in chips)
Seat 6: Budd (10000 in chips)
MrWhite: posts small blind 50
MrOrange: posts big blind 100
*** HOLE CARDS ***
Dealt to MrWhite [9c 8d]
Dealt to MrOrange [7d As]
Dealt to Hattori [7c 2s]
Dealt to MrBlue [6h Th]
Dealt to Pluribus [5c 8h]
Dealt to Budd [Kh 4s]
Hattori: folds
MrBlue: folds
Pluribus: folds
Budd: folds
MrWhite: folds
Uncalled bet (50) returned to MrOrange
MrOrange collected 100.0 from pot
*** SUMMARY ***
Total pot 100 | Rake 0


PokerStars Hand #75128: Hold'em No Limit (50/100) - 2019/07/11 20:52:08 ET
Table 'Pluribus Session 75' 6-max (Play Money) Seat #6 is the button
Seat 1: MrOrange (10000 in chips)
Seat 2: Hattori (10000 in chips)
Seat 3: MrBlue (10000 in chips)
Seat 4: Pluribus (10000 in chips)
Seat 5: Budd (10000 in chips)
Seat 6: MrWhite (10000 in chips)
MrOrange: posts small blind 50
Hattori: posts big blind 100
*** HOLE CARDS ***
Dealt to MrOrange [Qs 7c]
Dealt to Hattori [4s 6d]
Dealt to MrBlue [9d 3h]
Dealt to Pluribus [6s Jd]
Dealt to Budd [5s Jc]
Dealt to MrWhite [7h 5c]
MrBlue: folds
Pluribus: folds
Budd: folds
MrWhite: folds
MrOrange: folds
Uncalled bet (50) returned to Hattori
Hattori collected 100.0 from pot
*** SUMMARY ***
Total pot 100 | Rake 0


PokerStars Hand #75129: Hold'em No Limit (50/100) - 2019/07/11 20:52:09 ET
Table 'Pluribus Session 75' 6-max (Play Money) Seat #6 is the button
Seat 1: Hattori (10000 in chips)
Seat 2: MrBlue (10000 in chips)
Seat 3: Pluribus (10000 in chips)
Seat 4: Budd (10000 in chips)
Seat 5: MrWhite (10000 in chips)
Seat 6: MrOrange (10000 in chips)
Hattori: posts small blind 50
MrBlue: posts big blind 100
*** HOLE CARDS ***
Dealt to Hattori [5h As]
Dealt to MrBlue [6h 5c]
Dealt to Pluribus [9s 3s]
Dealt to Budd [7c 6c]
Dealt to MrWhite [Qs 5d]
Dealt to MrOrange [5s Qc]
Pluribus: folds
Budd: raises 125 to 225
MrWhite: folds
MrOrange: folds
Hattori: folds
MrBlue: calls 125
*** FLOP *** [4s 2s Kd]
MrBlue: checks
Budd: bets 175
MrBlue: calls 175
*** TURN *** [4s 2s Kd] [3h]
MrBlue: checks
Budd: checks
*** RIVER *** [4s 2s Kd] [3h] [Ad]
MrBlue: checks
Budd: checks
*** SHOWDOWN ***
MrBlue: shows [6h 5c]
MrBlue collected 850.0 from pot
*** SUMMARY ***
Total pot 850 | Rake 0
Board [4s 2s Kd 3h Ad]
Seat 2: MrBlue showed [6h 5c] and won (850.0)
Seat 4: Budd showed [7c 6c] and lost


PokerStars Hand #75130: Hold'em No Limit (50/100) - 2019/07/11 20:52:10 ET
Table 'Pluribus Session 75' 6-max (Play Money) Seat #6 is the button
Seat 1: MrBlue (10000 in chips)
Seat 2: Pluribus (10000 in chips)
Seat 3: Budd (10000 in chips)
Seat 4: MrWhite (10000 in chips)
Seat 5: MrOrange (10000 in chips)
Seat 6: Hattori (10000 in chips)
MrBlue: posts small blind 50
Pluribus: posts big blind 100
*** HOLE CARDS ***
Dealt to MrBlue [2d 4h]
Dealt to Pluribus [4s Ah]
Dealt to Budd [6s 7c]
Dealt to MrWhite [2s 8h]
Dealt to MrOrange [Th 9h]
Dealt to Hattori [3d 7d]
Budd: folds
MrWhite: folds
MrOrange: raises 110 to 210
Hattori: folds
MrBlue: folds
Pluribus: raises 890 to 1100
MrOrange: calls 890
*** FLOP *** [2c 6h Qc]
Pluribus: bets 2250
MrOrange: folds
Uncalled bet (2250) returned to Pluribus
Pluribus collected 2250.0 from pot
*** SUMMARY ***
Total pot 2250 | Rake 0
Board [2c 6h Qc]


PokerStars Hand #75131: Hold'em No Limit (50/100) - 2019/07/11 20:52:11 ET
Table 'Pluribus Session 75' 6-max (Play Money) Seat #6 is the button
Seat 1: Pluribus (10000 in chips)
Seat 2: Budd (10000 in chips)
Seat 3: MrWhite (10000 in chips)
Seat 4: MrOrange (10000 in chips)
Seat 5: Hattori (10000 in chips)
Seat 6: MrBlue (10000 in chips)
Pluribus: posts small blind 50
Budd: posts big blind 100
*** HOLE CARDS ***
Dealt to Pluribus [3h 9h]
Dealt to Budd [7s Jd]
Dealt to MrWhite [8s Kh]
Dealt to MrOrange [3c Ks]
Dealt to Hattori [Jh 5d]
Dealt to MrBlue [5h Ts]
MrWhite: folds
MrOrange: folds
Hattori: folds
MrBlue: folds
Pluribus: calls 50
Budd: checks
*** FLOP *** [2s 6s As]
Pluribus: checks
Budd: checks
*** TURN *** [2s 6s As] [3d]
Pluribus: checks
Budd: checks
*** RIVER *** [2s 6s As] [3d] [8h]
Pluribus: bets 100
Budd: folds
Uncalled bet (100) returned to Pluribus
Pluribus collected 200.0 from pot
*** SUMMARY ***
Total pot 200 | Rake 0
Board [2s 6s As 3d 8h]


PokerStars Hand #75132: Hold'em No Limit (50/100) - 2019/07/11 20:52:12 ET
Table 'Pluribus Session 75' 6-max (Play Money) Seat #6 is the button
Seat 1: Budd (10000 in chips)
Seat 2: MrWhite (10000 in chips)
Seat 3: MrOrange (10000 in chips)
Seat 4: Hattori (10000 in chips)
Seat 5: MrBlue (10000 in chips)
Seat 6: Pluribus (10000 in chips)
Budd: posts small blind 50
MrWhite: posts big blind 100
*** HOLE CARDS ***
Dealt to Budd [5h 8d]
Dealt to MrWhite [8c Kc]
Dealt to MrOrange [Ts Jd]
Dealt to Hattori [3h 6d]
Dealt to MrBlue [Qc 4d]
Dealt to Pluribus [Jc Kd]
MrOrange: folds
Hattori: folds
MrBlue: folds
Pluribus: raises 150 to 250
Budd: folds
MrWhite: calls 150
*** FLOP *** [Td Qd 7c]
MrWhite: checks
Pluribus: bets 1100
MrWhite: folds
Uncalled bet (1100) returned to Pluribus
Pluribus collected 550.0 from pot
*** SUMMARY ***
Total pot 550 | Rake 0
Board [Td Qd 7c]


PokerStars Hand #75133: Hold'em No Limit (50/100) - 2019/07/11 20:52:13 ET
Table 'Pluribus Session 75' 6-max (Play Money) Seat #6 is the button
Seat 1: MrWhite (10000 in chips)
Seat 2: MrOrange (10000 in chips)
Seat 3: Hattori (10000 in chips)
Seat 4: MrBlue (10000 in chips)
Seat 5: Pluribus (10000 in chips)
Seat 6: Budd (10000 in chips)
MrWhite: posts small blind 50
MrOrange: posts big blind 100
*** HOLE CARDS ***
Dealt to MrWhite [Kd Qd]
Dealt to MrOrange [7c 3s]
Dealt to Hattori [2d Kc]
Dealt to MrBlue [6d 3d]
Dealt to Pluribus [Jd 7d]
Dealt to Budd [2h 2c]
Hattori: folds
MrBlue: folds
Pluribus: raises 125 to 225
Budd: folds
MrWhite: raises 550 to 775
MrOrange: folds
Pluribus: folds
Uncalled bet (550) returned to MrWhite
MrWhite collected 550.0 from pot
*** SUMMARY ***
Total pot 550 | Rake 0


PokerStars Hand #75134: Hold'em No Limit (50/100) - 2019/07/11 20:52:14 ET
Table 'Pluribus Session 75' 6-max (Play Money) Seat #6 is the button
Seat 1: MrOrange (10000 in chips)
Seat 2: Hattori (10000 in chips)
Seat 3: MrBlue (10000 in chips)
Seat 4: Pluribus (10000 in chips)
Seat 5: Budd (10000 in chips)
Seat 6: MrWhite (10000 in chips)
MrOrange: posts small blind 50
Hattori: posts big blind 100
*** HOLE CARDS ***
Dealt to MrOrange [5s Ts]
Dealt to Hattori [6h 3c]
Dealt to MrBlue [5c Jd]
Dealt to Pluribus [8s Tc]
Dealt to Budd [Ks Th]
Dealt to MrWhite [6c 8c]
MrBlue: folds
Pluribus: folds
Budd: raises 125 to 225
MrWhite: folds
MrOrange: folds
Hattori: folds
Uncalled bet (125) returned to Budd
Budd collected 250.0 from pot
*** SUMMARY ***
Total pot 250 | Rake 0


PokerStars Hand #75135: Hold'em No Limit (50/100) - 2019/07/11 20:52:15 ET
Table 'Pluribus Session 75' 6-max (Play Money) Seat #6 is the button
Seat 1: Hattori (10000 in chips)
Seat 2: MrBlue (10000 in chips)
Seat 3: Pluribus (10000 in chips)
Seat 4: Budd (10000 in chips)
Seat 5: MrWhite (10000 in chips)
Seat 6: MrOrange (10000 in chips)
Hattori: posts small blind 50
MrBlue: posts big blind 100
*** HOLE CARDS ***
Dealt to Hattori [8s 7c]
Dealt to MrBlue [2d 3h]
Dealt to Pluribus [6c Tc]
Dealt to Budd [Th 7h]
Dealt to MrWhite [3s 5c]
Dealt to MrOrange [2s 7s]
Pluribus: folds
Budd: folds
MrWhite: folds
MrOrange: folds
Hattori: calls 50
MrBlue: raises 250 to 350
Hattori: folds
Uncalled bet (250) returned to MrBlue
MrBlue collected 200.0 from pot
*** SUMMARY ***
Total pot 200 | Rake 0


PokerStars Hand #75136: Hold'em No Limit (50/100) - 2019/07/11 20:52:16 ET
Table 'Pluribus Session 75' 6-max (Play Money) Seat #6 is the button
Seat 1: MrBlue (10000 in chips)
Seat 2: Pluribus (10000 in chips)
Seat 3: Budd (10000 in chips)
Seat 4: MrWhite (10000 in chips)
Seat 5: MrOrange (10000 in chips)
Seat 6: Hattori (10000 in chips)
MrBlue: posts small blind 50
Pluribus: posts big blind 100
*** HOLE CARDS ***
Dealt to MrBlue [7h 3h]
Dealt to Pluribus [7d 8d]
Dealt to Budd [8h 6s]
Dealt to MrWhite [Qd 8c]
Dealt to MrOrange [6d 3c]
Dealt to Hattori [9s 5d]
Budd: folds
MrWhite: folds
MrOrange: folds
Hattori: folds
MrBlue: calls 50
Pluribus: raises 250 to 350
MrBlue: folds
Uncalled bet (250) returned to Pluribus
Pluribus collected 200.0 from pot
*** SUMMARY ***
Total pot 200 | Rake 0


PokerStars Hand #75137: Hold'em No Limit (50/100) - 2019/07/11 20:52:17 ET
Table 'Pluribus Session 75' 6-max (Play Money) Seat #6 is the button
Seat 1: Pluribus (10000 in chips)
Seat 2: Budd (10000 in chips)
Seat 3: MrWhite (10000 in chips)
Seat 4: MrOrange (10000 in chips)
Seat 5: Hattori (10000 in chips)
Seat 6: MrBlue (10000 in chips)
Pluribus: posts small blind 50
Budd: posts big blind 100
*** HOLE CARDS ***
Dealt to Pluribus [2d 5c]
Dealt to Budd [6c 5h]
Dealt to MrWhite [8h Js]
Dealt to MrOrange [5s Td]
Dealt to Hattori [Ad 9c]
Dealt to MrBlue [4d Ts]
MrWhite: folds
MrOrange: folds
Hattori: raises 111 to 211
MrBlue: folds
Pluribus: folds
Budd: calls 111
*** FLOP *** [6h 7d Th]
Budd: checks
Hattori: bets 150
Budd: folds
Uncalled bet (150) returned to Hattori
Hattori collected 472.0 from pot
*** SUMMARY ***
Total pot 472 | Rake 0
Board [6h 7d Th]


PokerStars Hand #75138: Hold'em No Limit (50/100) - 2019/07/11 20:52:18 ET
Table 'Pluribus Session 75' 6-max (Play Money) Seat #6 is the button
Seat 1: Budd (10000 in chips)
Seat 2: MrWhite (10000 in chips)
Seat 3: MrOrange (10000 in chips)
Seat 4: Hattori (10000 in chips)
Seat 5: MrBlue (10000 in chips)
Seat 6: Pluribus (10000 in chips)
Budd: posts small blind 50
MrWhite: posts big blind 100
*** HOLE CARDS ***
Dealt to Budd [3h 2c]
Dealt to MrWhite [Kc 2h]
Dealt to MrOrange [Ad 5s]
Dealt to Hattori [8d 4h]
Dealt to MrBlue [9c 6h]
Dealt to Pluribus [9s Js]
MrOrange: folds
Hattori: folds
MrBlue: folds
Pluribus: raises 125 to 225
Budd: folds
MrWhite: folds
Uncalled bet (125) returned to Pluribus
Pluribus collected 250.0 from pot
*** SUMMARY ***
Total pot 250 | Rake 0


PokerStars Hand #75139: Hold'em No Limit (50/100) - 2019/07/11 20:52:19 ET
Table 'Pluribus Session 75' 6-max (Play Money) Seat #6 is the button
Seat 1: MrWhite (10000 in chips)
Seat 2: MrOrange (10000 in chips)
Seat 3: Hattori (10000 in chips)
Seat 4: MrBlue (10000 in chips)
Seat 5: Pluribus (10000 in chips)
Seat 6: Budd (10000 in chips)
MrWhite: posts small blind 50
MrOrange: posts big blind 100
*** HOLE CARDS ***
Dealt to MrWhite [3s 2h]
Dealt to MrOrange [Ts Ah]
Dealt to Hattori [2c 4c]
Dealt to MrBlue [8h 9h]
Dealt to Pluribus [9c 4s]
Dealt to Budd [Ac Kd]
Hattori: folds
MrBlue: raises 125 to 225
Pluribus: folds
Budd: raises 495 to 720
MrWhite: folds
MrOrange: folds
MrBlue: calls 495
*** FLOP *** [4h 5d 6s]
MrBlue: checks
Budd: bets 550
MrBlue: raises 1345 to 1895
Budd: folds
Uncalled bet (1345) returned to MrBlue
MrBlue collected 2690.0 from pot
*** SUMMARY ***
Total pot 2690 | Rake 0
Board [4h 5d 6s]


PokerStars Hand #75140: Hold'em No Limit (50/100) - 2019/07/11 20:52:20 ET
Table 'Pluribus Session 75' 6-max (Play Money) Seat #6 is the button
Seat 1: MrOrange (10000 in chips)
Seat 2: Hattori (10000 in chips)
Seat 3: MrBlue (10000 in chips)
Seat 4: Pluribus (10000 in chips)
Seat 5: Budd (10000 in chips)
Seat 6: MrWhite (10000 in chips)
MrOrange: posts small blind 50
Hattori: posts big blind 100
*** HOLE CARDS ***
Dealt to MrOrange [8c Ts]
Dealt to Hattori [4h 2s]
Dealt to MrBlue [5s 5h]
Dealt to Pluribus [Qd 4d]
Dealt to Budd [6s Ks]
Dealt to MrWhite [9c Jd]
MrBlue: raises 125 to 225
Pluribus: folds
Budd: folds
MrWhite: folds
MrOrange: folds
Hattori: folds
Uncalled bet (125) returned to MrBlue
MrBlue collected 250.0 from pot
*** SUMMARY ***
Total pot 250 | Rake 0


PokerStars Hand #75141: Hold'em No Limit (50/100) - 2019/07/11 20:52:21 ET
Table 'Pluribus Session 75' 6-max (Play Money) Seat #6 is the button
Seat 1: Hattori (10000 in chips)
Seat 2: MrBlue (10000 in chips)
Seat 3: Pluribus (10000 in chips)
Seat 4: Budd (10000 in chips)
Seat 5: MrWhite (10000 in chips)
Seat 6: MrOrange (10000 in chips)
Hattori: posts small blind 50
MrBlue: posts big blind 100
*** HOLE CARDS ***
Dealt to Hattori [8c 9s]
Dealt to MrBlue [6d 8s]
Dealt to Pluribus [7h Js]
Dealt to Budd [4c 2h]
Dealt to MrWhite [8h 3d]
Dealt to MrOrange [7d 9d]
Pluribus: folds
Budd: folds
MrWhite: folds
MrOrange: raises 124 to 224
Hattori: folds
MrBlue: calls 124
*** FLOP *** [Kc Kh 4d]
MrBlue: checks
MrOrange: bets 150
MrBlue: folds
Uncalled bet (150) returned to MrOrange
MrOrange collected 498.0 from pot
*** SUMMARY ***
Total pot 498 | Rake 0
Board [Kc Kh 4d]


PokerStars Hand #75142: Hold'em No Limit (50/100) - 2019/07/11 20:52:22 ET
Table 'Pluribus Session 75' 6-max (Play Money) Seat #6 is the button
Seat 1: MrBlue (10000 in chips)
Seat 2: Pluribus (10000 in chips)
Seat 3: Budd (10000 in chips)
Seat 4: MrWhite (10000 in chips)
Seat 5: MrOrange (10000 in chips)
Seat 6: Hattori (10000 in chips)
MrBlue: posts small blind 50
Pluribus: posts big blind 100
*** HOLE CARDS ***
Dealt to MrBlue [8h 6h]
Dealt to Pluribus [4s 9c]
Dealt to Budd [Qd 5d]
Dealt to MrWhite [Kh Js]
Dealt to MrOrange [2s 7d]
Dealt to Hattori [Kc 4d]
Budd: folds
MrWhite: folds
MrOrange: folds
Hattori: folds
MrBlue: raises 200 to 300
Pluribus: folds
Uncalled bet (200) returned to MrBlue
MrBlue collected 200.0 from pot
*** SUMMARY ***
Total pot 200 | Rake 0


PokerStars Hand #75143: Hold'em No Limit (50/100) - 2019/07/11 20:52:23 ET
Table 'Pluribus Session 75' 6-max (Play Money) Seat #6 is the button
Seat 1: Pluribus (10000 in chips)
Seat 2: Budd (10000 in chips)
Seat 3: MrWhite (10000 in chips)
Seat 4: MrOrange (10000 in chips)
Seat 5: Hattori (10000 in chips)
Seat 6: MrBlue (10000 in chips)
Pluribus: posts small blind 50
Budd: posts big blind 100
*** HOLE CARDS ***
Dealt to Pluribus [Kd 7h]
Dealt to Budd [6d Jh]
Dealt to MrWhite [9h Ad]
Dealt to MrOrange [3h 9s]
Dealt to Hattori [6h 3d]
Dealt to MrBlue [4d Td]
MrWhite: folds
MrOrange: folds
Hattori: folds
MrBlue: raises 125 to 225
Pluribus: folds
Budd: folds
Uncalled bet (125) returned to MrBlue
MrBlue collected 250.0 from pot
*** SUMMARY ***
Total pot 250 | Rake 0


PokerStars Hand #75144: Hold'em No Limit (50/100) - 2019/07/11 20:52:24 ET
Table 'Pluribus Session 75' 6-max (Play Money) Seat #6 is the button
Seat 1: Budd (10000 in chips)
Seat 2: MrWhite (10000 in chips)
Seat 3: MrOrange (10000 in chips)
Seat 4: Hattori (10000 in chips)
Seat 5: MrBlue (10000 in chips)
Seat 6: Pluribus (10000 in chips)
Budd: posts small blind 50
MrWhite: posts big blind 100
*** HOLE CARDS ***
Dealt to Budd [Kd 5h]
Dealt to MrWhite [Ad 8c]
Dealt to MrOrange [Kc 6d]
Dealt to Hattori [Ac 9c]
Dealt to MrBlue [Qs Jc]
Dealt to Pluribus [4c 6s]
MrOrange: folds
Hattori: raises 100 to 200
MrBlue: folds
Pluribus: folds
Budd: folds
MrWhite: calls 100
*** FLOP *** [3c Ks 4s]
MrWhite: checks
Hattori: checks
*** TURN *** [3c Ks 4s] [6h]
MrWhite: checks
Hattori: checks
*** RIVER *** [3c Ks 4s] [6h] [Ah]
MrWhite: checks
Hattori: bets 450
MrWhite: calls 450
*** SHOWDOWN ***
Hattori: shows [Ac 9c]
Hattori collected 1350.0 from pot
*** SUMMARY ***
Total pot 1350 | Rake 0
Board [3c Ks 4s 6h Ah]
Seat 2: MrWhite showed [Ad 8c] and lost
Seat 4: Hattori showed [Ac 9c] and won (1350.0)


PokerStars Hand #75145: Hold'em No Limit (50/100) - 2019/07/11 20:52:25 ET
Table 'Pluribus Session 75' 6-max (Play Money) Seat #6 is the button
Seat 1: MrWhite (10000 in chips)
Seat 2: MrOrange (10000 in chips)
Seat 3: Hattori (10000 in chips)
Seat 4: MrBlue (10000 in chips)
Seat 5: Pluribus (10000 in chips)
Seat 6: Budd (10000 in chips)
MrWhite: posts small blind 50
MrOrange: posts big blind 100
*** HOLE CARDS ***
Dealt to MrWhite [2c Kc]
Dealt to MrOrange [7h 5c]
Dealt to Hattori [Jd 9h]
Dealt to MrBlue [Th Ts]
Dealt to Pluribus [6s 3c]
Dealt to Budd [5h Js]
Hattori: folds
MrBlue: raises 125 to 225
Pluribus: folds
Budd: folds
MrWhite: folds
MrOrange: folds
Uncalled bet (125) returned to MrBlue
MrBlue collected 250.0 from pot
*** SUMMARY ***
Total pot 250 | Rake 0


PokerStars Hand #75146: Hold'em No Limit (50/100) - 2019/07/11 20:52:26 ET
Table 'Pluribus Session 75' 6-max (Play Money) Seat #6 is the button
Seat 1: MrOrange (10000 in chips)
Seat 2: Hattori (10000 in chips)
Seat 3: MrBlue (10000 in chips)
Seat 4: Pluribus (10000 in chips)
Seat 5: Budd (10000 in chips)
Seat 6: MrWhite (10000 in chips)
MrOrange: posts small blind 50
Hattori: posts big blind 100
*** HOLE CARDS ***
Dealt to MrOrange [6h 8h]
Dealt to Hattori [7s 5c]
Dealt to MrBlue [9c 7c]
Dealt to Pluribus [Ah 7d]
Dealt to Budd [As Jd]
Dealt to MrWhite [2d Ts]
MrBlue: raises 125 to 225
Pluribus: folds
Budd: folds
MrWhite: folds
MrOrange: folds
Hattori: folds
Uncalled bet (125) returned to MrBlue
MrBlue collected 250.0 from pot
*** SUMMARY ***
Total pot 250 | Rake 0


PokerStars Hand #75147: Hold'em No Limit (50/100) - 2019/07/11 20:52:27 ET
Table 'Pluribus Session 75' 6-max (Play Money) Seat #6 is the button
Seat 1: Hattori (10000 in chips)
Seat 2: MrBlue (10000 in chips)
Seat 3: Pluribus (10000 in chips)
Seat 4: Budd (10000 in chips)
Seat 5: MrWhite (10000 in chips)
Seat 6: MrOrange (10000 in chips)
Hattori: posts small blind 50
MrBlue: posts big blind 100
*** HOLE CARDS ***
Dealt to Hattori [Js 8h]
Dealt to MrBlue [Kh 8d]
Dealt to Pluribus [5c Kd]
Dealt to Budd [Ts Ks]
Dealt to MrWhite [5s As]
Dealt to MrOrange [3h Ah]
Pluribus: folds
Budd: raises 125 to 225
MrWhite: raises 450 to 675
MrOrange: folds
Hattori: folds
MrBlue: folds
Budd: folds
Uncalled bet (450) returned to MrWhite
MrWhite collected 600.0 from pot
*** SUMMARY ***
Total pot 600 | Rake 0


PokerStars Hand #75148: Hold'em No Limit (50/100) - 2019/07/11 20:52:28 ET
Table 'Pluribus Session 75' 6-max (Play Money) Seat #6 is the button
Seat 1: MrBlue (10000 in chips)
Seat 2: Pluribus (10000 in chips)
Seat 3: Budd (10000 in chips)
Seat 4: MrWhite (10000 in chips)
Seat 5: MrOrange (10000 in chips)
Seat 6: Hattori (10000 in chips)
MrBlue: posts small blind 50
Pluribus: posts big blind 100
*** HOLE CARDS ***
Dealt to MrBlue [9d 2d]
Dealt to Pluribus [4d 5c]
Dealt to Budd [Qs 5d]
Dealt to MrWhite [2s Qc]
Dealt to MrOrange [As 9s]
Dealt to Hattori [Kh 5s]
Budd: folds
MrWhite: folds
MrOrange: raises 110 to 210
Hattori: folds
MrBlue: folds
Pluribus: calls 110
*** FLOP *** [3s Jc 7c]
Pluribus: checks
MrOrange: bets 150
Pluribus: calls 150
*** TURN *** [3s Jc 7c] [4s]
Pluribus: checks
MrOrange: checks
*** RIVER *** [3s Jc 7c] [4s] [8s]
Pluribus: checks
MrOrange: bets 1050
Pluribus: folds
Uncalled bet (1050) returned to MrOrange
MrOrange collected 770.0 from pot
*** SUMMARY ***
Total pot 770 | Rake 0
Board [3s Jc 7c 4s 8s]


PokerStars Hand #75149: Hold'em No Limit (50/100) - 2019/07/11 20:52:29 ET
Table 'Pluribus Session 75' 6-max (Play Money) Seat #6 is the button
Seat 1: Pluribus (10000 in chips)
Seat 2: Budd (10000 in chips)
Seat 3: MrWhite (10000 in chips)
Seat 4: MrOrange (10000 in chips)
Seat 5: Hattori (10000 in chips)
Seat 6: MrBlue (10000 in chips)
Pluribus: posts small blind 50
Budd: posts big blind 100
*** HOLE CARDS ***
Dealt to Pluribus [Th 9h]
Dealt to Budd [3s Ac]
Dealt to MrWhite [4h Kd]
Dealt to MrOrange [8s Qs]
Dealt to Hattori [5s 8c]
Dealt to MrBlue [Ad 7c]
MrWhite: folds
MrOrange: folds
Hattori: folds
MrBlue: raises 125 to 225
Pluribus: raises 825 to 1050
Budd: folds
MrBlue: folds
Uncalled bet (825) returned to Pluribus
Pluribus collected 550.0 from pot
*** SUMMARY ***
Total pot 550 | Rake 0


PokerStars Hand #75150: Hold'em No Limit (50/100) - 2019/07/11 20:52:30 ET
Table 'Pluribus Session 75' 6-max (Play Money) Seat #6 is the button
Seat 1: Budd (10000 in chips)
Seat 2: MrWhite (10000 in chips)
Seat 3: MrOrange (10000 in chips)
Seat 4: Hattori (10000 in chips)
Seat 5: MrBlue (10000 in chips)
Seat 6: Pluribus (10000 in chips)
Budd: posts small blind 50
MrWhite: posts big blind 100
*** HOLE CARDS ***
Dealt to Budd [Kd 9c]
Dealt to MrWhite [3s Jd]
Dealt to MrOrange [5d Th]
Dealt to Hattori [7c Js]
Dealt to MrBlue [8s Td]
Dealt to Pluribus [5s 7s]
MrOrange: folds
Hattori: folds
MrBlue: folds
Pluribus: raises 150 to 250
Budd: folds
MrWhite: folds
Uncalled bet (150) returned to Pluribus
Pluribus collected 250.0 from pot
*** SUMMARY ***
Total pot 250 | Rake 0


PokerStars Hand #75151: Hold'em No Limit (50/100) - 2019/07/11 20:52:31 ET
Table 'Pluribus Session 75' 6-max (Play Money) Seat #6 is the button
Seat 1: MrWhite (10000 in chips)
Seat 2: MrOrange (10000 in chips)
Seat 3: Hattori (10000 in chips)
Seat 4: MrBlue (10000 in chips)
Seat 5: Pluribus (10000 in chips)
Seat 6: Budd (10000 in chips)
MrWhite: posts small blind 50
MrOrange: posts big blind 100
*** HOLE CARDS ***
Dealt to MrWhite [2c 8d]
Dealt to MrOrange [5h 4h]
Dealt to Hattori [5c Tc]
Dealt to MrBlue [Jh Qd]
Dealt to Pluribus [As 8s]
Dealt to Budd [4c Kc]
Hattori: folds
MrBlue: folds
Pluribus: raises 100 to 200
Budd: folds
MrWhite: folds
MrOrange: raises 900 to 1100
Pluribus: calls 900
*** FLOP *** [Ac 4s Ks]
MrOrange: bets 750
Pluribus: calls 750
*** TURN *** [Ac 4s Ks] [7h]
MrOrange: bets 1750
Pluribus: calls 1750
*** RIVER *** [Ac 4s Ks] [7h] [6h]
MrOrange: bets 6400 and is all-in
Pluribus: folds
Uncalled bet (6400) returned to MrOrange
MrOrange collected 7250.0 from pot
*** SUMMARY ***
Total pot 7250 | Rake 0
Board [Ac 4s Ks 7h 6h]


PokerStars Hand #75152: Hold'em No Limit (50/100) - 2019/07/11 20:52:32 ET
Table 'Pluribus Session 75' 6-max (Play Money) Seat #6 is the button
Seat 1: MrOrange (10000 in chips)
Seat 2: Hattori (10000 in chips)
Seat 3: MrBlue (10000 in chips)
Seat 4: Pluribus (10000 in chips)
Seat 5: Budd (10000 in chips)
Seat 6: MrWhite (10000 in chips)
MrOrange: posts small blind 50
Hattori: posts big blind 100
*** HOLE CARDS ***
Dealt to MrOrange [5s Ad]
Dealt to Hattori [4c 2d]
Dealt to MrBlue [Kh 3h]
Dealt to Pluribus [2c Kc]
Dealt to Budd [6c Jh]
Dealt to MrWhite [3d 2s]
MrBlue: folds
Pluribus: folds
Budd: folds
MrWhite: folds
MrOrange: folds
Uncalled bet (50) returned to Hattori
Hattori collected 100.0 from pot
*** SUMMARY ***
Total pot 100 | Rake 0


PokerStars Hand #75153: Hold'em No Limit (50/100) - 2019/07/11 20:52:33 ET
Table 'Pluribus Session 75' 6-max (Play Money) Seat #6 is the button
Seat 1: Hattori (10000 in chips)
Seat 2: MrBlue (10000 in chips)
Seat 3: Pluribus (10000 in chips)
Seat 4: Budd (10000 in chips)
Seat 5: MrWhite (10000 in chips)
Seat 6: MrOrange (10000 in chips)
Hattori: posts small blind 50
MrBlue: posts big blind 100
*** HOLE CARDS ***
Dealt to Hattori [7s 5s]
Dealt to MrBlue [Kc Qd]
Dealt to Pluribus [8d 3h]
Dealt to Budd [6h 2s]
Dealt to MrWhite [8c Tc]
Dealt to MrOrange [Jd 4d]
Pluribus: folds
Budd: folds
MrWhite: raises 125 to 225
MrOrange: folds
Hattori: folds
MrBlue: calls 125
*** FLOP *** [Qc 4h 6d]
MrBlue: checks
MrWhite: bets 375
MrBlue: calls 375
*** TURN *** [Qc 4h 6d] [9s]
MrBlue: checks
MrWhite: bets 937
MrBlue: calls 937
*** RIVER *** [Qc 4h 6d] [9s] [8h]
MrBlue: checks
MrWhite: checks
*** SHOWDOWN ***
MrBlue: shows [Kc Qd]
MrBlue collected 3124.0 from pot
*** SUMMARY ***
Total pot 3124 | Rake 0
Board [Qc 4h 6d 9s 8h]
Seat 2: MrBlue showed [Kc Qd] and won (3124.0)
Seat 5: MrWhite showed [8c Tc] and lost


PokerStars Hand #75154: Hold'em No Limit (50/100) - 2019/07/11 20:52:34 ET
Table 'Pluribus Session 75' 6-max (Play Money) Seat #6 is the button
Seat 1: MrBlue (10000 in chips)
Seat 2: Pluribus (10000 in chips)
Seat 3: Budd (10000 in chips)
Seat 4: MrWhite (10000 in chips)
Seat 5: MrOrange (10000 in chips)
Seat 6: Hattori (10000 in chips)
MrBlue: posts small blind 50
Pluribus: posts big blind 100
*** HOLE CARDS ***
Dealt to MrBlue [4h As]
Dealt to Pluribus [Qh 5c]
Dealt to Budd [Ad Ac]
Dealt to MrWhite [7c Ks]
Dealt to MrOrange [Kh Td]
Dealt to Hattori [9h 5d]
Budd: raises 125 to 225
MrWhite: folds
MrOrange: folds
Hattori: folds
MrBlue: folds
Pluribus: folds
Uncalled bet (125) returned to Budd
Budd collected 250.0 from pot
*** SUMMARY ***
Total pot 250 | Rake 0


PokerStars Hand #75155: Hold'em No Limit (50/100) - 2019/07/11 20:52:35 ET
Table 'Pluribus Session 75' 6-max (Play Money) Seat #6 is the button
Seat 1: Pluribus (10000 in chips)
Seat 2: Budd (10000 in chips)
Seat 3: MrWhite (10000 in chips)
Seat 4: MrOrange (10000 in chips)
Seat 5: Hattori (10000 in chips)
Seat 6: MrBlue (10000 in chips)
Pluribus: posts small blind 50
Budd: posts big blind 100
*** HOLE CARDS ***
Dealt to Pluribus [6d Qd]
Dealt to Budd [8s Qh]
Dealt to MrWhite [As 7c]
Dealt to MrOrange [4d Kh]
Dealt to Hattori [7d 7s]
Dealt to MrBlue [Js 5d]
MrWhite: folds
MrOrange: folds
Hattori: raises 111 to 211
MrBlue: folds
Pluribus: folds
Budd: folds
Uncalled bet (111) returned to Hattori
Hattori collected 250.0 from pot
*** SUMMARY ***
Total pot 250 | Rake 0


PokerStars Hand #75156: Hold'em No Limit (50/100) - 2019/07/11 20:52:36 ET
Table 'Pluribus Session 75' 6-max (Play Money) Seat #6 is the button
Seat 1: Budd (10000 in chips)
Seat 2: MrWhite (10000 in chips)
Seat 3: MrOrange (10000 in chips)
Seat 4: Hattori (10000 in chips)
Seat 5: MrBlue (10000 in chips)
Seat 6: Pluribus (10000 in chips)
Budd: posts small blind 50
MrWhite: posts big blind 100
*** HOLE CARDS ***
Dealt to Budd [Qc Kc]
Dealt to MrWhite [Kh Th]
Dealt to MrOrange [4s 4d]
Dealt to Hattori [3c 4c]
Dealt to MrBlue [Js 6h]
Dealt to Pluribus [Ad 9c]
MrOrange: raises 100 to 200
Hattori: folds
MrBlue: folds
Pluribus: folds
Budd: calls 150
MrWhite: calls 100
*** FLOP *** [7s Jc Tc]
Budd: checks
MrWhite: checks
MrOrange: checks
*** TURN *** [7s Jc Tc] [5c]
Budd: checks
MrWhite: checks
MrOrange: checks
*** RIVER *** [7s Jc Tc] [5c] [6s]
Budd: checks
MrWhite: checks
MrOrange: checks
*** SHOWDOWN ***
Budd: shows [Qc Kc]
Budd collected 600.0 from pot
*** SUMMARY ***
Total pot 600 | Rake 0
Board [7s Jc Tc 5c 6s]
Seat 1: Budd showed [Qc Kc] and won (600.0)
Seat 2: MrWhite showed [Kh Th] and lost
Seat 3: MrOrange showed [4s 4d] and lost


PokerStars Hand #75157: Hold'em No Limit (50/100) - 2019/07/11 20:52:37 ET
Table 'Pluribus Session 75' 6-max (Play Money) Seat #6 is the button
Seat 1: MrWhite (10000 in chips)
Seat 2: MrOrange (10000 in chips)
Seat 3: Hattori (10000 in chips)
Seat 4: MrBlue (10000 in chips)
Seat 5: Pluribus (10000 in chips)
Seat 6: Budd (10000 in chips)
MrWhite: posts small blind 50
MrOrange: posts big blind 100
*** HOLE CARDS ***
Dealt to MrWhite [Td Ah]
Dealt to MrOrange [5s 7d]
Dealt to Hattori [8s 7s]
Dealt to MrBlue [As 2c]
Dealt to Pluribus [Qd 9s]
Dealt to Budd [4c Qh]
Hattori: raises 100 to 200
MrBlue: folds
Pluribus: folds
Budd: folds
MrWhite: folds
MrOrange: calls 100
*** FLOP *** [Kc 5h 5d]
MrOrange: checks
Hattori: checks
*** TURN *** [Kc 5h 5d] [4s]
MrOrange: bets 150
Hattori: calls 150
*** RIVER *** [Kc 5h 5d] [4s] [3c]
MrOrange: bets 575
Hattori: folds
Uncalled bet (575) returned to MrOrange
MrOrange collected 750.0 from pot
*** SUMMARY ***
Total pot 750 | Rake 0
Board [Kc 5h 5d 4s 3c]


PokerStars Hand #75158: Hold'em No Limit (50/100) - 2019/07/11 20:52:38 ET
Table 'Pluribus Session 75' 6-max (Play Money) Seat #6 is the button
Seat 1: MrOrange (10000 in chips)
Seat 2: Hattori (10000 in chips)
Seat 3: MrBlue (10000 in chips)
Seat 4: Pluribus (10000 in chips)
Seat 5: Budd (10000 in chips)
Seat 6: MrWhite (10000 in chips)
MrOrange: posts small blind 50
Hattori: posts big blind 100
*** HOLE CARDS ***
Dealt to MrOrange [9d 5d]
Dealt to Hattori [2c As]
Dealt to MrBlue [5c 3s]
Dealt to Pluribus [Ks 9c]
Dealt to Budd [Js 8h]
Dealt to MrWhite [7s 9s]
MrBlue: folds
Pluribus: folds
Budd: folds
MrWhite: raises 125 to 225
MrOrange: folds
Hattori: calls 125
*** FLOP *** [6d 5h 6c]
Hattori: checks
MrWhite: bets 250
Hattori: folds
Uncalled bet (250) returned to MrWhite
MrWhite collected 500.0 from pot
*** SUMMARY ***
Total pot 500 | Rake 0
Board [6d 5h 6c]


PokerStars Hand #75159: Hold'em No Limit (50/100) - 2019/07/11 20:52:39 ET
Table 'Pluribus Session 75' 6-max (Play Money) Seat #6 is the button
Seat 1: Hattori (10000 in chips)
Seat 2: MrBlue (10000 in chips)
Seat 3: Pluribus (10000 in chips)
Seat 4: Budd (10000 in chips)
Seat 5: MrWhite (10000 in chips)
Seat 6: MrOrange (10000 in chips)
Hattori: posts small blind 50
MrBlue: posts big blind 100
*** HOLE CARDS ***
Dealt to Hattori [Qh 6h]
Dealt to MrBlue [4c 2s]
Dealt to Pluribus [Qs Tc]
Dealt to Budd [6c Qd]
Dealt to MrWhite [Ac 7h]
Dealt to MrOrange [9c 6d]
Pluribus: folds
Budd: folds
MrWhite: folds
MrOrange: folds
Hattori: calls 50
MrBlue: raises 250 to 350
Hattori: calls 250
*** FLOP *** [3s As 5s]
Hattori: checks
MrBlue: bets 300
Hattori: folds
Uncalled bet (300) returned to MrBlue
MrBlue collected 700.0 from pot
*** SUMMARY ***
Total pot 700 | Rake 0
Board [3s As 5s]


PokerStars Hand #75160: Hold'em No Limit (50/100) - 2019/07/11 20:52:40 ET
Table 'Pluribus Session 75' 6-max (Play Money) Seat #6 is the button
Seat 1: MrBlue (10000 in chips)
Seat 2: Pluribus (10000 in chips)
Seat 3: Budd (10000 in chips)
Seat 4: MrWhite (10000 in chips)
Seat 5: MrOrange (10000 in chips)
Seat 6: Hattori (10000 in chips)
MrBlue: posts small blind 50
Pluribus: posts big blind 100
*** HOLE CARDS ***
Dealt to MrBlue [4s 5d]
Dealt to Pluribus [Ks 9h]
Dealt to Budd [Qs Th]
Dealt to MrWhite [Js 8d]
Dealt to MrOrange [2s Qc]
Dealt to Hattori [8c 3s]
Budd: folds
MrWhite: folds
MrOrange: folds
Hattori: folds
MrBlue: calls 50
Pluribus: checks
*** FLOP *** [Qh 2c 4d]
MrBlue: checks
Pluribus: checks
*** TURN *** [Qh 2c 4d] [Td]
MrBlue: checks
Pluribus: checks
*** RIVER *** [Qh 2c 4d] [Td] [Kc]
MrBlue: checks
Pluribus: bets 100
MrBlue: calls 100
*** SHOWDOWN ***
Pluribus: shows [Ks 9h]
Pluribus collected 400.0 from pot
*** SUMMARY ***
Total pot 400 | Rake 0
Board [Qh 2c 4d Td Kc]
Seat 1: MrBlue showed [4s 5d] and lost
Seat 2: Pluribus showed [Ks 9h] and won (400.0)


PokerStars Hand #75161: Hold'em No Limit (50/100) - 2019/07/11 20:52:41 ET
Table 'Pluribus Session 75' 6-max (Play Money) Seat #6 is the button
Seat 1: Pluribus (10000 in chips)
Seat 2: Budd (10000 in chips)
Seat 3: MrWhite (10000 in chips)
Seat 4: MrOrange (10000 in chips)
Seat 5: Hattori (10000 in chips)
Seat 6: MrBlue (10000 in chips)
Pluribus: posts small blind 50
Budd: posts big blind 100
*** HOLE CARDS ***
Dealt to Pluribus [5d Qs]
Dealt to Budd [3d Ts]
Dealt to MrWhite [7s 6s]
Dealt to MrOrange [9s As]
Dealt to Hattori [Jh Td]
Dealt to MrBlue [4c 9c]
MrWhite: raises 125 to 225
MrOrange: raises 475 to 700
Hattori: folds
MrBlue: folds
Pluribus: folds
Budd: folds
MrWhite: folds
Uncalled bet (475) returned to MrOrange
MrOrange collected 600.0 from pot
*** SUMMARY ***
Total pot 600 | Rake 0


PokerStars Hand #75162: Hold'em No Limit (50/100) - 2019/07/11 20:52:42 ET
Table 'Pluribus Session 75' 6-max (Play Money) Seat #6 is the button
Seat 1: Budd (10000 in chips)
Seat 2: MrWhite (10000 in chips)
Seat 3: MrOrange (10000 in chips)
Seat 4: Hattori (10000 in chips)
Seat 5: MrBlue (10000 in chips)
Seat 6: Pluribus (10000 in chips)
Budd: posts small blind 50
MrWhite: posts big blind 100
*** HOLE CARDS ***
Dealt to Budd [As 8c]
Dealt to MrWhite [Kh 4d]
Dealt to MrOrange [9d 9c]
Dealt to Hattori [2c 5s]
Dealt to MrBlue [Tc Ts]
Dealt to Pluribus [7s 8h]
MrOrange: raises 100 to 200
Hattori: folds
MrBlue: calls 200
Pluribus: folds
Budd: folds
MrWhite: folds
*** FLOP *** [7h 8d Kc]
MrOrange: checks
MrBlue: checks
*** TURN *** [7h 8d Kc] [Js]
MrOrange: checks
MrBlue: checks
*** RIVER *** [7h 8d Kc] [Js] [5h]
MrOrange: checks
MrBlue: bets 200
MrOrange: folds
Uncalled bet (200) returned to MrBlue
MrBlue collected 550.0 from pot
*** SUMMARY ***
Total pot 550 | Rake 0
Board [7h 8d Kc Js 5h]


PokerStars Hand #75163: Hold'em No Limit (50/100) - 2019/07/11 20:52:43 ET
Table 'Pluribus Session 75' 6-max (Play Money) Seat #6 is the button
Seat 1: MrWhite (10000 in chips)
Seat 2: MrOrange (10000 in chips)
Seat 3: Hattori (10000 in chips)
Seat 4: MrBlue (10000 in chips)
Seat 5: Pluribus (10000 in chips)
Seat 6: Budd (10000 in chips)
MrWhite: posts small blind 50
MrOrange: posts big blind 100
*** HOLE CARDS ***
Dealt to MrWhite [Ah Th]
Dealt to MrOrange [As Td]
Dealt to Hattori [8d Kd]
Dealt to MrBlue [9c Qc]
Dealt to Pluribus [Tc Ac]
Dealt to Budd [9d 8c]
Hattori: raises 100 to 200
MrBlue: folds
Pluribus: raises 412 to 612
Budd: folds
MrWhite: folds
MrOrange: folds
Hattori: folds
Uncalled bet (412) returned to Pluribus
Pluribus collected 550.0 from pot
*** SUMMARY ***
Total pot 550 | Rake 0


PokerStars Hand #75164: Hold'em No Limit (50/100) - 2019/07/11 20:52:44 ET
Table 'Pluribus Session 75' 6-max (Play Money) Seat #6 is the button
Seat 1: MrOrange (10000 in chips)
Seat 2: Hattori (10000 in chips)
Seat 3: MrBlue (10000 in chips)
Seat 4: Pluribus (10000 in chips)
Seat 5: Budd (10000 in chips)
Seat 6: MrWhite (10000 in chips)
MrOrange: posts small blind 50
Hattori: posts big blind 100
*** HOLE CARDS ***
Dealt to MrOrange [Kc 7d]
Dealt to Hattori [6c Js]
Dealt to MrBlue [3d 3h]
Dealt to Pluribus [Kh Qs]
Dealt to Budd [Ks 9s]
Dealt to MrWhite [4d Qd]
MrBlue: raises 125 to 225
Pluribus: folds
Budd: folds
MrWhite: folds
MrOrange: folds
Hattori: folds
Uncalled bet (125) returned to MrBlue
MrBlue collected 250.0 from pot
*** SUMMARY ***
Total pot 250 | Rake 0


PokerStars Hand #75165: Hold'em No Limit (50/100) - 2019/07/11 20:52:45 ET
Table 'Pluribus Session 75' 6-max (Play Money) Seat #6 is the button
Seat 1: Hattori (10000 in chips)
Seat 2: MrBlue (10000 in chips)
Seat 3: Pluribus (10000 in chips)
Seat 4: Budd (10000 in chips)
Seat 5: MrWhite (10000 in chips)
Seat 6: MrOrange (10000 in chips)
Hattori: posts small blind 50
MrBlue: posts big blind 100
*** HOLE CARDS ***
Dealt to Hattori [2d 9d]
Dealt to MrBlue [Ah 6h]
Dealt to Pluribus [Th 5c]
Dealt to Budd [7c 9h]
Dealt to MrWhite [Ac 9s]
Dealt to MrOrange [4h 3s]
Pluribus: folds
Budd: folds
MrWhite: folds
MrOrange: folds
Hattori: folds
Uncalled bet (50) returned to MrBlue
MrBlue collected 100.0 from pot
*** SUMMARY ***
Total pot 100 | Rake 0


PokerStars Hand #75166: Hold'em No Limit (50/100) - 2019/07/11 20:52:46 ET
Table 'Pluribus Session 75' 6-max (Play Money) Seat #6 is the button
Seat 1: MrBlue (10000 in chips)
Seat 2: Pluribus (10000 in chips)
Seat 3: Budd (10000 in chips)
Seat 4: MrWhite (10000 in chips)
Seat 5: MrOrange (10000 in chips)
Seat 6: Hattori (10000 in chips)
MrBlue: posts small blind 50
Pluribus: posts big blind 100
*** HOLE CARDS ***
Dealt to MrBlue [Tc Ad]
Dealt to Pluribus [2s 5h]
Dealt to Budd [Qd 7c]
Dealt to MrWhite [Ah 6s]
Dealt to MrOrange [3d 9h]
Dealt to Hattori [Jc Js]
Budd: folds
MrWhite: folds
MrOrange: folds
Hattori: raises 125 to 225
MrBlue: calls 175
Pluribus: folds
*** FLOP *** [6c 2d 8s]
MrBlue: checks
Hattori: bets 459
MrBlue: folds
Uncalled bet (459) returned to Hattori
Hattori collected 550.0 from pot
*** SUMMARY ***
Total pot 550 | Rake 0
Board [6c 2d 8s]


PokerStars Hand #75167: Hold'em No Limit (50/100) - 2019/07/11 20:52:47 ET
Table 'Pluribus Session 75' 6-max (Play Money) Seat #6 is the button
Seat 1: Pluribus (10000 in chips)
Seat 2: Budd (10000 in chips)
Seat 3: MrWhite (10000 in chips)
Seat 4: MrOrange (10000 in chips)
Seat 5: Hattori (10000 in chips)
Seat 6: MrBlue (10000 in chips)
Pluribus: posts small blind 50
Budd: posts big blind 100
*** HOLE CARDS ***
Dealt to Pluribus [As 8s]
Dealt to Budd [Js 3s]
Dealt to MrWhite [8h 3c]
Dealt to MrOrange [Jh Qs]
Dealt to Hattori [3d Ks]
Dealt to MrBlue [Th 2h]
MrWhite: folds
MrOrange: folds
Hattori: folds
MrBlue: folds
Pluribus: raises 175 to 275
Budd: raises 550 to 825
Pluribus: calls 550
*** FLOP *** [8d 6d 5c]
Pluribus: checks
Budd: bets 575
Pluribus: calls 575
*** TURN *** [8d 6d 5c] [Kd]
Pluribus: checks
Budd: checks
*** RIVER *** [8d 6d 5c] [Kd] [5h]
Pluribus: checks
Budd: checks
*** SHOWDOWN ***
Pluribus: shows [As 8s]
Pluribus collected 2800.0 from pot
*** SUMMARY ***
Total pot 2800 | Rake 0
Board [8d 6d 5c Kd 5h]
Seat 1: Pluribus showed [As 8s] and won (2800.0)
Seat 2: Budd showed [Js 3s] and lost


PokerStars Hand #75168: Hold'em No Limit (50/100) - 2019/07/11 20:52:48 ET
Table 'Pluribus Session 75' 6-max (Play Money) Seat #6 is the button
Seat 1: Budd (10000 in chips)
Seat 2: MrWhite (10000 in chips)
Seat 3: MrOrange (10000 in chips)
Seat 4: Hattori (10000 in chips)
Seat 5: MrBlue (10000 in chips)
Seat 6: Pluribus (10000 in chips)
Budd: posts small blind 50
MrWhite: posts big blind 100
*** HOLE CARDS ***
Dealt to Budd [Jc 2h]
Dealt to MrWhite [3h Qs]
Dealt to MrOrange [Ah 3c]
Dealt to Hattori [8d 8s]
Dealt to MrBlue [4c Jd]
Dealt to Pluribus [5s Tc]
MrOrange: folds
Hattori: raises 100 to 200
MrBlue: folds
Pluribus: folds
Budd: folds
MrWhite: folds
Uncalled bet (100) returned to Hattori
Hattori collected 250.0 from pot
*** SUMMARY ***
Total pot 250 | Rake 0


PokerStars Hand #75169: Hold'em No Limit (50/100) - 2019/07/11 20:52:49 ET
Table 'Pluribus Session 75' 6-max (Play Money) Seat #6 is the button
Seat 1: MrWhite (10000 in chips)
Seat 2: MrOrange (10000 in chips)
Seat 3: Hattori (10000 in chips)
Seat 4: MrBlue (10000 in chips)
Seat 5: Pluribus (10000 in chips)
Seat 6: Budd (10000 in chips)
MrWhite: posts small blind 50
MrOrange: posts big blind 100
*** HOLE CARDS ***
Dealt to MrWhite [3c Jh]
Dealt to MrOrange [Ad 2c]
Dealt to Hattori [3d 9s]
Dealt to MrBlue [7h 7s]
Dealt to Pluribus [Jc Jd]
Dealt to Budd [Qs 4s]
Hattori: folds
MrBlue: raises 125 to 225
Pluribus: raises 525 to 750
Budd: folds
MrWhite: folds
MrOrange: folds
MrBlue: calls 525
*** FLOP *** [Ts 8h 9h]
MrBlue: checks
Pluribus: bets 412
MrBlue: calls 412
*** TURN *** [Ts 8h 9h] [8c]
MrBlue: checks
Pluribus: checks
*** RIVER *** [Ts 8h 9h] [8c] [Tc]
MrBlue: checks
Pluribus: bets 2474
MrBlue: folds
Uncalled bet (2474) returned to Pluribus
Pluribus collected 2474.0 from pot
*** SUMMARY ***
Total pot 2474 | Rake 0
Board [Ts 8h 9h 8c Tc]


PokerStars Hand #75170: Hold'em No Limit (50/100) - 2019/07/11 20:52:50 ET
Table 'Pluribus Session 75' 6-max (Play Money) Seat #6 is the button
Seat 1: MrOrange (10000 in chips)
Seat 2: Hattori (10000 in chips)
Seat 3: MrBlue (10000 in chips)
Seat 4: Pluribus (10000 in chips)
Seat 5: Budd (10000 in chips)
Seat 6: MrWhite (10000 in chips)
MrOrange: posts small blind 50
Hattori: posts big blind 100
*** HOLE CARDS ***
Dealt to MrOrange [2c Jd]
Dealt to Hattori [Jc 8h]
Dealt to MrBlue [5c Kh]
Dealt to Pluribus [Th Jh]
Dealt to Budd [8c 7h]
Dealt to MrWhite [6s Kc]
MrBlue: folds
Pluribus: raises 100 to 200
Budd: folds
MrWhite: folds
MrOrange: folds
Hattori: folds
Uncalled bet (100) returned to Pluribus
Pluribus collected 250.0 from pot
*** SUMMARY ***
Total pot 250 | Rake 0


PokerStars Hand #75171: Hold'em No Limit (50/100) - 2019/07/11 20:52:51 ET
Table 'Pluribus Session 75' 6-max (Play Money) Seat #6 is the button
Seat 1: Hattori (10000 in chips)
Seat 2: MrBlue (10000 in chips)
Seat 3: Pluribus (10000 in chips)
Seat 4: Budd (10000 in chips)
Seat 5: MrWhite (10000 in chips)
Seat 6: MrOrange (10000 in chips)
Hattori: posts small blind 50
MrBlue: posts big blind 100
*** HOLE CARDS ***
Dealt to Hattori [Qc 8c]
Dealt to MrBlue [5h 3c]
Dealt to Pluribus [6h 9s]
Dealt to Budd [7d Ah]
Dealt to MrWhite [9c Jh]
Dealt to MrOrange [4h 5c]
Pluribus: folds
Budd: folds
MrWhite: folds
MrOrange: folds
Hattori: calls 50
MrBlue: raises 250 to 350
Hattori: calls 250
*** FLOP *** [4c Js 7s]
Hattori: checks
MrBlue: bets 400
Hattori: raises 1100 to 1500
MrBlue: folds
Uncalled bet (1100) returned to Hattori
Hattori collected 1500.0 from pot
*** SUMMARY ***
Total pot 1500 | Rake 0
Board [4c Js 7s]


PokerStars Hand #75172: Hold'em No Limit (50/100) - 2019/07/11 20:52:52 ET
Table 'Pluribus Session 75' 6-max (Play Money) Seat #6 is the button
Seat 1: MrBlue (10000 in chips)
Seat 2: Pluribus (10000 in chips)
Seat 3: Budd (10000 in chips)
Seat 4: MrWhite (10000 in chips)
Seat 5: MrOrange (10000 in chips)
Seat 6: Hattori (10000 in chips)
MrBlue: posts small blind 50
Pluribus: posts big blind 100
*** HOLE CARDS ***
Dealt to MrBlue [Ac 4c]
Dealt to Pluribus [2h 6d]
Dealt to Budd [8s Qc]
Dealt to MrWhite [Ah 5d]
Dealt to MrOrange [Qs Qd]
Dealt to Hattori [4h Jd]
Budd: folds
MrWhite: folds
MrOrange: raises 120 to 220
Hattori: folds
MrBlue: calls 170
Pluribus: folds
*** FLOP *** [Jc 2d 9d]
MrBlue: checks
MrOrange: bets 255
MrBlue: folds
Uncalled bet (255) returned to MrOrange
MrOrange collected 540.0 from pot
*** SUMMARY ***
Total pot 540 | Rake 0
Board [Jc 2d 9d]


PokerStars Hand #75173: Hold'em No Limit (50/100) - 2019/07/11 20:52:53 ET
Table 'Pluribus Session 75' 6-max (Play Money) Seat #6 is the button
Seat 1: Pluribus (10000 in chips)
Seat 2: Budd (10000 in chips)
Seat 3: MrWhite (10000 in chips)
Seat 4: MrOrange (10000 in chips)
Seat 5: Hattori (10000 in chips)
Seat 6: MrBlue (10000 in chips)
Pluribus: posts small blind 50
Budd: posts big blind 100
*** HOLE CARDS ***
Dealt to Pluribus [6s 8c]
Dealt to Budd [2h 2c]
Dealt to MrWhite [4h 9s]
Dealt to MrOrange [Th 3s]
Dealt to Hattori [3c Kd]
Dealt to MrBlue [7h Kc]
MrWhite: folds
MrOrange: folds
Hattori: folds
MrBlue: folds
Pluribus: folds
Uncalled bet (50) returned to Budd
Budd collected 100.0 from pot
*** SUMMARY ***
Total pot 100 | Rake 0
