PokerStars Hand #78000: Hold'em No Limit (50/100) - 2019/07/11 21:40:00 ET
Table 'Pluribus Session 78' 6-max (Play Money) Seat #6 is the button
Seat 1: Budd (10000 in chips)
Seat 2: MrWhite (10000 in chips)
Seat 3: MrOrange (10000 in chips)
Seat 4: Hattori (10000 in chips)
Seat 5: MrBlue (10000 in chips)
Seat 6: Pluribus (10000 in chips)
Budd: posts small blind 50
MrWhite: posts big blind 100
*** HOLE CARDS ***
Dealt to Budd [6d Qh]
Dealt to MrWhite [5h 8d]
Dealt to MrOrange [Jc 2s]
Dealt to Hattori [Ks 5c]
Dealt to MrBlue [Tc Kh]
Dealt to Pluribus [9s 7c]
MrOrange: folds
Hattori: folds
MrBlue: raises 125 to 225
Pluribus: folds
Budd: folds
MrWhite: folds
Uncalled bet (125) returned to MrBlue
MrBlue collected 250.0 from pot
*** SUMMARY ***
Total pot 250 | Rake 0


PokerStars Hand #78001: Hold'em No Limit (50/100) - 2019/07/11 21:40:01 ET
Table 'Pluribus Session 78' 6-max (Play Money) Seat #6 is the button
Seat 1: MrWhite (10000 in chips)
Seat 2: MrOrange (10000 in chips)
Seat 3: Hattori (10000 in chips)
Seat 4: MrBlue (10000 in chips)
Seat 5: Pluribus (10000 in chips)
Seat 6: Budd (10000 in chips)
MrWhite: posts small blind 50
MrOrange: posts big blind 100
*** HOLE CARDS ***
Dealt to MrWhite [8h Jh]
Dealt to MrOrange [7d 3c]
Dealt to Hattori [Qd 5s]
Dealt to MrBlue [5d Ts]
Dealt to Pluribus [7c Ac]
Dealt to Budd [4c Kc]
Hattori: folds
MrBlue: folds
Pluribus: raises 100 to 200
Budd: folds
MrWhite: folds
MrOrange: folds
Uncalled bet (100) returned to Pluribus
Pluribus collected 250.0 from pot
*** SUMMARY ***
Total pot 250 | Rake 0


PokerStars Hand #78002: Hold'em No Limit (50/100) - 2019/07/11 21:40:02 ET
Table 'Pluribus Session 78' 6-max (Play Money) Seat #6 is the button
Seat 1: MrOrange (10000 in chips)
Seat 2: Hattori (10000 in chips)
Seat 3: MrBlue (10000 in chips)
Seat 4: Pluribus (10000 in chips)
Seat 5: Budd (10000 in chips)
Seat 6: MrWhite (10000 in chips)
MrOrange: posts small blind 50
Hattori: posts big blind 100
*** HOLE CARDS ***
Dealt to MrOrange [5h Th]
Dealt to Hattori [Qs Ts]
Dealt to MrBlue [6d Ah]
Dealt to Pluribus [5d 6s]
Dealt to Budd [8c Ac]
Dealt to MrWhite [Ks Jd]
MrBlue: folds
Pluribus: folds
Budd: raises 125 to 225
MrWhite: calls 225
MrOrange: folds
Hattori: raises 1075 to 1300
Budd: folds
MrWhite: folds
Uncalled bet (1075) returned to Hattori
Hattori collected 725.0 from pot
*** SUMMARY ***
Total pot 725 | Rake 0


PokerStars Hand #78003: Hold'em No Limit (50/100) - 2019/07/11 21:40:03 ET
Table 'Pluribus Session 78' 6-max (Play Money) Seat #6 is the button
Seat 1: Hattori (10000 in chips)
Seat 2: MrBlue (10000 in chips)
Seat 3: Pluribus (10000 in chips)
Seat 4: Budd (10000 in chips)
Seat 5: MrWhite (10000 in chips)
Seat 6: MrOrange (10000 in chips)
Hattori: posts small blind 50
MrBlue: posts big blind 100
*** HOLE CARDS ***
Dealt to Hattori [6c Jc]
Dealt to MrBlue [5d 4s]
Dealt to Pluribus [9s 7h]
Dealt to Budd [3s 3d]
Dealt to MrWhite [6s Th]
Dealt to MrOrange [6h 4h]
Pluribus: folds
Budd: folds
MrWhite: folds
MrOrange: folds
Hattori: raises 133 to 233
MrBlue: raises 505 to 738
Hattori: folds
Uncalled bet (505) returned to MrBlue
MrBlue collected 466.0 from pot
*** SUMMARY ***
Total pot 466 | Rake 0


PokerStars Hand #78004: Hold'em No Limit (50/100) - 2019/07/11 21:40:04 ET
Table 'Pluribus Session 78' 6-max (Play Money) Seat #6 is the button
Seat 1: MrBlue (10000 in chips)
Seat 2: Pluribus (10000 in chips)
Seat 3: Budd (10000 in chips)
Seat 4: MrWhite (10000 in chips)
Seat 5: MrOrange (10000 in chips)
Seat 6: Hattori (10000 in chips)
MrBlue: posts small blind 50
Pluribus: posts big blind 100
*** HOLE CARDS ***
Dealt to MrBlue [6d 2c]
Dealt to Pluribus [3d Kc]
Dealt to Budd [8s 6c]
Dealt to MrWhite [2d 5h]
Dealt to MrOrange [Kd 2s]
Dealt to Hattori [6h 9h]
Budd: folds
MrWhite: folds
MrOrange: folds
Hattori: raises 125 to 225
MrBlue: folds
Pluribus: folds
Uncalled bet (125) returned to Hattori
Hattori collected 250.0 from pot
*** SUMMARY ***
Total pot 250 | Rake 0


PokerStars Hand #78005: Hold'em No Limit (50/100) - 2019/07/11 21:40:05 ET
Table 'Pluribus Session 78' 6-max (Play Money) Seat #6 is the button
Seat 1: Pluribus (10000 in chips)
Seat 2: Budd (10000 in chips)
Seat 3: MrWhite (10000 in chips)
Seat 4: MrOrange (10000 in chips)
Seat 5: Hattori (10000 in chips)
Seat 6: MrBlue (10000 in chips)
Pluribus: posts small blind 50
Budd: posts big blind 100
*** HOLE CARDS ***
Dealt to Pluribus [Ks 2h]
Dealt to Budd [Jc Tc]
Dealt to MrWhite [8h Jd]
Dealt to MrOrange [Th 7h]
Dealt to Hattori [As 5h]
Dealt to MrBlue [5d 8s]
MrWhite: folds
MrOrange: folds
Hattori: folds
MrBlue: folds
Pluribus: folds
Uncalled bet (50) returned to Budd
Budd collected 100.0 from pot
*** SUMMARY ***
Total pot 100 | Rake 0


PokerStars Hand #78006: Hold'em No Limit (50/100) - 2019/07/11 21:40:06 ET
Table 'Pluribus Session 78' 6-max (Play Money) Seat #6 is the button
Seat 1: Budd (10000 in chips)
Seat 2: MrWhite (10000 in chips)
Seat 3: MrOrange (10000 in chips)
Seat 4: Hattori (10000 in chips)
Seat 5: MrBlue (10000 in chips)
Seat 6: Pluribus (10000 in chips)
Budd: posts small blind 50
MrWhite: posts big blind 100
*** HOLE CARDS ***
Dealt to Budd [4d 2c]
Dealt to MrWhite [Tc 9d]
Dealt to MrOrange [Jh 4c]
Dealt to Hattori [6s 9s]
Dealt to MrBlue [Td Qd]
Dealt to Pluribus [Th Kc]
MrOrange: folds
Hattori: folds
MrBlue: raises 125 to 225
Pluribus: folds
Budd: folds
MrWhite: calls 125
*** FLOP *** [2h 6h 8d]
MrWhite: checks
MrBlue: checks
*** TURN *** [2h 6h 8d] [As]
MrWhite: checks
MrBlue: bets 375
MrWhite: raises 1250 to 1625
MrBlue: folds
Uncalled bet (1250) returned to MrWhite
MrWhite collected 1250.0 from pot
*** SUMMARY ***
Total pot 1250 | Rake 0
Board [2h 6h 8d As]


PokerStars Hand #78007: Hold'em No Limit (50/100) - 2019/07/11 21:40:07 ET
Table 'Pluribus Session 78' 6-max (Play Money) Seat #6 is the button
Seat 1: MrWhite (10000 in chips)
Seat 2: MrOrange (10000 in chips)
Seat 3: Hattori (10000 in chips)
Seat 4: MrBlue (10000 in chips)
Seat 5: Pluribus (10000 in chips)
Seat 6: Budd (10000 in chips)
MrWhite: posts small blind 50
MrOrange: posts big blind 100
*** HOLE CARDS ***
Dealt to MrWhite [8h Kc]
Dealt to MrOrange [8d As]
Dealt to Hattori [4c Th]
Dealt to MrBlue [6c 5c]
Dealt to Pluribus [Ac 6s]
Dealt to Budd [Qh Jd]
Hattori: folds
MrBlue: raises 125 to 225
Pluribus: folds
Budd: folds
MrWhite: folds
MrOrange: folds
Uncalled bet (125) returned to MrBlue
MrBlue collected 250.0 from pot
*** SUMMARY ***
Total pot 250 | Rake 0


PokerStars Hand #78008: Hold'em No Limit (50/100) - 2019/07/11 21:40:08 ET
Table 'Pluribus Session 78' 6-max (Play Money) Seat #6 is the button
Seat 1: MrOrange (10000 in chips)
Seat 2: Hattori (10000 in chips)
Seat 3: MrBlue (10000 in chips)
Seat 4: Pluribus (10000 in chips)
Seat 5: Budd (10000 in chips)
Seat 6: MrWhite (10000 in chips)
MrOrange: posts small blind 50
Hattori: posts big blind 100
*** HOLE CARDS ***
Dealt to MrOrange [9h Jd]
Dealt to Hattori [3d Qc]
Dealt to MrBlue [4s Ad]
Dealt to Pluribus [3s Tc]
Dealt to Budd [Kh 5h]
Dealt to MrWhite [7s 6c]
MrBlue: folds
Pluribus: folds
Budd: raises 125 to 225
MrWhite: folds
MrOrange: folds
Hattori: folds
Uncalled bet (125) returned to Budd
Budd collected 250.0 from pot
*** SUMMARY ***
Total pot 250 | Rake 0


PokerStars Hand #78009: Hold'em No Limit (50/100) - 2019/07/11 21:40:09 ET
Table 'Pluribus Session 78' 6-max (Play Money) Seat #6 is the button
Seat 1: Hattori (10000 in chips)
Seat 2: MrBlue (10000 in chips)
Seat 3: Pluribus (10000 in chips)
Seat 4: Budd (10000 in chips)
Seat 5: MrWhite (10000 in chips)
Seat 6: MrOrange (10000 in chips)
Hattori: posts small blind 50
MrBlue: posts big blind 100
*** HOLE CARDS ***
Dealt to Hattori [2h Tc]
Dealt to MrBlue [Js 4d]
Dealt to Pluribus [6c 7h]
Dealt to Budd [5h 7s]
Dealt to MrWhite [9c 5c]
Dealt to MrOrange [Ks 8s]
Pluribus: folds
Budd: folds
MrWhite: folds
MrOrange: raises 124 to 224
Hattori: folds
MrBlue: folds
Uncalled bet (124) returned to MrOrange
MrOrange collected 250.0 from pot
*** SUMMARY ***
Total pot 250 | Rake 0


PokerStars Hand #78010: Hold'em No Limit (50/100) - 2019/07/11 21:40:10 ET
Table 'Pluribus Session 78' 6-max (Play Money) Seat #6 is the button
Seat 1: MrBlue (10000 in chips)
Seat 2: Pluribus (10000 in chips)
Seat 3: Budd (10000 in chips)
Seat 4: MrWhite (10000 in chips)
Seat 5: MrOrange (10000 in chips)
Seat 6: Hattori (10000 in chips)
MrBlue: posts small blind 50
Pluribus: posts big blind 100
*** HOLE CARDS ***
Dealt to MrBlue [6h Qs]
Dealt to Pluribus [7h 5s]
Dealt to Budd [Kh 9h]
Dealt to MrWhite [6c Kd]
Dealt to MrOrange [5c Jd]
Dealt to Hattori [4h Ah]
Budd: raises 125 to 225
MrWhite: folds
MrOrange: folds
Hattori: raises 575 to 800
MrBlue: folds
Pluribus: folds
Budd: folds
Uncalled bet (575) returned to Hattori
Hattori collected 600.0 from pot
*** SUMMARY ***
Total pot 600 | Rake 0


PokerStars Hand #78011: Hold'em No Limit (50/100) - 2019/07/11 21:40:11 ET
Table 'Pluribus Session 78' 6-max (Play Money) Seat #6 is the button
Seat 1: Pluribus (10000 in chips)
Seat 2: Budd (10000 in chips)
Seat 3: MrWhite (10000 in chips)
Seat 4: MrOrange (10000 in chips)
Seat 5: Hattori (10000 in chips)
Seat 6: MrBlue (10000 in chips)
Pluribus: posts small blind 50
Budd: posts big blind 100
*** HOLE CARDS ***
Dealt to Pluribus [2c 9d]
Dealt to Budd [6s 4c]
Dealt to MrWhite [As Ts]
Dealt to MrOrange [Tc Td]
Dealt to Hattori [4s Qh]
Dealt to MrBlue [Qc 9c]
MrWhite: raises 125 to 225
MrOrange: calls 225
Hattori: folds
MrBlue: folds
Pluribus: folds
Budd: folds
*** FLOP *** [4d Kh 9h]
MrWhite: checks
MrOrange: checks
*** TURN *** [4d Kh 9h] [Jh]
MrWhite: bets 450
MrOrange: folds
Uncalled bet (450) returned to MrWhite
MrWhite collected 600.0 from pot
*** SUMMARY ***
Total pot 600 | Rake 0
Board [4d Kh 9h Jh]


PokerStars Hand #78012: Hold'em No Limit (50/100) - 2019/07/11 21:40:12 ET
Table 'Pluribus Session 78' 6-max (Play Money) Seat #6 is the button
Seat 1: Budd (10000 in chips)
Seat 2: MrWhite (10000 in chips)
Seat 3: MrOrange (10000 in chips)
Seat 4: Hattori (10000 in chips)
Seat 5: MrBlue (10000 in chips)
Seat 6: Pluribus (10000 in chips)
Budd: posts small blind 50
MrWhite: posts big blind 100
*** HOLE CARDS ***
Dealt to Budd [Td Ts]
Dealt to MrWhite [2s Kd]
Dealt to MrOrange [4h 2c]
Dealt to Hattori [Ad 3d]
Dealt to MrBlue [9s Qc]
Dealt to Pluribus [Jh 9c]
MrOrange: folds
Hattori: raises 100 to 200
MrBlue: folds
Pluribus: folds
Budd: calls 150
MrWhite: calls 100
*** FLOP *** [4c 6s 9d]
Budd: checks
MrWhite: checks
Hattori: checks
*** TURN *** [4c 6s 9d] [5s]
Budd: bets 450
MrWhite: folds
Hattori: calls 450
*** RIVER *** [4c 6s 9d] [5s] [6h]
Budd: bets 1500
Hattori: folds
Uncalled bet (1500) returned to Budd
Budd collected 1500.0 from pot
*** SUMMARY ***
Total pot 1500 | Rake 0
Board [4c 6s 9d 5s 6h]


PokerStars Hand #78013: Hold'em No Limit (50/100) - 2019/07/11 21:40:13 ET
Table 'Pluribus Session 78' 6-max (Play Money) Seat #6 is the button
Seat 1: MrWhite (10000 in chips)
Seat 2: MrOrange (10000 in chips)
Seat 3: Hattori (10000 in chips)
Seat 4: MrBlue (10000 in chips)
Seat 5: Pluribus (10000 in chips)
Seat 6: Budd (10000 in chips)
MrWhite: posts small blind 50
MrOrange: posts big blind 100
*** HOLE CARDS ***
Dealt to MrWhite [4h 8h]
Dealt to MrOrange [Ac Th]
Dealt to Hattori [6s Tc]
Dealt to MrBlue [Ts Jh]
Dealt to Pluribus [Jc 3h]
Dealt to Budd [6c 6d]
Hattori: folds
MrBlue: folds
Pluribus: folds
Budd: raises 150 to 250
MrWhite: folds
MrOrange: calls 150
*** FLOP *** [7c Kh 4c]
MrOrange: checks
Budd: bets 175
MrOrange: calls 175
*** TURN *** [7c Kh 4c] [2h]
MrOrange: checks
Budd: checks
*** RIVER *** [7c Kh 4c] [2h] [8d]
MrOrange: checks
Budd: checks
*** SHOWDOWN ***
Budd: shows [6c 6d]
Budd collected 900.0 from pot
*** SUMMARY ***
Total pot 900 | Rake 0
Board [7c Kh 4c 2h 8d]
Seat 2: MrOrange showed [Ac Th] and lost
Seat 6: Budd showed [6c 6d] and won (900.0)


PokerStars Hand #78014: Hold'em No Limit (50/100) - 2019/07/11 21:40:14 ET
Table 'Pluribus Session 78' 6-max (Play Money) Seat #6 is the button
Seat 1: MrOrange (10000 in chips)
Seat 2: Hattori (10000 in chips)
Seat 3: MrBlue (10000 in chips)
Seat 4: Pluribus (10000 in chips)
Seat 5: Budd (10000 in chips)
Seat 6: MrWhite (10000 in chips)
MrOrange: posts small blind 50
Hattori: posts big blind 100
*** HOLE CARDS ***
Dealt to MrOrange [Ad 9d]
Dealt to Hattori [2d Jd]
Dealt to MrBlue [Jc Ac]
Dealt to Pluribus [8s 2h]
Dealt to Budd [Ah 6c]
Dealt to MrWhite [6d Qc]
MrBlue: raises 125 to 225
Pluribus: folds
Budd: folds
MrWhite: folds
MrOrange: folds
Hattori: calls 125
*** FLOP *** [7c 2s Td]
Hattori: checks
MrBlue: checks
*** TURN *** [7c 2s Td] [9h]
Hattori: checks
MrBlue: checks
*** RIVER *** [7c 2s Td] [9h] [7d]
Hattori: bets 100
MrBlue: calls 100
*** SHOWDOWN ***
Hattori: shows [2d Jd]
Hattori collected 700.0 from pot
*** SUMMARY ***
Total pot 700 | Rake 0
Board [7c 2s Td 9h 7d]
Seat 2: Hattori showed [2d Jd] and won (700.0)
Seat 3: MrBlue showed [Jc Ac] and lost


PokerStars Hand #78015: Hold'em No Limit (50/100) - 2019/07/11 21:40:15 ET
Table 'Pluribus Session 78' 6-max (Play Money) Seat #6 is the button
Seat 1: Hattori (10000 in chips)
Seat 2: MrBlue (10000 in chips)
Seat 3: Pluribus (10000 in chips)
Seat 4: Budd (10000 in chips)
Seat 5: MrWhite (10000 in chips)
Seat 6: MrOrange (10000 in chips)
Hattori: posts small blind 50
MrBlue: posts big blind 100
*** HOLE CARDS ***
Dealt to Hattori [Qs 9c]
Dealt to MrBlue [Th 4h]
Dealt to Pluribus [Ks Ac]
Dealt to Budd [Qd 4d]
Dealt to MrWhite [3h Jc]
Dealt to MrOrange [8c 9s]
Pluribus: raises 100 to 200
Budd: folds
MrWhite: folds
MrOrange: folds
Hattori: folds
MrBlue: calls 100
*** FLOP *** [Js 5s 4s]
MrBlue: checks
Pluribus: bets 225
MrBlue: folds
Uncalled bet (225) returned to Pluribus
Pluribus collected 450.0 from pot
*** SUMMARY ***
Total pot 450 | Rake 0
Board [Js 5s 4s]


PokerStars Hand #78016: Hold'em No Limit (50/100) - 2019/07/11 21:40:16 ET
Table 'Pluribus Session 78' 6-max (Play Money) Seat #6 is the button
Seat 1: MrBlue (10000 in chips)
Seat 2: Pluribus (10000 in chips)
Seat 3: Budd (10000 in chips)
Seat 4: MrWhite (10000 in chips)
Seat 5: MrOrange (10000 in chips)
Seat 6: Hattori (10000 in chips)
MrBlue: posts small blind 50
Pluribus: posts big blind 100
*** HOLE CARDS ***
Dealt to MrBlue [Ks Ah]
Dealt to Pluribus [Jc 8c]
Dealt to Budd [5s Jd]
Dealt to MrWhite [Jh 3d]
Dealt to MrOrange [6s 8h]
Dealt to Hattori [Kh Qd]
Budd: folds
MrWhite: folds
MrOrange: folds
Hattori: raises 125 to 225
MrBlue: raises 850 to 1075
Pluribus: folds
Hattori: calls 850
*** FLOP *** [Qh 5c Js]
MrBlue: bets 850
Hattori: calls 850
*** TURN *** [Qh 5c Js] [Ad]
MrBlue: checks
Hattori: checks
*** RIVER *** [Qh 5c Js] [Ad] [Qs]
MrBlue: checks
Hattori: bets 4000
MrBlue: raises 4075 to 8075 and is all-in
Hattori: calls 4075 and is all-in
*** SHOWDOWN ***
Hattori: shows [Kh Qd]
Hattori collected 20100.0 from pot
*** SUMMARY ***
Total pot 20100 | Rake 0
Board [Qh 5c Js Ad Qs]
Seat 1: MrBlue showed [Ks Ah] and lost
Seat 6: Hattori showed [Kh Qd] and won (20100.0)


PokerStars Hand #78017: Hold'em No Limit (50/100) - 2019/07/11 21:40:17 ET
Table 'Pluribus Session 78' 6-max (Play Money) Seat #6 is the button
Seat 1: Pluribus (10000 in chips)
Seat 2: Budd (10000 in chips)
Seat 3: MrWhite (10000 in chips)
Seat 4: MrOrange (10000 in chips)
Seat 5: Hattori (10000 in chips)
Seat 6: MrBlue (10000 in chips)
Pluribus: posts small blind 50
Budd: posts big blind 100
*** HOLE CARDS ***
Dealt to Pluribus [Kd 7d]
Dealt to Budd [8s Tc]
Dealt to MrWhite [Ad 2s]
Dealt to MrOrange [Jd 3c]
Dealt to Hattori [Qc 8c]
Dealt to MrBlue [6d Jc]
MrWhite: folds
MrOrange: folds
Hattori: raises 111 to 211
MrBlue: folds
Pluribus: calls 161
Budd: raises 989 to 1200
Hattori: folds
Pluribus: folds
Uncalled bet (989) returned to Budd
Budd collected 633.0 from pot
*** SUMMARY ***
Total pot 633 | Rake 0


PokerStars Hand #78018: Hold'em No Limit (50/100) - 2019/07/11 21:40:18 ET
Table 'Pluribus Session 78' 6-max (Play Money) Seat #6 is the button
Seat 1: Budd (10000 in chips)
Seat 2: MrWhite (10000 in chips)
Seat 3: MrOrange (10000 in chips)
Seat 4: Hattori (10000 in chips)
Seat 5: MrBlue (10000 in chips)
Seat 6: Pluribus (10000 in chips)
Budd: posts small blind 50
MrWhite: posts big blind 100
*** HOLE CARDS ***
Dealt to Budd [Js Kh]
Dealt to MrWhite [Ah As]
Dealt to MrOrange [3c 9h]
Dealt to Hattori [Jh 2d]
Dealt to MrBlue [2h Jd]
Dealt to Pluribus [Qh 4d]
MrOrange: folds
Hattori: folds
MrBlue: folds
Pluribus: folds
Budd: calls 50
MrWhite: raises 200 to 300
Budd: calls 200
*** FLOP *** [Ts 8d 6s]
Budd: checks
MrWhite: bets 450
Budd: folds
Uncalled bet (450) returned to MrWhite
MrWhite collected 600.0 from pot
*** SUMMARY ***
Total pot 600 | Rake 0
Board [Ts 8d 6s]


PokerStars Hand #78019: Hold'em No Limit (50/100) - 2019/07/11 21:40:19 ET
Table 'Pluribus Session 78' 6-max (Play Money) Seat #6 is the button
Seat 1: MrWhite (10000 in chips)
Seat 2: MrOrange (10000 in chips)
Seat 3: Hattori (10000 in chips)
Seat 4: MrBlue (10000 in chips)
Seat 5: Pluribus (10000 in chips)
Seat 6: Budd (10000 in chips)
MrWhite: posts small blind 50
MrOrange: posts big blind 100
*** HOLE CARDS ***
Dealt to MrWhite [2d 2c]
Dealt to MrOrange [Kd 8h]
Dealt to Hattori [3c 3h]
Dealt to MrBlue [6s Js]
Dealt to Pluribus [3s Ah]
Dealt to Budd [Ks Ad]
Hattori: raises 100 to 200
MrBlue: folds
Pluribus: folds
Budd: raises 520 to 720
MrWhite: folds
MrOrange: folds
Hattori: calls 520
*** FLOP *** [9s Td 4h]
Hattori: checks
Budd: bets 550
Hattori: folds
Uncalled bet (550) returned to Budd
Budd collected 1590.0 from pot
*** SUMMARY ***
Total pot 1590 | Rake 0
Board [9s Td 4h]


PokerStars Hand #78020: Hold'em No Limit (50/100) - 2019/07/11 21:40:20 ET
Table 'Pluribus Session 78' 6-max (Play Money) Seat #6 is the button
Seat 1: MrOrange (10000 in chips)
Seat 2: Hattori (10000 in chips)
Seat 3: MrBlue (10000 in chips)
Seat 4: Pluribus (10000 in chips)
Seat 5: Budd (10000 in chips)
Seat 6: MrWhite (10000 in chips)
MrOrange: posts small blind 50
Hattori: posts big blind 100
*** HOLE CARDS ***
Dealt to MrOrange [4s As]
Dealt to Hattori [4h 6s]
Dealt to MrBlue [Kh 5h]
Dealt to Pluribus [3s 7d]
Dealt to Budd [5d 8s]
Dealt to MrWhite [Qc 7h]
MrBlue: folds
Pluribus: folds
Budd: folds
MrWhite: folds
MrOrange: raises 150 to 250
Hattori: calls 150
*** FLOP *** [9s 5c Td]
MrOrange: checks
Hattori: checks
*** TURN *** [9s 5c Td] [Kd]
MrOrange: checks
Hattori: checks
*** RIVER *** [9s 5c Td] [Kd] [Qh]
MrOrange: checks
Hattori: checks
*** SHOWDOWN ***
MrOrange: shows [4s As]
MrOrange collected 500.0 from pot
*** SUMMARY ***
Total pot 500 | Rake 0
Board [9s 5c Td Kd Qh]
Seat 1: MrOrange showed [4s As] and won (500.0)
Seat 2: Hattori showed [4h 6s] and lost


PokerStars Hand #78021: Hold'em No Limit (50/100) - 2019/07/11 21:40:21 ET
Table 'Pluribus Session 78' 6-max (Play Money) Seat #6 is the button
Seat 1: Hattori (10000 in chips)
Seat 2: MrBlue (10000 in chips)
Seat 3: Pluribus (10000 in chips)
Seat 4: Budd (10000 in chips)
Seat 5: MrWhite (10000 in chips)
Seat 6: MrOrange (10000 in chips)
Hattori: posts small blind 50
MrBlue: posts big blind 100
*** HOLE CARDS ***
Dealt to Hattori [5h 4h]
Dealt to MrBlue [As 6h]
Dealt to Pluribus [8h 2s]
Dealt to Budd [6c Ks]
Dealt to MrWhite [2d 7s]
Dealt to MrOrange [Ts 4d]
Pluribus: folds
Budd: folds
MrWhite: folds
MrOrange: folds
Hattori: raises 135 to 235
MrBlue: calls 135
*** FLOP *** [Td Qd 7c]
Hattori: checks
MrBlue: bets 200
Hattori: folds
Uncalled bet (200) returned to MrBlue
MrBlue collected 470.0 from pot
*** SUMMARY ***
Total pot 470 | Rake 0
Board [Td Qd 7c]


PokerStars Hand #78022: Hold'em No Limit (50/100) - 2019/07/11 21:40:22 ET
Table 'Pluribus Session 78' 6-max (Play Money) Seat #6 is the button
Seat 1: MrBlue (10000 in chips)
Seat 2: Pluribus (10000 in chips)
Seat 3: Budd (10000 in chips)
Seat 4: MrWhite (10000 in chips)
Seat 5: MrOrange (10000 in chips)
Seat 6: Hattori (10000 in chips)
MrBlue: posts small blind 50
Pluribus: posts big blind 100
*** HOLE CARDS ***
Dealt to MrBlue [8s 4c]
Dealt to Pluribus [Jh 4s]
Dealt to Budd [9c Tc]
Dealt to MrWhite [Jd Jc]
Dealt to MrOrange [9d 3h]
Dealt to Hattori [Ad 5s]
Budd: raises 125 to 225
MrWhite: calls 225
MrOrange: folds
Hattori: folds
MrBlue: folds
Pluribus: folds
*** FLOP *** [3d Ts 3s]
Budd: checks
MrWhite: bets 300
Budd: calls 300
*** TURN *** [3d Ts 3s] [6c]
Budd: checks
MrWhite: bets 725
Budd: calls 725
*** RIVER *** [3d Ts 3s] [6c] [5c]
Budd: checks
MrWhite: bets 1200
Budd: folds
Uncalled bet (1200) returned to MrWhite
MrWhite collected 2650.0 from pot
*** SUMMARY ***
Total pot 2650 | Rake 0
Board [3d Ts 3s 6c 5c]


PokerStars Hand #78023: Hold'em No Limit (50/100) - 2019/07/11 21:40:23 ET
Table 'Pluribus Session 78' 6-max (Play Money) Seat #6 is the button
Seat 1: Pluribus (10000 in chips)
Seat 2: Budd (10000 in chips)
Seat 3: MrWhite (10000 in chips)
Seat 4: MrOrange (10000 in chips)
Seat 5: Hattori (10000 in chips)
Seat 6: MrBlue (10000 in chips)
Pluribus: posts small blind 50
Budd: posts big blind 100
*** HOLE CARDS ***
Dealt to Pluribus [2s Kc]
Dealt to Budd [2d 6h]
Dealt to MrWhite [9d Qs]
Dealt to MrOrange [5s Qd]
Dealt to Hattori [4s 8s]
Dealt to MrBlue [Qc As]
MrWhite: folds
MrOrange: folds
Hattori: folds
MrBlue: raises 125 to 225
Pluribus: folds
Budd: folds
Uncalled bet (125) returned to MrBlue
MrBlue collected 250.0 from pot
*** SUMMARY ***
Total pot 250 | Rake 0


PokerStars Hand #78024: Hold'em No Limit (50/100) - 2019/07/11 21:40:24 ET
Table 'Pluribus Session 78' 6-max (Play Money) Seat #6 is the button
Seat 1: Budd (10000 in chips)
Seat 2: MrWhite (10000 in chips)
Seat 3: MrOrange (10000 in chips)
Seat 4: Hattori (10000 in chips)
Seat 5: MrBlue (10000 in chips)
Seat 6: Pluribus (10000 in chips)
Budd: posts small blind 50
MrWhite: posts big blind 100
*** HOLE CARDS ***
Dealt to Budd [4h Tc]
Dealt to MrWhite [8h 4d]
Dealt to MrOrange [Qc 7s]
Dealt to Hattori [4c 2h]
Dealt to MrBlue [7h 6h]
Dealt to Pluribus [Ks 5h]
MrOrange: folds
Hattori: folds
MrBlue: raises 125 to 225
Pluribus: folds
Budd: folds
MrWhite: folds
Uncalled bet (125) returned to MrBlue
MrBlue collected 250.0 from pot
*** SUMMARY ***
Total pot 250 | Rake 0


PokerStars Hand #78025: Hold'em No Limit (50/100) - 2019/07/11 21:40:25 ET
Table 'Pluribus Session 78' 6-max (Play Money) Seat #6 is the button
Seat 1: MrWhite (10000 in chips)
Seat 2: MrOrange (10000 in chips)
Seat 3: Hattori (10000 in chips)
Seat 4: MrBlue (10000 in chips)
Seat 5: Pluribus (10000 in chips)
Seat 6: Budd (10000 in chips)
MrWhite: posts small blind 50
MrOrange: posts big blind 100
*** HOLE CARDS ***
Dealt to MrWhite [6h Js]
Dealt to MrOrange [Jh 9c]
Dealt to Hattori [4d 4h]
Dealt to MrBlue [8h 6c]
Dealt to Pluribus [2s Tc]
Dealt to Budd [Td Ah]
Hattori: raises 100 to 200
MrBlue: folds
Pluribus: folds
Budd: folds
MrWhite: folds
MrOrange: folds
Uncalled bet (100) returned to Hattori
Hattori collected 250.0 from pot
*** SUMMARY ***
Total pot 250 | Rake 0


PokerStars Hand #78026: Hold'em No Limit (50/100) - 2019/07/11 21:40:26 ET
Table 'Pluribus Session 78' 6-max (Play Money) Seat #6 is the button
Seat 1: MrOrange (10000 in chips)
Seat 2: Hattori (10000 in chips)
Seat 3: MrBlue (10000 in chips)
Seat 4: Pluribus (10000 in chips)
Seat 5: Budd (10000 in chips)
Seat 6: MrWhite (10000 in chips)
MrOrange: posts small blind 50
Hattori: posts big blind 100
*** HOLE CARDS ***
Dealt to MrOrange [6c 6d]
Dealt to Hattori [Ts 8c]
Dealt to MrBlue [Kh Tc]
Dealt to Pluribus [Ac Qs]
Dealt to Budd [8d Ad]
Dealt to MrWhite [Kd Qd]
MrBlue: folds
Pluribus: raises 150 to 250
Budd: folds
MrWhite: calls 250
MrOrange: calls 200
Hattori: folds
*** FLOP *** [9h 2h 2s]
MrOrange: checks
Pluribus: checks
MrWhite: checks
*** TURN *** [9h 2h 2s] [9s]
MrOrange: checks
Pluribus: checks
MrWhite: checks
*** RIVER *** [9h 2h 2s] [9s] [Kc]
MrOrange: checks
Pluribus: checks
MrWhite: bets 425
MrOrange: folds
Pluribus: raises 1700 to 2125
MrWhite: calls 1700
*** SHOWDOWN ***
MrWhite: shows [Kd Qd]
MrWhite collected 5100.0 from pot
*** SUMMARY ***
Total pot 5100 | Rake 0
Board [9h 2h 2s 9s Kc]
Seat 4: Pluribus showed [Ac Qs] and lost
Seat 6: MrWhite showed [Kd Qd] and won (5100.0)


PokerStars Hand #78027: Hold'em No Limit (50/100) - 2019/07/11 21:40:27 ET
Table 'Pluribus Session 78' 6-max (Play Money) Seat #6 is the button
Seat 1: Hattori (10000 in chips)
Seat 2: MrBlue (10000 in chips)
Seat 3: Pluribus (10000 in chips)
Seat 4: Budd (10000 in chips)
Seat 5: MrWhite (10000 in chips)
Seat 6: MrOrange (10000 in chips)
Hattori: posts small blind 50
MrBlue: posts big blind 100
*** HOLE CARDS ***
Dealt to Hattori [8s Th]
Dealt to MrBlue [3h 5d]
Dealt to Pluribus [Jd Jc]
Dealt to Budd [9s 7s]
Dealt to MrWhite [Ad 7d]
Dealt to MrOrange [Ks 9h]
Pluribus: calls 100
Budd: folds
MrWhite: raises 262 to 362
MrOrange: folds
Hattori: folds
MrBlue: folds
Pluribus: calls 262
*** FLOP *** [7h 5c 6s]
Pluribus: checks
MrWhite: checks
*** TURN *** [7h 5c 6s] [8c]
Pluribus: bets 218
MrWhite: calls 218
*** RIVER *** [7h 5c 6s] [8c] [4c]
Pluribus: checks
MrWhite: bets 982
Pluribus: raises 1637 to 2619
MrWhite: folds
Uncalled bet (1637) returned to Pluribus
Pluribus collected 3274.0 from pot
*** SUMMARY ***
Total pot 3274 | Rake 0
Board [7h 5c 6s 8c 4c]


PokerStars Hand #78028: Hold'em No Limit (50/100) - 2019/07/11 21:40:28 ET
Table 'Pluribus Session 78' 6-max (Play Money) Seat #6 is the button
Seat 1: MrBlue (10000 in chips)
Seat 2: Pluribus (10000 in chips)
Seat 3: Budd (10000 in chips)
Seat 4: MrWhite (10000 in chips)
Seat 5: MrOrange (10000 in chips)
Seat 6: Hattori (10000 in chips)
MrBlue: posts small blind 50
Pluribus: posts big blind 100
*** HOLE CARDS ***
Dealt to MrBlue [3c Ah]
Dealt to Pluribus [Kc 2c]
Dealt to Budd [5h Ts]
Dealt to MrWhite [5s 6h]
Dealt to MrOrange [3s 2h]
Dealt to Hattori [4c Js]
Budd: folds
MrWhite: folds
MrOrange: folds
Hattori: folds
MrBlue: raises 200 to 300
Pluribus: calls 200
*** FLOP *** [6c 4h Td]
MrBlue: checks
Pluribus: checks
*** TURN *** [6c 4h Td] [Ad]
MrBlue: checks
Pluribus: checks
*** RIVER *** [6c 4h Td] [Ad] [4d]
MrBlue: bets 450
Pluribus: folds
Uncalled bet (450) returned to MrBlue
MrBlue collected 600.0 from pot
*** SUMMARY ***
Total pot 600 | Rake 0
Board [6c 4h Td Ad 4d]


PokerStars Hand #78029: Hold'em No Limit (50/100) - 2019/07/11 21:40:29 ET
Table 'Pluribus Session 78' 6-max (Play Money) Seat #6 is the button
Seat 1: Pluribus (10000 in chips)
Seat 2: Budd (10000 in chips)
Seat 3: MrWhite (10000 in chips)
Seat 4: MrOrange (10000 in chips)
Seat 5: Hattori (10000 in chips)
Seat 6: MrBlue (10000 in chips)
Pluribus: posts small blind 50
Budd: posts big blind 100
*** HOLE CARDS ***
Dealt to Pluribus [Jc 5d]
Dealt to Budd [5c 5h]
Dealt to MrWhite [Qd 9s]
Dealt to MrOrange [Td Qc]
Dealt to Hattori [Ts 7c]
Dealt to MrBlue [Kh Jh]
MrWhite: folds
MrOrange: folds
Hattori: folds
MrBlue: raises 125 to 225
Pluribus: folds
Budd: calls 125
*** FLOP *** [9d 3d 9c]
Budd: checks
MrBlue: checks
*** TURN *** [9d 3d 9c] [As]
Budd: checks
MrBlue: checks
*** RIVER *** [9d 3d 9c] [As] [3s]
Budd: bets 250
MrBlue: folds
Uncalled bet (250) returned to Budd
Budd collected 500.0 from pot
*** SUMMARY ***
Total pot 500 | Rake 0
Board [9d 3d 9c As 3s]


PokerStars Hand #78030: Hold'em No Limit (50/100) - 2019/07/11 21:40:30 ET
Table 'Pluribus Session 78' 6-max (Play Money) Seat #6 is the button
Seat 1: Budd (10000 in chips)
Seat 2: MrWhite (10000 in chips)
Seat 3: MrOrange (10000 in chips)
Seat 4: Hattori (10000 in chips)
Seat 5: MrBlue (10000 in chips)
Seat 6: Pluribus (10000 in chips)
Budd: posts small blind 50
MrWhite: posts big blind 100
*** HOLE CARDS ***
Dealt to Budd [5c 7h]
Dealt to MrWhite [2d 4h]
Dealt to MrOrange [7d 8c]
Dealt to Hattori [5s Ac]
Dealt to MrBlue [7s 2s]
Dealt to Pluribus [4c 8d]
MrOrange: folds
Hattori: folds
MrBlue: folds
Pluribus: folds
Budd: folds
Uncalled bet (50) returned to MrWhite
MrWhite collected 100.0 from pot
*** SUMMARY ***
Total pot 100 | Rake 0


PokerStars Hand #78031: Hold'em No Limit (50/100) - 2019/07/11 21:40:31 ET
Table 'Pluribus Session 78' 6-max (Play Money) Seat #6 is the button
Seat 1: MrWhite (10000 in chips)
Seat 2: MrOrange (10000 in chips)
Seat 3: Hattori (10000 in chips)
Seat 4: MrBlue (10000 in chips)
Seat 5: Pluribus (10000 in chips)
Seat 6: Budd (10000 in chips)
MrWhite: posts small blind 50
MrOrange: posts big blind 100
*** HOLE CARDS ***
Dealt to MrWhite [2s Qs]
Dealt to MrOrange [Jc Jh]
Dealt to Hattori [8d 9s]
Dealt to MrBlue [2d 6s]
Dealt to Pluribus [3s 5d]
Dealt to Budd [Jd 2c]
Hattori: folds
MrBlue: folds
Pluribus: folds
Budd: folds
MrWhite: folds
Uncalled bet (50) returned to MrOrange
MrOrange collected 100.0 from pot
*** SUMMARY ***
Total pot 100 | Rake 0


PokerStars Hand #78032: Hold'em No Limit (50/100) - 2019/07/11 21:40:32 ET
Table 'Pluribus Session 78' 6-max (Play Money) Seat #6 is the button
Seat 1: MrOrange (10000 in chips)
Seat 2: Hattori (10000 in chips)
Seat 3: MrBlue (10000 in chips)
Seat 4: Pluribus (10000 in chips)
Seat 5: Budd (10000 in chips)
Seat 6: MrWhite (10000 in chips)
MrOrange: posts small blind 50
Hattori: posts big blind 100
*** HOLE CARDS ***
Dealt to MrOrange [9s 6d]
Dealt to Hattori [Js 5h]
Dealt to MrBlue [Th Ad]
Dealt to Pluribus [Ah 8c]
Dealt to Budd [3s 7s]
Dealt to MrWhite [3h 4d]
MrBlue: folds
Pluribus: folds
Budd: folds
MrWhite: folds
MrOrange: folds
Uncalled bet (50) returned to Hattori
Hattori collected 100.0 from pot
*** SUMMARY ***
Total pot 100 | Rake 0


PokerStars Hand #78033: Hold'em No Limit (50/100) - 2019/07/11 21:40:33 ET
Table 'Pluribus Session 78' 6-max (Play Money) Seat #6 is the button
Seat 1: Hattori (10000 in chips)
Seat 2: MrBlue (10000 in chips)
Seat 3: Pluribus (10000 in chips)
Seat 4: Budd (10000 in chips)
Seat 5: MrWhite (10000 in chips)
Seat 6: MrOrange (10000 in chips)
Hattori: posts small blind 50
MrBlue: posts big blind 100
*** HOLE CARDS ***
Dealt to Hattori [Ts Ks]
Dealt to MrBlue [Qh 4h]
Dealt to Pluribus [5c 6h]
Dealt to Budd [4d Js]
Dealt to MrWhite [Jh Qd]
Dealt to MrOrange [9c 8s]
Pluribus: folds
Budd: folds
MrWhite: raises 125 to 225
MrOrange: folds
Hattori: calls 175
MrBlue: calls 125
*** FLOP *** [6d Kd Qc]
Hattori: checks
MrBlue: checks
MrWhite: checks
*** TURN *** [6d Kd Qc] [Ah]
Hattori: checks
MrBlue: checks
MrWhite: checks
*** RIVER *** [6d Kd Qc] [Ah] [7s]
Hattori: checks
MrBlue: checks
MrWhite: checks
*** SHOWDOWN ***
Hattori: shows [Ts Ks]
Hattori collected 675.0 from pot
*** SUMMARY ***
Total pot 675 | Rake 0
Board [6d Kd Qc Ah 7s]
Seat 1: Hattori showed [Ts Ks] and won (675.0)
Seat 2: MrBlue showed [Qh 4h] and lost
Seat 5: MrWhite showed [Jh Qd] and lost


PokerStars Hand #78034: Hold'em No Limit (50/100) - 2019/07/11 21:40:34 ET
Table 'Pluribus Session 78' 6-max (Play Money) Seat #6 is the button
Seat 1: MrBlue (10000 in chips)
Seat 2: Pluribus (10000 in chips)
Seat 3: Budd (10000 in chips)
Seat 4: MrWhite (10000 in chips)
Seat 5: MrOrange (10000 in chips)
Seat 6: Hattori (10000 in chips)
MrBlue: posts small blind 50
Pluribus: posts big blind 100
*** HOLE CARDS ***
Dealt to MrBlue [3c 5d]
Dealt to Pluribus [Jd 4h]
Dealt to Budd [7c 2h]
Dealt to MrWhite [4d 7d]
Dealt to MrOrange [Td Jc]
Dealt to Hattori [As 3h]
Budd: folds
MrWhite: folds
MrOrange: folds
Hattori: folds
MrBlue: calls 50
Pluribus: checks
*** FLOP *** [3d 4c Kd]
MrBlue: checks
Pluribus: checks
*** TURN *** [3d 4c Kd] [Kh]
MrBlue: checks
Pluribus: bets 200
MrBlue: folds
Uncalled bet (200) returned to Pluribus
Pluribus collected 200.0 from pot
*** SUMMARY ***
Total pot 200 | Rake 0
Board [3d 4c Kd Kh]


PokerStars Hand #78035: Hold'em No Limit (50/100) - 2019/07/11 21:40:35 ET
Table 'Pluribus Session 78' 6-max (Play Money) Seat #6 is the button
Seat 1: Pluribus (10000 in chips)
Seat 2: Budd (10000 in chips)
Seat 3: MrWhite (10000 in chips)
Seat 4: MrOrange (10000 in chips)
Seat 5: Hattori (10000 in chips)
Seat 6: MrBlue (10000 in chips)
Pluribus: posts small blind 50
Budd: posts big blind 100
*** HOLE CARDS ***
Dealt to Pluribus [2h 6c]
Dealt to Budd [Ad 3s]
Dealt to MrWhite [Tc 5s]
Dealt to MrOrange [Td 3c]
Dealt to Hattori [Kd 8d]
Dealt to MrBlue [5d Ks]
MrWhite: folds
MrOrange: folds
Hattori: raises 111 to 211
MrBlue: folds
Pluribus: folds
Budd: calls 111
*** FLOP *** [Jc 7d 2s]
Budd: checks
Hattori: bets 475
Budd: folds
Uncalled bet (475) returned to Hattori
Hattori collected 472.0 from pot
*** SUMMARY ***
Total pot 472 | Rake 0
Board [Jc 7d 2s]


PokerStars Hand #78036: Hold'em No Limit (50/100) - 2019/07/11 21:40:36 ET
Table 'Pluribus Session 78' 6-max (Play Money) Seat #6 is the button
Seat 1: Budd (10000 in chips)
Seat 2: MrWhite (10000 in chips)
Seat 3: MrOrange (10000 in chips)
Seat 4: Hattori (10000 in chips)
Seat 5: MrBlue (10000 in chips)
Seat 6: Pluribus (10000 in chips)
Budd: posts small blind 50
MrWhite: posts big blind 100
*** HOLE CARDS ***
Dealt to Budd [Kd 5h]
Dealt to MrWhite [2s 3d]
Dealt to MrOrange [Qh 6d]
Dealt to Hattori [9c 8s]
Dealt to MrBlue [Ad 8c]
Dealt to Pluribus [Qs 5d]
MrOrange: folds
Hattori: folds
MrBlue: raises 125 to 225
Pluribus: folds
Budd: folds
MrWhite: folds
Uncalled bet (125) returned to MrBlue
MrBlue collected 250.0 from pot
*** SUMMARY ***
Total pot 250 | Rake 0


PokerStars Hand #78037: Hold'em No Limit (50/100) - 2019/07/11 21:40:37 ET
Table 'Pluribus Session 78' 6-max (Play Money) Seat #6 is the button
Seat 1: MrWhite (10000 in chips)
Seat 2: MrOrange (10000 in chips)
Seat 3: Hattori (10000 in chips)
Seat 4: MrBlue (10000 in chips)
Seat 5: Pluribus (10000 in chips)
Seat 6: Budd (10000 in chips)
MrWhite: posts small blind 50
MrOrange: posts big blind 100
*** HOLE CARDS ***
Dealt to MrWhite [9s 6h]
Dealt to MrOrange [2d Qd]
Dealt to Hattori [7d Qh]
Dealt to MrBlue [2h 4d]
Dealt to Pluribus [Kh Qs]
Dealt to Budd [7s Qc]
Hattori: folds
MrBlue: folds
Pluribus: raises 125 to 225
Budd: folds
MrWhite: folds
MrOrange: folds
Uncalled bet (125) returned to Pluribus
Pluribus collected 250.0 from pot
*** SUMMARY ***
Total pot 250 | Rake 0


PokerStars Hand #78038: Hold'em No Limit (50/100) - 2019/07/11 21:40:38 ET
Table 'Pluribus Session 78' 6-max (Play Money) Seat #6 is the button
Seat 1: MrOrange (10000 in chips)
Seat 2: Hattori (10000 in chips)
Seat 3: MrBlue (10000 in chips)
Seat 4: Pluribus (10000 in chips)
Seat 5: Budd (10000 in chips)
Seat 6: MrWhite (10000 in chips)
MrOrange: posts small blind 50
Hattori: posts big blind 100
*** HOLE CARDS ***
Dealt to MrOrange [Ah Kd]
Dealt to Hattori [4d 9d]
Dealt to MrBlue [Qc 3h]
Dealt to Pluribus [As Qd]
Dealt to Budd [9h 8s]
Dealt to MrWhite [2s 9s]
MrBlue: folds
Pluribus: raises 100 to 200
Budd: folds
MrWhite: folds
MrOrange: raises 900 to 1100
Hattori: folds
Pluribus: folds
Uncalled bet (900) returned to MrOrange
MrOrange collected 500.0 from pot
*** SUMMARY ***
Total pot 500 | Rake 0


PokerStars Hand #78039: Hold'em No Limit (50/100) - 2019/07/11 21:40:39 ET
Table 'Pluribus Session 78' 6-max (Play Money) Seat #6 is the button
Seat 1: Hattori (10000 in chips)
Seat 2: MrBlue (10000 in chips)
Seat 3: Pluribus (10000 in chips)
Seat 4: Budd (10000 in chips)
Seat 5: MrWhite (10000 in chips)
Seat 6: MrOrange (10000 in chips)
Hattori: posts small blind 50
MrBlue: posts big blind 100
*** HOLE CARDS ***
Dealt to Hattori [4c Jh]
Dealt to MrBlue [7d 6c]
Dealt to Pluribus [7c 8s]
Dealt to Budd [Jd 4d]
Dealt to MrWhite [2d 7s]
Dealt to MrOrange [As 5d]
Pluribus: folds
Budd: folds
MrWhite: folds
MrOrange: folds
Hattori: folds
Uncalled bet (50) returned to MrBlue
MrBlue collected 100.0 from pot
*** SUMMARY ***
Total pot 100 | Rake 0


PokerStars Hand #78040: Hold'em No Limit (50/100) - 2019/07/11 21:40:40 ET
Table 'Pluribus Session 78' 6-max (Play Money) Seat #6 is the button
Seat 1: MrBlue (10000 in chips)
Seat 2: Pluribus (10000 in chips)
Seat 3: Budd (10000 in chips)
Seat 4: MrWhite (10000 in chips)
Seat 5: MrOrange (10000 in chips)
Seat 6: Hattori (10000 in chips)
MrBlue: posts small blind 50
Pluribus: posts big blind 100
*** HOLE CARDS ***
Dealt to MrBlue [3s 3d]
Dealt to Pluribus [Ac Td]
Dealt to Budd [Tc Ad]
Dealt to MrWhite [9c Ah]
Dealt to MrOrange [5h 9s]
Dealt to Hattori [Kh 4s]
Budd: folds
MrWhite: folds
MrOrange: folds
Hattori: folds
MrBlue: calls 50
Pluribus: raises 175 to 275
MrBlue: calls 175
*** FLOP *** [5d 4d Th]
MrBlue: checks
Pluribus: bets 1100
MrBlue: folds
Uncalled bet (1100) returned to Pluribus
Pluribus collected 550.0 from pot
*** SUMMARY ***
Total pot 550 | Rake 0
Board [5d 4d Th]


PokerStars Hand #78041: Hold'em No Limit (50/100) - 2019/07/11 21:40:41 ET
Table 'Pluribus Session 78' 6-max (Play Money) Seat #6 is the button
Seat 1: Pluribus (10000 in chips)
Seat 2: Budd (10000 in chips)
Seat 3: MrWhite (10000 in chips)
Seat 4: MrOrange (10000 in chips)
Seat 5: Hattori (10000 in chips)
Seat 6: MrBlue (10000 in chips)
Pluribus: posts small blind 50
Budd: posts big blind 100
*** HOLE CARDS ***
Dealt to Pluribus [6h 2h]
Dealt to Budd [4d Jd]
Dealt to MrWhite [7s 4s]
Dealt to MrOrange [2s Ad]
Dealt to Hattori [Jc 4h]
Dealt to MrBlue [8h Qd]
MrWhite: folds
MrOrange: folds
Hattori: folds
MrBlue: raises 125 to 225
Pluribus: folds
Budd: calls 125
*** FLOP *** [Tc Ts Kc]
Budd: checks
MrBlue: checks
*** TURN *** [Tc Ts Kc] [Kh]
Budd: checks
MrBlue: checks
*** RIVER *** [Tc Ts Kc] [Kh] [3c]
Budd: checks
MrBlue: checks
*** SHOWDOWN ***
MrBlue: shows [8h Qd]
MrBlue collected 500.0 from pot
*** SUMMARY ***
Total pot 500 | Rake 0
Board [Tc Ts Kc Kh 3c]
Seat 2: Budd showed [4d Jd] and lost
Seat 6: MrBlue showed [8h Qd] and won (500.0)


PokerStars Hand #78042: Hold'em No Limit (50/100) - 2019/07/11 21:40:42 ET
Table 'Pluribus Session 78' 6-max (Play Money) Seat #6 is the button
Seat 1: Budd (10000 in chips)
Seat 2: MrWhite (10000 in chips)
Seat 3: MrOrange (10000 in chips)
Seat 4: Hattori (10000 in chips)
Seat 5: MrBlue (10000 in chips)
Seat 6: Pluribus (10000 in chips)
Budd: posts small blind 50
MrWhite: posts big blind 100
*** HOLE CARDS ***
Dealt to Budd [Qh 8c]
Dealt to MrWhite [9s Qs]
Dealt to MrOrange [7s Js]
Dealt to Hattori [Ad As]
Dealt to MrBlue [5c 7h]
Dealt to Pluribus [Ts Kd]
MrOrange: folds
Hattori: raises 100 to 200
MrBlue: folds
Pluribus: folds
Budd: folds
MrWhite: calls 100
*** FLOP *** [Ah Jd 2c]
MrWhite: checks
Hattori: bets 115
MrWhite: folds
Uncalled bet (115) returned to Hattori
Hattori collected 450.0 from pot
*** SUMMARY ***
Total pot 450 | Rake 0
Board [Ah Jd 2c]


PokerStars Hand #78043: Hold'em No Limit (50/100) - 2019/07/11 21:40:43 ET
Table 'Pluribus Session 78' 6-max (Play Money) Seat #6 is the button
Seat 1: MrWhite (10000 in chips)
Seat 2: MrOrange (10000 in chips)
Seat 3: Hattori (10000 in chips)
Seat 4: MrBlue (10000 in chips)
Seat 5: Pluribus (10000 in chips)
Seat 6: Budd (10000 in chips)
MrWhite: posts small blind 50
MrOrange: posts big blind 100
*** HOLE CARDS ***
Dealt to MrWhite [2c 2s]
Dealt to MrOrange [Jc Td]
Dealt to Hattori [Ks 3s]
Dealt to MrBlue [Jh 4c]
Dealt to Pluribus [Kd 5c]
Dealt to Budd [7s Ts]
Hattori: folds
MrBlue: folds
Pluribus: folds
Budd: raises 150 to 250
MrWhite: folds
MrOrange: calls 150
*** FLOP *** [4h 5d 5h]
MrOrange: checks
Budd: checks
*** TURN *** [4h 5d 5h] [7h]
MrOrange: checks
Budd: checks
*** RIVER *** [4h 5d 5h] [7h] [9c]
MrOrange: bets 455
Budd: calls 455
*** SHOWDOWN ***
Budd: shows [7s Ts]
Budd collected 1460.0 from pot
*** SUMMARY ***
Total pot 1460 | Rake 0
Board [4h 5d 5h 7h 9c]
Seat 2: MrOrange showed [Jc Td] and lost
Seat 6: Budd showed [7s Ts] and won (1460.0)


PokerStars Hand #78044: Hold'em No Limit (50/100) - 2019/07/11 21:40:44 ET
Table 'Pluribus Session 78' 6-max (Play Money) Seat #6 is the button
Seat 1: MrOrange (10000 in chips)
Seat 2: Hattori (10000 in chips)
Seat 3: MrBlue (10000 in chips)
Seat 4: Pluribus (10000 in chips)
Seat 5: Budd (10000 in chips)
Seat 6: MrWhite (10000 in chips)
MrOrange: posts small blind 50
Hattori: posts big blind 100
*** HOLE CARDS ***
Dealt to MrOrange [Qs 2h]
Dealt to Hattori [9s 8h]
Dealt to MrBlue [2s 2c]
Dealt to Pluribus [Jh 4d]
Dealt to Budd [As Qh]
Dealt to MrWhite [Jc Kd]
MrBlue: raises 125 to 225
Pluribus: folds
Budd: calls 225
MrWhite: folds
MrOrange: folds
Hattori: folds
*** FLOP *** [6s Kh Ah]
MrBlue: bets 250
Budd: calls 250
*** TURN *** [6s Kh Ah] [Js]
MrBlue: checks
Budd: bets 825
MrBlue: folds
Uncalled bet (825) returned to Budd
Budd collected 1100.0 from pot
*** SUMMARY ***
Total pot 1100 | Rake 0
Board [6s Kh Ah Js]


PokerStars Hand #78045: Hold'em No Limit (50/100) - 2019/07/11 21:40:45 ET
Table 'Pluribus Session 78' 6-max (Play Money) Seat #6 is the button
Seat 1: Hattori (10000 in chips)
Seat 2: MrBlue (10000 in chips)
Seat 3: Pluribus (10000 in chips)
Seat 4: Budd (10000 in chips)
Seat 5: MrWhite (10000 in chips)
Seat 6: MrOrange (10000 in chips)
Hattori: posts small blind 50
MrBlue: posts big blind 100
*** HOLE CARDS ***
Dealt to Hattori [2s Qh]
Dealt to MrBlue [Kh 5d]
Dealt to Pluribus [4h 6c]
Dealt to Budd [3d 7h]
Dealt to MrWhite [5c 4c]
Dealt to MrOrange [8d 4s]
Pluribus: folds
Budd: folds
MrWhite: raises 125 to 225
MrOrange: folds
Hattori: folds
MrBlue: folds
Uncalled bet (125) returned to MrWhite
MrWhite collected 250.0 from pot
*** SUMMARY ***
Total pot 250 | Rake 0


PokerStars Hand #78046: Hold'em No Limit (50/100) - 2019/07/11 21:40:46 ET
Table 'Pluribus Session 78' 6-max (Play Money) Seat #6 is the button
Seat 1: MrBlue (10000 in chips)
Seat 2: Pluribus (10000 in chips)
Seat 3: Budd (10000 in chips)
Seat 4: MrWhite (10000 in chips)
Seat 5: MrOrange (10000 in chips)
Seat 6: Hattori (10000 in chips)
MrBlue: posts small blind 50
Pluribus: posts big blind 100
*** HOLE CARDS ***
Dealt to MrBlue [8s 2s]
Dealt to Pluribus [Jh As]
Dealt to Budd [4h Qs]
Dealt to MrWhite [Td Kd]
Dealt to MrOrange [8c 7h]
Dealt to Hattori [Ac 5c]
Budd: folds
MrWhite: raises 125 to 225
MrOrange: folds
Hattori: calls 225
MrBlue: folds
Pluribus: calls 125
*** FLOP *** [Ks 5s 4d]
Pluribus: bets 362
MrWhite: calls 362
Hattori: folds
*** TURN *** [Ks 5s 4d] [2d]
Pluribus: checks
MrWhite: checks
*** RIVER *** [Ks 5s 4d] [2d] [7c]
Pluribus: checks
MrWhite: checks
*** SHOWDOWN ***
MrWhite: shows [Td Kd]
MrWhite collected 1449.0 from pot
*** SUMMARY ***
Total pot 1449 | Rake 0
Board [Ks 5s 4d 2d 7c]
Seat 2: Pluribus showed [Jh As] and lost
Seat 4: MrWhite showed [Td Kd] and won (1449.0)


PokerStars Hand #78047: Hold'em No Limit (50/100) - 2019/07/11 21:40:47 ET
Table 'Pluribus Session 78' 6-max (Play Money) Seat #6 is the button
Seat 1: Pluribus (10000 in chips)
Seat 2: Budd (10000 in chips)
Seat 3: MrWhite (10000 in chips)
Seat 4: MrOrange (10000 in chips)
Seat 5: Hattori (10000 in chips)
Seat 6: MrBlue (10000 in chips)
Pluribus: posts small blind 50
Budd: posts big blind 100
*** HOLE CARDS ***
Dealt to Pluribus [3d 9h]
Dealt to Budd [Ac 8s]
Dealt to MrWhite [7d Ah]
Dealt to MrOrange [5d 6h]
Dealt to Hattori [Jh 8h]
Dealt to MrBlue [8d 7s]
MrWhite: folds
MrOrange: folds
Hattori: raises 111 to 211
MrBlue: folds
Pluribus: folds
Budd: calls 111
*** FLOP *** [9c 2c 7h]
Budd: checks
Hattori: bets 550
Budd: folds
Uncalled bet (550) returned to Hattori
Hattori collected 472.0 from pot
*** SUMMARY ***
Total pot 472 | Rake 0
Board [9c 2c 7h]


PokerStars Hand #78048: Hold'em No Limit (50/100) - 2019/07/11 21:40:48 ET
Table 'Pluribus Session 78' 6-max (Play Money) Seat #6 is the button
Seat 1: Budd (10000 in chips)
Seat 2: MrWhite (10000 in chips)
Seat 3: MrOrange (10000 in chips)
Seat 4: Hattori (10000 in chips)
Seat 5: MrBlue (10000 in chips)
Seat 6: Pluribus (10000 in chips)
Budd: posts small blind 50
MrWhite: posts big blind 100
*** HOLE CARDS ***
Dealt to Budd [7d 8c]
Dealt to MrWhite [3c 7c]
Dealt to MrOrange [5s Tc]
Dealt to Hattori [6s 2h]
Dealt to MrBlue [Kc 6c]
Dealt to Pluribus [6d Kd]
MrOrange: folds
Hattori: folds
MrBlue: raises 125 to 225
Pluribus: calls 225
Budd: folds
MrWhite: raises 725 to 950
MrBlue: folds
Pluribus: folds
Uncalled bet (725) returned to MrWhite
MrWhite collected 725.0 from pot
*** SUMMARY ***
Total pot 725 | Rake 0


PokerStars Hand #78049: Hold'em No Limit (50/100) - 2019/07/11 21:40:49 ET
Table 'Pluribus Session 78' 6-max (Play Money) Seat #6 is the button
Seat 1: MrWhite (10000 in chips)
Seat 2: MrOrange (10000 in chips)
Seat 3: Hattori (10000 in chips)
Seat 4: MrBlue (10000 in chips)
Seat 5: Pluribus (10000 in chips)
Seat 6: Budd (10000 in chips)
MrWhite: posts small blind 50
MrOrange: posts big blind 100
*** HOLE CARDS ***
Dealt to MrWhite [2c 3d]
Dealt to MrOrange [7d 5h]
Dealt to Hattori [Th Ts]
Dealt to MrBlue [Ks 3s]
Dealt to Pluribus [Ad 9d]
Dealt to Budd [6c 9c]
Hattori: raises 100 to 200
MrBlue: folds
Pluribus: calls 200
Budd: folds
MrWhite: folds
MrOrange: folds
*** FLOP *** [Tc Qh 7h]
Hattori: checks
Pluribus: checks
*** TURN *** [Tc Qh 7h] [9s]
Hattori: checks
Pluribus: checks
*** RIVER *** [Tc Qh 7h] [9s] [As]
Hattori: checks
Pluribus: bets 275
Hattori: raises 1375 to 1650
Pluribus: folds
Uncalled bet (1375) returned to Hattori
Hattori collected 1100.0 from pot
*** SUMMARY ***
Total pot 1100 | Rake 0
Board [Tc Qh 7h 9s As]


PokerStars Hand #78050: Hold'em No Limit (50/100) - 2019/07/11 21:40:50 ET
Table 'Pluribus Session 78' 6-max (Play Money) Seat #6 is the button
Seat 1: MrOrange (10000 in chips)
Seat 2: Hattori (10000 in chips)
Seat 3: MrBlue (10000 in chips)
Seat 4: Pluribus (10000 in chips)
Seat 5: Budd (10000 in chips)
Seat 6: MrWhite (10000 in chips)
MrOrange: posts small blind 50
Hattori: posts big blind 100
*** HOLE CARDS ***
Dealt to MrOrange [Th 4s]
Dealt to Hattori [Ts Jc]
Dealt to MrBlue [Kc 5d]
Dealt to Pluribus [3c 8c]
Dealt to Budd [3d 5c]
Dealt to MrWhite [3h 8d]
MrBlue: folds
Pluribus: folds
Budd: folds
MrWhite: folds
MrOrange: folds
Uncalled bet (50) returned to Hattori
Hattori collected 100.0 from pot
*** SUMMARY ***
Total pot 100 | Rake 0


PokerStars Hand #78051: Hold'em No Limit (50/100) - 2019/07/11 21:40:51 ET
Table 'Pluribus Session 78' 6-max (Play Money) Seat #6 is the button
Seat 1: Hattori (10000 in chips)
Seat 2: MrBlue (10000 in chips)
Seat 3: Pluribus (10000 in chips)
Seat 4: Budd (10000 in chips)
Seat 5: MrWhite (10000 in chips)
Seat 6: MrOrange (10000 in chips)
Hattori: posts small blind 50
MrBlue: posts big blind 100
*** HOLE CARDS ***
Dealt to Hattori [5c Qc]
Dealt to MrBlue [Td Ad]
Dealt to Pluribus [6d 3h]
Dealt to Budd [2c 7h]
Dealt to MrWhite [4d 4c]
Dealt to MrOrange [5s 3d]
Pluribus: folds
Budd: folds
MrWhite: raises 125 to 225
MrOrange: folds
Hattori: folds
MrBlue: calls 125
*** FLOP *** [8s 9c 6c]
MrBlue: checks
MrWhite: checks
*** TURN *** [8s 9c 6c] [Qd]
MrBlue: checks
MrWhite: checks
*** RIVER *** [8s 9c 6c] [Qd] [5d]
MrBlue: checks
MrWhite: checks
*** SHOWDOWN ***
MrWhite: shows [4d 4c]
MrWhite collected 500.0 from pot
*** SUMMARY ***
Total pot 500 | Rake 0
Board [8s 9c 6c Qd 5d]
Seat 2: MrBlue showed [Td Ad] and lost
Seat 5: MrWhite showed [4d 4c] and won (500.0)


PokerStars Hand #78052: Hold'em No Limit (50/100) - 2019/07/11 21:40:52 ET
Table 'Pluribus Session 78' 6-max (Play Money) Seat #6 is the button
Seat 1: MrBlue (10000 in chips)
Seat 2: Pluribus (10000 in chips)
Seat 3: Budd (10000 in chips)
Seat 4: MrWhite (10000 in chips)
Seat 5: MrOrange (10000 in chips)
Seat 6: Hattori (10000 in chips)
MrBlue: posts small blind 50
Pluribus: posts big blind 100
*** HOLE CARDS ***
Dealt to MrBlue [9c 3d]
Dealt to Pluribus [7s Kc]
Dealt to Budd [Qc Qh]
Dealt to MrWhite [Ah 7c]
Dealt to MrOrange [Ks 4h]
Dealt to Hattori [8h 2d]
Budd: raises 125 to 225
MrWhite: folds
MrOrange: folds
Hattori: folds
MrBlue: folds
Pluribus: folds
Uncalled bet (125) returned to Budd
Budd collected 250.0 from pot
*** SUMMARY ***
Total pot 250 | Rake 0


PokerStars Hand #78053: Hold'em No Limit (50/100) - 2019/07/11 21:40:53 ET
Table 'Pluribus Session 78' 6-max (Play Money) Seat #6 is the button
Seat 1: Pluribus (10000 in chips)
Seat 2: Budd (10000 in chips)
Seat 3: MrWhite (10000 in chips)
Seat 4: MrOrange (10000 in chips)
Seat 5: Hattori (10000 in chips)
Seat 6: MrBlue (10000 in chips)
Pluribus: posts small blind 50
Budd: posts big blind 100
*** HOLE CARDS ***
Dealt to Pluribus [5s 4d]
Dealt to Budd [Ad 6h]
Dealt to MrWhite [Jh 5c]
Dealt to MrOrange [Qs 9h]
Dealt to Hattori [3d Qh]
Dealt to MrBlue [Jd 5d]
MrWhite: folds
MrOrange: folds
Hattori: folds
MrBlue: raises 125 to 225
Pluribus: folds
Budd: calls 125
*** FLOP *** [7s Ah 8h]
Budd: checks
MrBlue: checks
*** TURN *** [7s Ah 8h] [6d]
Budd: bets 250
MrBlue: folds
Uncalled bet (250) returned to Budd
Budd collected 500.0 from pot
*** SUMMARY ***
Total pot 500 | Rake 0
Board [7s Ah 8h 6d]


PokerStars Hand #78054: Hold'em No Limit (50/100) - 2019/07/11 21:40:54 ET
Table 'Pluribus Session 78' 6-max (Play Money) Seat #6 is the button
Seat 1: Budd (10000 in chips)
Seat 2: MrWhite (10000 in chips)
Seat 3: MrOrange (10000 in chips)
Seat 4: Hattori (10000 in chips)
Seat 5: MrBlue (10000 in chips)
Seat 6: Pluribus (10000 in chips)
Budd: posts small blind 50
MrWhite: posts big blind 100
*** HOLE CARDS ***
Dealt to Budd [Qc 8d]
Dealt to MrWhite [Jd Th]
Dealt to MrOrange [4h 5d]
Dealt to Hattori [6h 9s]
Dealt to MrBlue [7d Qs]
Dealt to Pluribus [5s Ts]
MrOrange: folds
Hattori: folds
MrBlue: folds
Pluribus: raises 125 to 225
Budd: folds
MrWhite: calls 125
*** FLOP *** [3c 3s 5c]
MrWhite: checks
Pluribus: bets 250
MrWhite: folds
Uncalled bet (250) returned to Pluribus
Pluribus collected 500.0 from pot
*** SUMMARY ***
Total pot 500 | Rake 0
Board [3c 3s 5c]


PokerStars Hand #78055: Hold'em No Limit (50/100) - 2019/07/11 21:40:55 ET
Table 'Pluribus Session 78' 6-max (Play Money) Seat #6 is the button
Seat 1: MrWhite (10000 in chips)
Seat 2: MrOrange (10000 in chips)
Seat 3: Hattori (10000 in chips)
Seat 4: MrBlue (10000 in chips)
Seat 5: Pluribus (10000 in chips)
Seat 6: Budd (10000 in chips)
MrWhite: posts small blind 50
MrOrange: posts big blind 100
*** HOLE CARDS ***
Dealt to MrWhite [8h 2s]
Dealt to MrOrange [8s 7h]
Dealt to Hattori [Ah Jh]
Dealt to MrBlue [7d Tc]
Dealt to Pluribus [7s 3h]
Dealt to Budd [Ac 4s]
Hattori: raises 100 to 200
MrBlue: folds
Pluribus: folds
Budd: folds
MrWhite: folds
MrOrange: folds
Uncalled bet (100) returned to Hattori
Hattori collected 250.0 from pot
*** SUMMARY ***
Total pot 250 | Rake 0


PokerStars Hand #78056: Hold'em No Limit (50/100) - 2019/07/11 21:40:56 ET
Table 'Pluribus Session 78' 6-max (Play Money) Seat #6 is the button
Seat 1: MrOrange (10000 in chips)
Seat 2: Hattori (10000 in chips)
Seat 3: MrBlue (10000 in chips)
Seat 4: Pluribus (10000 in chips)
Seat 5: Budd (10000 in chips)
Seat 6: MrWhite (10000 in chips)
MrOrange: posts small blind 50
Hattori: posts big blind 100
*** HOLE CARDS ***
Dealt to MrOrange [Jc 5c]
Dealt to Hattori [Js 4h]
Dealt to MrBlue [2h 8h]
Dealt to Pluribus [Qc Jd]
Dealt to Budd [8s Ac]
Dealt to MrWhite [Qd 8d]
MrBlue: folds
Pluribus: raises 150 to 250
Budd: folds
MrWhite: folds
MrOrange: folds
Hattori: folds
Uncalled bet (150) returned to Pluribus
Pluribus collected 250.0 from pot
*** SUMMARY ***
Total pot 250 | Rake 0


PokerStars Hand #78057: Hold'em No Limit (50/100) - 2019/07/11 21:40:57 ET
Table 'Pluribus Session 78' 6-max (Play Money) Seat #6 is the button
Seat 1: Hattori (10000 in chips)
Seat 2: MrBlue (10000 in chips)
Seat 3: Pluribus (10000 in chips)
Seat 4: Budd (10000 in chips)
Seat 5: MrWhite (10000 in chips)
Seat 6: MrOrange (10000 in chips)
Hattori: posts small blind 50
MrBlue: posts big blind 100
*** HOLE CARDS ***
Dealt to Hattori [Jh 7d]
Dealt to MrBlue [Ks Kc]
Dealt to Pluribus [8h Kd]
Dealt to Budd [5h 6d]
Dealt to MrWhite [9s 2h]
Dealt to MrOrange [Ah As]
Pluribus: folds
Budd: folds
MrWhite: folds
MrOrange: raises 124 to 224
Hattori: folds
MrBlue: raises 845 to 1069
MrOrange: raises 1231 to 2300
MrBlue: raises 7700 to 10000 and is all-in
MrOrange: calls 7700 and is all-in
*** FLOP *** [7h Ts 8c]
*** TURN *** [7h Ts 8c] [6s]
*** RIVER *** [7h Ts 8c] [6s] [Qh]
*** SHOWDOWN ***
MrOrange: shows [Ah As]
MrOrange collected 20050.0 from pot
*** SUMMARY ***
Total pot 20050 | Rake 0
Board [7h Ts 8c 6s Qh]
Seat 2: MrBlue showed [Ks Kc] and lost
Seat 6: MrOrange showed [Ah As] and won (20050.0)


PokerStars Hand #78058: Hold'em No Limit (50/100) - 2019/07/11 21:40:58 ET
Table 'Pluribus Session 78' 6-max (Play Money) Seat #6 is the button
Seat 1: MrBlue (10000 in chips)
Seat 2: Pluribus (10000 in chips)
Seat 3: Budd (10000 in chips)
Seat 4: MrWhite (10000 in chips)
Seat 5: MrOrange (10000 in chips)
Seat 6: Hattori (10000 in chips)
MrBlue: posts small blind 50
Pluribus: posts big blind 100
*** HOLE CARDS ***
Dealt to MrBlue [2h Ts]
Dealt to Pluribus [7h 3s]
Dealt to Budd [Ks 9s]
Dealt to MrWhite [5c 2s]
Dealt to MrOrange [Jh As]
Dealt to Hattori [Qc 7c]
Budd: raises 125 to 225
MrWhite: folds
MrOrange: folds
Hattori: folds
MrBlue: folds
Pluribus: folds
Uncalled bet (125) returned to Budd
Budd collected 250.0 from pot
*** SUMMARY ***
Total pot 250 | Rake 0


PokerStars Hand #78059: Hold'em No Limit (50/100) - 2019/07/11 21:40:59 ET
Table 'Pluribus Session 78' 6-max (Play Money) Seat #6 is the button
Seat 1: Pluribus (10000 in chips)
Seat 2: Budd (10000 in chips)
Seat 3: MrWhite (10000 in chips)
Seat 4: MrOrange (10000 in chips)
Seat 5: Hattori (10000 in chips)
Seat 6: MrBlue (10000 in chips)
Pluribus: posts small blind 50
Budd: posts big blind 100
*** HOLE CARDS ***
Dealt to Pluribus [2h Js]
Dealt to Budd [Ah Jd]
Dealt to MrWhite [5h Tc]
Dealt to MrOrange [Jc 9s]
Dealt to Hattori [6d 2c]
Dealt to MrBlue [8c Qs]
MrWhite: folds
MrOrange: folds
Hattori: folds
MrBlue: folds
Pluribus: folds
Uncalled bet (50) returned to Budd
Budd collected 100.0 from pot
*** SUMMARY ***
Total pot 100 | Rake 0


PokerStars Hand #78060: Hold'em No Limit (50/100) - 2019/07/11 21:41:00 ET
Table 'Pluribus Session 78' 6-max (Play Money) Seat #6 is the button
Seat 1: Budd (10000 in chips)
Seat 2: MrWhite (10000 in chips)
Seat 3: MrOrange (10000 in chips)
Seat 4: Hattori (10000 in chips)
Seat 5: MrBlue (10000 in chips)
Seat 6: Pluribus (10000 in chips)
Budd: posts small blind 50
MrWhite: posts big blind 100
*** HOLE CARDS ***
Dealt to Budd [Jd 8s]
Dealt to MrWhite [Ts 2s]
Dealt to MrOrange [Kh 7c]
Dealt to Hattori [5c Kd]
Dealt to MrBlue [Kc 3h]
Dealt to Pluribus [Jh Tc]
MrOrange: folds
Hattori: folds
MrBlue: folds
Pluribus: raises 125 to 225
Budd: folds
MrWhite: calls 125
*** FLOP *** [9c 7s 5s]
MrWhite: checks
Pluribus: checks
*** TURN *** [9c 7s 5s] [4s]
MrWhite: bets 375
Pluribus: folds
Uncalled bet (375) returned to MrWhite
MrWhite collected 500.0 from pot
*** SUMMARY ***
Total pot 500 | Rake 0
Board [9c 7s 5s 4s]


PokerStars Hand #78061: Hold'em No Limit (50/100) - 2019/07/11 21:41:01 ET
Table 'Pluribus Session 78' 6-max (Play Money) Seat #6 is the button
Seat 1: MrWhite (10000 in chips)
Seat 2: MrOrange (10000 in chips)
Seat 3: Hattori (10000 in chips)
Seat 4: MrBlue (10000 in chips)
Seat 5: Pluribus (10000 in chips)
Seat 6: Budd (10000 in chips)
MrWhite: posts small blind 50
MrOrange: posts big blind 100
*** HOLE CARDS ***
Dealt to MrWhite [Ks 2h]
Dealt to MrOrange [3d 4s]
Dealt to Hattori [Jd 4d]
Dealt to MrBlue [Jh 7h]
Dealt to Pluribus [5d 5s]
Dealt to Budd [6h 6s]
Hattori: folds
MrBlue: raises 125 to 225
Pluribus: raises 450 to 675
Budd: folds
MrWhite: folds
MrOrange: folds
MrBlue: folds
Uncalled bet (450) returned to Pluribus
Pluribus collected 600.0 from pot
*** SUMMARY ***
Total pot 600 | Rake 0


PokerStars Hand #78062: Hold'em No Limit (50/100) - 2019/07/11 21:41:02 ET
Table 'Pluribus Session 78' 6-max (Play Money) Seat #6 is the button
Seat 1: MrOrange (10000 in chips)
Seat 2: Hattori (10000 in chips)
Seat 3: MrBlue (10000 in chips)
Seat 4: Pluribus (10000 in chips)
Seat 5: Budd (10000 in chips)
Seat 6: MrWhite (10000 in chips)
MrOrange: posts small blind 50
Hattori: posts big blind 100
*** HOLE CARDS ***
Dealt to MrOrange [Ts 4h]
Dealt to Hattori [9s 8s]
Dealt to MrBlue [4d 7h]
Dealt to Pluribus [As 3h]
Dealt to Budd [5h Tc]
Dealt to MrWhite [Jh Qh]
MrBlue: folds
Pluribus: folds
Budd: folds
MrWhite: raises 125 to 225
MrOrange: folds
Hattori: raises 1105 to 1330
MrWhite: calls 1105
*** FLOP *** [Ah 9c 8c]
Hattori: bets 1800
MrWhite: folds
Uncalled bet (1800) returned to Hattori
Hattori collected 2710.0 from pot
*** SUMMARY ***
Total pot 2710 | Rake 0
Board [Ah 9c 8c]


PokerStars Hand #78063: Hold'em No Limit (50/100) - 2019/07/11 21:41:03 ET
Table 'Pluribus Session 78' 6-max (Play Money) Seat #6 is the button
Seat 1: Hattori (10000 in chips)
Seat 2: MrBlue (10000 in chips)
Seat 3: Pluribus (10000 in chips)
Seat 4: Budd (10000 in chips)
Seat 5: MrWhite (10000 in chips)
Seat 6: MrOrange (10000 in chips)
Hattori: posts small blind 50
MrBlue: posts big blind 100
*** HOLE CARDS ***
Dealt to Hattori [9h 3c]
Dealt to MrBlue [Ts 5d]
Dealt to Pluribus [4d Kd]
Dealt to Budd [7s Ks]
Dealt to MrWhite [6c 8d]
Dealt to MrOrange [Ah Jc]
Pluribus: folds
Budd: raises 125 to 225
MrWhite: folds
MrOrange: raises 475 to 700
Hattori: folds
MrBlue: folds
Budd: folds
Uncalled bet (475) returned to MrOrange
MrOrange collected 600.0 from pot
*** SUMMARY ***
Total pot 600 | Rake 0


PokerStars Hand #78064: Hold'em No Limit (50/100) - 2019/07/11 21:41:04 ET
Table 'Pluribus Session 78' 6-max (Play Money) Seat #6 is the button
Seat 1: MrBlue (10000 in chips)
Seat 2: Pluribus (10000 in chips)
Seat 3: Budd (10000 in chips)
Seat 4: MrWhite (10000 in chips)
Seat 5: MrOrange (10000 in chips)
Seat 6: Hattori (10000 in chips)
MrBlue: posts small blind 50
Pluribus: posts big blind 100
*** HOLE CARDS ***
Dealt to MrBlue [Kh 5h]
Dealt to Pluribus [Th Jd]
Dealt to Budd [3s Js]
Dealt to MrWhite [9d 8s]
Dealt to MrOrange [Ts As]
Dealt to Hattori [Jh Kd]
Budd: folds
MrWhite: folds
MrOrange: raises 115 to 215
Hattori: raises 535 to 750
MrBlue: folds
Pluribus: folds
MrOrange: calls 535
*** FLOP *** [2s Ks 5s]
MrOrange: checks
Hattori: checks
*** TURN *** [2s Ks 5s] [8h]
MrOrange: bets 2250
Hattori: folds
Uncalled bet (2250) returned to MrOrange
MrOrange collected 1650.0 from pot
*** SUMMARY ***
Total pot 1650 | Rake 0
Board [2s Ks 5s 8h]


PokerStars Hand #78065: Hold'em No Limit (50/100) - 2019/07/11 21:41:05 ET
Table 'Pluribus Session 78' 6-max (Play Money) Seat #6 is the button
Seat 1: Pluribus (10000 in chips)
Seat 2: Budd (10000 in chips)
Seat 3: MrWhite (10000 in chips)
Seat 4: MrOrange (10000 in chips)
Seat 5: Hattori (10000 in chips)
Seat 6: MrBlue (10000 in chips)
Pluribus: posts small blind 50
Budd: posts big blind 100
*** HOLE CARDS ***
Dealt to Pluribus [6c Qs]
Dealt to Budd [Tc 3h]
Dealt to MrWhite [Jc 2h]
Dealt to MrOrange [2s 4d]
Dealt to Hattori [6s Ks]
Dealt to MrBlue [7h 4c]
MrWhite: folds
MrOrange: folds
Hattori: raises 111 to 211
MrBlue: folds
Pluribus: folds
Budd: folds
Uncalled bet (111) returned to Hattori
Hattori collected 250.0 from pot
*** SUMMARY ***
Total pot 250 | Rake 0


PokerStars Hand #78066: Hold'em No Limit (50/100) - 2019/07/11 21:41:06 ET
Table 'Pluribus Session 78' 6-max (Play Money) Seat #6 is the button
Seat 1: Budd (10000 in chips)
Seat 2: MrWhite (10000 in chips)
Seat 3: MrOrange (10000 in chips)
Seat 4: Hattori (10000 in chips)
Seat 5: MrBlue (10000 in chips)
Seat 6: Pluribus (10000 in chips)
Budd: posts small blind 50
MrWhite: posts big blind 100
*** HOLE CARDS ***
Dealt to Budd [9h 5c]
Dealt to MrWhite [Qh Jh]
Dealt to MrOrange [4d Th]
Dealt to Hattori [Kd 3s]
Dealt to MrBlue [9s 4c]
Dealt to Pluribus [9c 8d]
MrOrange: folds
Hattori: folds
MrBlue: folds
Pluribus: raises 125 to 225
Budd: folds
MrWhite: calls 125
*** FLOP *** [6s Js Jd]
MrWhite: checks
Pluribus: bets 250
MrWhite: calls 250
*** TURN *** [6s Js Jd] [Kh]
MrWhite: checks
Pluribus: bets 1000
MrWhite: calls 1000
*** RIVER *** [6s Js Jd] [Kh] [Ah]
MrWhite: checks
Pluribus: checks
*** SHOWDOWN ***
MrWhite: shows [Qh Jh]
MrWhite collected 3000.0 from pot
*** SUMMARY ***
Total pot 3000 | Rake 0
Board [6s Js Jd Kh Ah]
Seat 2: MrWhite showed [Qh Jh] and won (3000.0)
Seat 6: Pluribus showed [9c 8d] and lost


PokerStars Hand #78067: Hold'em No Limit (50/100) - 2019/07/11 21:41:07 ET
Table 'Pluribus Session 78' 6-max (Play Money) Seat #6 is the button
Seat 1: MrWhite (10000 in chips)
Seat 2: MrOrange (10000 in chips)
Seat 3: Hattori (10000 in chips)
Seat 4: MrBlue (10000 in chips)
Seat 5: Pluribus (10000 in chips)
Seat 6: Budd (10000 in chips)
MrWhite: posts small blind 50
MrOrange: posts big blind 100
*** HOLE CARDS ***
Dealt to MrWhite [9s Ac]
Dealt to MrOrange [3c Ts]
Dealt to Hattori [5s 2h]
Dealt to MrBlue [Ad 8s]
Dealt to Pluribus [Jh 7h]
Dealt to Budd [Js 5h]
Hattori: folds
MrBlue: folds
Pluribus: raises 125 to 225
Budd: folds
MrWhite: folds
MrOrange: folds
Uncalled bet (125) returned to Pluribus
Pluribus collected 250.0 from pot
*** SUMMARY ***
Total pot 250 | Rake 0


PokerStars Hand #78068: Hold'em No Limit (50/100) - 2019/07/11 21:41:08 ET
Table 'Pluribus Session 78' 6-max (Play Money) Seat #6 is the button
Seat 1: MrOrange (10000 in chips)
Seat 2: Hattori (10000 in chips)
Seat 3: MrBlue (10000 in chips)
Seat 4: Pluribus (10000 in chips)
Seat 5: Budd (10000 in chips)
Seat 6: MrWhite (10000 in chips)
MrOrange: posts small blind 50
Hattori: posts big blind 100
*** HOLE CARDS ***
Dealt to MrOrange [7d 9d]
Dealt to Hattori [5s Qh]
Dealt to MrBlue [5d 5h]
Dealt to Pluribus [9h Ad]
Dealt to Budd [8d 6h]
Dealt to MrWhite [Qd 8h]
MrBlue: raises 125 to 225
Pluribus: folds
Budd: folds
MrWhite: folds
MrOrange: folds
Hattori: folds
Uncalled bet (125) returned to MrBlue
MrBlue collected 250.0 from pot
*** SUMMARY ***
Total pot 250 | Rake 0


PokerStars Hand #78069: Hold'em No Limit (50/100) - 2019/07/11 21:41:09 ET
Table 'Pluribus Session 78' 6-max (Play Money) Seat #6 is the button
Seat 1: Hattori (10000 in chips)
Seat 2: MrBlue (10000 in chips)
Seat 3: Pluribus (10000 in chips)
Seat 4: Budd (10000 in chips)
Seat 5: MrWhite (10000 in chips)
Seat 6: MrOrange (10000 in chips)
Hattori: posts small blind 50
MrBlue: posts big blind 100
*** HOLE CARDS ***
Dealt to Hattori [Ad 7h]
Dealt to MrBlue [Qh As]
Dealt to Pluribus [7c Jd]
Dealt to Budd [9h Ac]
Dealt to MrWhite [3c 4h]
Dealt to MrOrange [2c Qc]
Pluribus: folds
Budd: folds
MrWhite: folds
MrOrange: folds
Hattori: raises 135 to 235
MrBlue: raises 534 to 769
Hattori: folds
Uncalled bet (534) returned to MrBlue
MrBlue collected 470.0 from pot
*** SUMMARY ***
Total pot 470 | Rake 0


PokerStars Hand #78070: Hold'em No Limit (50/100) - 2019/07/11 21:41:10 ET
Table 'Pluribus Session 78' 6-max (Play Money) Seat #6 is the button
Seat 1: MrBlue (10000 in chips)
Seat 2: Pluribus (10000 in chips)
Seat 3: Budd (10000 in chips)
Seat 4: MrWhite (10000 in chips)
Seat 5: MrOrange (10000 in chips)
Seat 6: Hattori (10000 in chips)
MrBlue: posts small blind 50
Pluribus: posts big blind 100
*** HOLE CARDS ***
Dealt to MrBlue [9c Ad]
Dealt to Pluribus [Ks 3d]
Dealt to Budd [Qc Ac]
Dealt to MrWhite [6c Jc]
Dealt to MrOrange [6s Tc]
Dealt to Hattori [3c Jd]
Budd: raises 125 to 225
MrWhite: folds
MrOrange: folds
Hattori: folds
MrBlue: folds
Pluribus: folds
Uncalled bet (125) returned to Budd
Budd collected 250.0 from pot
*** SUMMARY ***
Total pot 250 | Rake 0


PokerStars Hand #78071: Hold'em No Limit (50/100) - 2019/07/11 21:41:11 ET
Table 'Pluribus Session 78' 6-max (Play Money) Seat #6 is the button
Seat 1: Pluribus (10000 in chips)
Seat 2: Budd (10000 in chips)
Seat 3: MrWhite (10000 in chips)
Seat 4: MrOrange (10000 in chips)
Seat 5: Hattori (10000 in chips)
Seat 6: MrBlue (10000 in chips)
Pluribus: posts small blind 50
Budd: posts big blind 100
*** HOLE CARDS ***
Dealt to Pluribus [6d 4c]
Dealt to Budd [Ks Jd]
Dealt to MrWhite [8d 6c]
Dealt to MrOrange [9c Tc]
Dealt to Hattori [2h 8c]
Dealt to MrBlue [4h 3c]
MrWhite: folds
MrOrange: raises 115 to 215
Hattori: folds
MrBlue: folds
Pluribus: folds
Budd: calls 115
*** FLOP *** [2c 2d Ts]
Budd: checks
MrOrange: checks
*** TURN *** [2c 2d Ts] [5h]
Budd: checks
MrOrange: bets 150
Budd: folds
Uncalled bet (150) returned to MrOrange
MrOrange collected 480.0 from pot
*** SUMMARY ***
Total pot 480 | Rake 0
Board [2c 2d Ts 5h]


PokerStars Hand #78072: Hold'em No Limit (50/100) - 2019/07/11 21:41:12 ET
Table 'Pluribus Session 78' 6-max (Play Money) Seat #6 is the button
Seat 1: Budd (10000 in chips)
Seat 2: MrWhite (10000 in chips)
Seat 3: MrOrange (10000 in chips)
Seat 4: Hattori (10000 in chips)
Seat 5: MrBlue (10000 in chips)
Seat 6: Pluribus (10000 in chips)
Budd: posts small blind 50
MrWhite: posts big blind 100
*** HOLE CARDS ***
Dealt to Budd [6c 7s]
Dealt to MrWhite [2d 9d]
Dealt to MrOrange [Js Ad]
Dealt to Hattori [8d Ac]
Dealt to MrBlue [3h Qs]
Dealt to Pluribus [9c Qc]
MrOrange: raises 100 to 200
Hattori: folds
MrBlue: folds
Pluribus: calls 200
Budd: folds
MrWhite: calls 100
*** FLOP *** [5d 2s 2c]
MrWhite: checks
MrOrange: checks
Pluribus: checks
*** TURN *** [5d 2s 2c] [Ah]
MrWhite: checks
MrOrange: checks
Pluribus: checks
*** RIVER *** [5d 2s 2c] [Ah] [7c]
MrWhite: checks
MrOrange: checks
Pluribus: checks
*** SHOWDOWN ***
MrWhite: shows [2d 9d]
MrWhite collected 650.0 from pot
*** SUMMARY ***
Total pot 650 | Rake 0
Board [5d 2s 2c Ah 7c]
Seat 2: MrWhite showed [2d 9d] and won (650.0)
Seat 3: MrOrange showed [Js Ad] and lost
Seat 6: Pluribus showed [9c Qc] and lost


PokerStars Hand #78073: Hold'em No Limit (50/100) - 2019/07/11 21:41:13 ET
Table 'Pluribus Session 78' 6-max (Play Money) Seat #6 is the button
Seat 1: MrWhite (10000 in chips)
Seat 2: MrOrange (10000 in chips)
Seat 3: Hattori (10000 in chips)
Seat 4: MrBlue (10000 in chips)
Seat 5: Pluribus (10000 in chips)
Seat 6: Budd (10000 in chips)
MrWhite: posts small blind 50
MrOrange: posts big blind 100
*** HOLE CARDS ***
Dealt to MrWhite [Ks 3s]
Dealt to MrOrange [Qc As]
Dealt to Hattori [2h 7h]
Dealt to MrBlue [7s Kc]
Dealt to Pluribus [6c 3c]
Dealt to Budd [9h Ah]
Hattori: folds
MrBlue: folds
Pluribus: folds
Budd: raises 150 to 250
MrWhite: folds
MrOrange: raises 950 to 1200
Budd: calls 950
*** FLOP *** [4c 9s 3h]
MrOrange: bets 825
Budd: calls 825
*** TURN *** [4c 9s 3h] [Ac]
MrOrange: checks
Budd: bets 1850
MrOrange: calls 1850
*** RIVER *** [4c 9s 3h] [Ac] [Js]
MrOrange: checks
Budd: bets 6125 and is all-in
MrOrange: calls 6125 and is all-in
*** SHOWDOWN ***
Budd: shows [9h Ah]
Budd collected 20050.0 from pot
*** SUMMARY ***
Total pot 20050 | Rake 0
Board [4c 9s 3h Ac Js]
Seat 2: MrOrange showed [Qc As] and lost
Seat 6: Budd showed [9h Ah] and won (20050.0)


PokerStars Hand #78074: Hold'em No Limit (50/100) - 2019/07/11 21:41:14 ET
Table 'Pluribus Session 78' 6-max (Play Money) Seat #6 is the button
Seat 1: MrOrange (10000 in chips)
Seat 2: Hattori (10000 in chips)
Seat 3: MrBlue (10000 in chips)
Seat 4: Pluribus (10000 in chips)
Seat 5: Budd (10000 in chips)
Seat 6: MrWhite (10000 in chips)
MrOrange: posts small blind 50
Hattori: posts big blind 100
*** HOLE CARDS ***
Dealt to MrOrange [3h 3c]
Dealt to Hattori [Ad 4c]
Dealt to MrBlue [3s 8c]
Dealt to Pluribus [Kh Th]
Dealt to Budd [Jc Ts]
Dealt to MrWhite [5s Jh]
MrBlue: folds
Pluribus: raises 100 to 200
Budd: folds
MrWhite: folds
MrOrange: folds
Hattori: calls 100
*** FLOP *** [Js Kd Tc]
Hattori: checks
Pluribus: bets 225
Hattori: calls 225
*** TURN *** [Js Kd Tc] [Qs]
Hattori: checks
Pluribus: checks
*** RIVER *** [Js Kd Tc] [Qs] [2c]
Hattori: bets 900
Pluribus: folds
Uncalled bet (900) returned to Hattori
Hattori collected 900.0 from pot
*** SUMMARY ***
Total pot 900 | Rake 0
Board [Js Kd Tc Qs 2c]


PokerStars Hand #78075: Hold'em No Limit (50/100) - 2019/07/11 21:41:15 ET
Table 'Pluribus Session 78' 6-max (Play Money) Seat #6 is the button
Seat 1: Hattori (10000 in chips)
Seat 2: MrBlue (10000 in chips)
Seat 3: Pluribus (10000 in chips)
Seat 4: Budd (10000 in chips)
Seat 5: MrWhite (10000 in chips)
Seat 6: MrOrange (10000 in chips)
Hattori: posts small blind 50
MrBlue: posts big blind 100
*** HOLE CARDS ***
Dealt to Hattori [Tc 8c]
Dealt to MrBlue [8h 5h]
Dealt to Pluribus [Td 8s]
Dealt to Budd [4s 5d]
Dealt to MrWhite [3d Qs]
Dealt to MrOrange [7c 2d]
Pluribus: folds
Budd: folds
MrWhite: folds
MrOrange: folds
Hattori: calls 50
MrBlue: raises 250 to 350
Hattori: raises 1050 to 1400
MrBlue: calls 1050
*** FLOP *** [7s 3h Jd]
Hattori: bets 1400
MrBlue: folds
Uncalled bet (1400) returned to Hattori
Hattori collected 2800.0 from pot
*** SUMMARY ***
Total pot 2800 | Rake 0
Board [7s 3h Jd]


PokerStars Hand #78076: Hold'em No Limit (50/100) - 2019/07/11 21:41:16 ET
Table 'Pluribus Session 78' 6-max (Play Money) Seat #6 is the button
Seat 1: MrBlue (10000 in chips)
Seat 2: Pluribus (10000 in chips)
Seat 3: Budd (10000 in chips)
Seat 4: MrWhite (10000 in chips)
Seat 5: MrOrange (10000 in chips)
Seat 6: Hattori (10000 in chips)
MrBlue: posts small blind 50
Pluribus: posts big blind 100
*** HOLE CARDS ***
Dealt to MrBlue [Qd 7h]
Dealt to Pluribus [6h 6c]
Dealt to Budd [Kd Ts]
Dealt to MrWhite [Ks 5c]
Dealt to MrOrange [6s Qc]
Dealt to Hattori [5s Jc]
Budd: folds
MrWhite: folds
MrOrange: folds
Hattori: folds
MrBlue: raises 200 to 300
Pluribus: raises 525 to 825
MrBlue: folds
Uncalled bet (525) returned to Pluribus
Pluribus collected 600.0 from pot
*** SUMMARY ***
Total pot 600 | Rake 0


PokerStars Hand #78077: Hold'em No Limit (50/100) - 2019/07/11 21:41:17 ET
Table 'Pluribus Session 78' 6-max (Play Money) Seat #6 is the button
Seat 1: Pluribus (10000 in chips)
Seat 2: Budd (10000 in chips)
Seat 3: MrWhite (10000 in chips)
Seat 4: MrOrange (10000 in chips)
Seat 5: Hattori (10000 in chips)
Seat 6: MrBlue (10000 in chips)
Pluribus: posts small blind 50
Budd: posts big blind 100
*** HOLE CARDS ***
Dealt to Pluribus [Ac 4h]
Dealt to Budd [6s 4d]
Dealt to MrWhite [As Jd]
Dealt to MrOrange [9s Kd]
Dealt to Hattori [Th 2h]
Dealt to MrBlue [Ts 7c]
MrWhite: raises 125 to 225
MrOrange: folds
Hattori: folds
MrBlue: folds
Pluribus: folds
Budd: folds
Uncalled bet (125) returned to MrWhite
MrWhite collected 250.0 from pot
*** SUMMARY ***
Total pot 250 | Rake 0


PokerStars Hand #78078: Hold'em No Limit (50/100) - 2019/07/11 21:41:18 ET
Table 'Pluribus Session 78' 6-max (Play Money) Seat #6 is the button
Seat 1: Budd (10000 in chips)
Seat 2: MrWhite (10000 in chips)
Seat 3: MrOrange (10000 in chips)
Seat 4: Hattori (10000 in chips)
Seat 5: MrBlue (10000 in chips)
Seat 6: Pluribus (10000 in chips)
Budd: posts small blind 50
MrWhite: posts big blind 100
*** HOLE CARDS ***
Dealt to Budd [6h 8s]
Dealt to MrWhite [4d 8c]
Dealt to MrOrange [Ad 7c]
Dealt to Hattori [3h Kc]
Dealt to MrBlue [9h As]
Dealt to Pluribus [9d Kd]
MrOrange: folds
Hattori: folds
MrBlue: raises 125 to 225
Pluribus: raises 450 to 675
Budd: folds
MrWhite: folds
MrBlue: folds
Uncalled bet (450) returned to Pluribus
Pluribus collected 600.0 from pot
*** SUMMARY ***
Total pot 600 | Rake 0


PokerStars Hand #78079: Hold'em No Limit (50/100) - 2019/07/11 21:41:19 ET
Table 'Pluribus Session 78' 6-max (Play Money) Seat #6 is the button
Seat 1: MrWhite (10000 in chips)
Seat 2: MrOrange (10000 in chips)
Seat 3: Hattori (10000 in chips)
Seat 4: MrBlue (10000 in chips)
Seat 5: Pluribus (10000 in chips)
Seat 6: Budd (10000 in chips)
MrWhite: posts small blind 50
MrOrange: posts big blind 100
*** HOLE CARDS ***
Dealt to MrWhite [7h Kd]
Dealt to MrOrange [Jh Ts]
Dealt to Hattori [7d Qh]
Dealt to MrBlue [7c 6d]
Dealt to Pluribus [8s Qs]
Dealt to Budd [Jc Tc]
Hattori: folds
MrBlue: folds
Pluribus: raises 100 to 200
Budd: calls 200
MrWhite: folds
MrOrange: calls 100
*** FLOP *** [Td Ad Qd]
MrOrange: checks
Pluribus: bets 325
Budd: folds
MrOrange: folds
Uncalled bet (325) returned to Pluribus
Pluribus collected 650.0 from pot
*** SUMMARY ***
Total pot 650 | Rake 0
Board [Td Ad Qd]


PokerStars Hand #78080: Hold'em No Limit (50/100) - 2019/07/11 21:41:20 ET
Table 'Pluribus Session 78' 6-max (Play Money) Seat #6 is the button
Seat 1: MrOrange (10000 in chips)
Seat 2: Hattori (10000 in chips)
Seat 3: MrBlue (10000 in chips)
Seat 4: Pluribus (10000 in chips)
Seat 5: Budd (10000 in chips)
Seat 6: MrWhite (10000 in chips)
MrOrange: posts small blind 50
Hattori: posts big blind 100
*** HOLE CARDS ***
Dealt to MrOrange [6h 3s]
Dealt to Hattori [2s 9h]
Dealt to MrBlue [Kd Jd]
Dealt to Pluribus [Ts Ad]
Dealt to Budd [8c 4d]
Dealt to MrWhite [Qc 3h]
MrBlue: raises 125 to 225
Pluribus: folds
Budd: folds
MrWhite: folds
MrOrange: folds
Hattori: folds
Uncalled bet (125) returned to MrBlue
MrBlue collected 250.0 from pot
*** SUMMARY ***
Total pot 250 | Rake 0


PokerStars Hand #78081: Hold'em No Limit (50/100) - 2019/07/11 21:41:21 ET
Table 'Pluribus Session 78' 6-max (Play Money) Seat #6 is the button
Seat 1: Hattori (10000 in chips)
Seat 2: MrBlue (10000 in chips)
Seat 3: Pluribus (10000 in chips)
Seat 4: Budd (10000 in chips)
Seat 5: MrWhite (10000 in chips)
Seat 6: MrOrange (10000 in chips)
Hattori: posts small blind 50
MrBlue: posts big blind 100
*** HOLE CARDS ***
Dealt to Hattori [7d 5d]
Dealt to MrBlue [4c As]
Dealt to Pluribus [Ad 9h]
Dealt to Budd [Ac Ks]
Dealt to MrWhite [5s Td]
Dealt to MrOrange [4h 2s]
Pluribus: folds
Budd: raises 125 to 225
MrWhite: folds
MrOrange: folds
Hattori: folds
MrBlue: calls 125
*** FLOP *** [Ah 8c 7s]
MrBlue: checks
Budd: bets 175
MrBlue: calls 175
*** TURN *** [Ah 8c 7s] [3s]
MrBlue: checks
Budd: bets 1275
MrBlue: folds
Uncalled bet (1275) returned to Budd
Budd collected 850.0 from pot
*** SUMMARY ***
Total pot 850 | Rake 0
Board [Ah 8c 7s 3s]


PokerStars Hand #78082: Hold'em No Limit (50/100) - 2019/07/11 21:41:22 ET
Table 'Pluribus Session 78' 6-max (Play Money) Seat #6 is the button
Seat 1: MrBlue (10000 in chips)
Seat 2: Pluribus (10000 in chips)
Seat 3: Budd (10000 in chips)
Seat 4: MrWhite (10000 in chips)
Seat 5: MrOrange (10000 in chips)
Seat 6: Hattori (10000 in chips)
MrBlue: posts small blind 50
Pluribus: posts big blind 100
*** HOLE CARDS ***
Dealt to MrBlue [3h 9s]
Dealt to Pluribus [Ks Ah]
Dealt to Budd [7c 5c]
Dealt to MrWhite [5d 4h]
Dealt to MrOrange [2h Kd]
Dealt to Hattori [Ad 8d]
Budd: folds
MrWhite: folds
MrOrange: folds
Hattori: raises 125 to 225
MrBlue: folds
Pluribus: raises 1000 to 1225
Hattori: calls 1000
*** FLOP *** [7d 2s As]
Pluribus: bets 625
Hattori: calls 625
*** TURN *** [7d 2s As] [Qh]
Pluribus: bets 2812
Hattori: calls 2812
*** RIVER *** [7d 2s As] [Qh] [8h]
Pluribus: bets 5338 and is all-in
Hattori: calls 5338 and is all-in
*** SHOWDOWN ***
Hattori: shows [Ad 8d]
Hattori collected 20050.0 from pot
*** SUMMARY ***
Total pot 20050 | Rake 0
Board [7d 2s As Qh 8h]
Seat 2: Pluribus showed [Ks Ah] and lost
Seat 6: Hattori showed [Ad 8d] and won (20050.0)


PokerStars Hand #78083: Hold'em No Limit (50/100) - 2019/07/11 21:41:23 ET
Table 'Pluribus Session 78' 6-max (Play Money) Seat #6 is the button
Seat 1: Pluribus (10000 in chips)
Seat 2: Budd (10000 in chips)
Seat 3: MrWhite (10000 in chips)
Seat 4: MrOrange (10000 in chips)
Seat 5: Hattori (10000 in chips)
Seat 6: MrBlue (10000 in chips)
Pluribus: posts small blind 50
Budd: posts big blind 100
*** HOLE CARDS ***
Dealt to Pluribus [2s Ah]
Dealt to Budd [Jh Ts]
Dealt to MrWhite [3s 2d]
Dealt to MrOrange [4c 3h]
Dealt to Hattori [9h 8s]
Dealt to MrBlue [As 8d]
MrWhite: folds
MrOrange: folds
Hattori: folds
MrBlue: raises 125 to 225
Pluribus: folds
Budd: calls 125
*** FLOP *** [Ad Tc Kd]
Budd: checks
MrBlue: checks
*** TURN *** [Ad Tc Kd] [Kc]
Budd: checks
MrBlue: bets 375
Budd: folds
Uncalled bet (375) returned to MrBlue
MrBlue collected 500.0 from pot
*** SUMMARY ***
Total pot 500 | Rake 0
Board [Ad Tc Kd Kc]


PokerStars Hand #78084: Hold'em No Limit (50/100) - 2019/07/11 21:41:24 ET
Table 'Pluribus Session 78' 6-max (Play Money) Seat #6 is the button
Seat 1: Budd (10000 in chips)
Seat 2: MrWhite (10000 in chips)
Seat 3: MrOrange (10000 in chips)
Seat 4: Hattori (10000 in chips)
Seat 5: MrBlue (10000 in chips)
Seat 6: Pluribus (10000 in chips)
Budd: posts small blind 50
MrWhite: posts big blind 100
*** HOLE CARDS ***
Dealt to Budd [Js 6s]
Dealt to MrWhite [Qh Th]
Dealt to MrOrange [2c Qd]
Dealt to Hattori [8h As]
Dealt to MrBlue [6d Kc]
Dealt to Pluribus [8d 5c]
MrOrange: folds
Hattori: folds
MrBlue: folds
Pluribus: folds
Budd: raises 200 to 300
MrWhite: calls 200
*** FLOP *** [Ks Kh 4d]
Budd: bets 175
MrWhite: calls 175
*** TURN *** [Ks Kh 4d] [7s]
Budd: bets 575
MrWhite: folds
Uncalled bet (575) returned to Budd
Budd collected 950.0 from pot
*** SUMMARY ***
Total pot 950 | Rake 0
Board [Ks Kh 4d 7s]


PokerStars Hand #78085: Hold'em No Limit (50/100) - 2019/07/11 21:41:25 ET
Table 'Pluribus Session 78' 6-max (Play Money) Seat #6 is the button
Seat 1: MrWhite (10000 in chips)
Seat 2: MrOrange (10000 in chips)
Seat 3: Hattori (10000 in chips)
Seat 4: MrBlue (10000 in chips)
Seat 5: Pluribus (10000 in chips)
Seat 6: Budd (10000 in chips)
MrWhite: posts small blind 50
MrOrange: posts big blind 100
*** HOLE CARDS ***
Dealt to MrWhite [Kc Ks]
Dealt to MrOrange [2c Tc]
Dealt to Hattori [3d 4h]
Dealt to MrBlue [4d 6h]
Dealt to Pluribus [Th Kd]
Dealt to Budd [9d 2h]
Hattori: folds
MrBlue: folds
Pluribus: raises 100 to 200
Budd: folds
MrWhite: raises 500 to 700
MrOrange: folds
Pluribus: raises 1500 to 2200
MrWhite: raises 2250 to 4450
Pluribus: folds
Uncalled bet (2250) returned to MrWhite
MrWhite collected 4500.0 from pot
*** SUMMARY ***
Total pot 4500 | Rake 0


PokerStars Hand #78086: Hold'em No Limit (50/100) - 2019/07/11 21:41:26 ET
Table 'Pluribus Session 78' 6-max (Play Money) Seat #6 is the button
Seat 1: MrOrange (10000 in chips)
Seat 2: Hattori (10000 in chips)
Seat 3: MrBlue (10000 in chips)
Seat 4: Pluribus (10000 in chips)
Seat 5: Budd (10000 in chips)
Seat 6: MrWhite (10000 in chips)
MrOrange: posts small blind 50
Hattori: posts big blind 100
*** HOLE CARDS ***
Dealt to MrOrange [7c Jd]
Dealt to Hattori [Ah 2d]
Dealt to MrBlue [Qc Jh]
Dealt to Pluribus [9c 7d]
Dealt to Budd [8d 8h]
Dealt to MrWhite [5h Jc]
MrBlue: folds
Pluribus: folds
Budd: raises 125 to 225
MrWhite: folds
MrOrange: folds
Hattori: calls 125
*** FLOP *** [3s 9d Qs]
Hattori: checks
Budd: checks
*** TURN *** [3s 9d Qs] [Ks]
Hattori: checks
Budd: checks
*** RIVER *** [3s 9d Qs] [Ks] [3d]
Hattori: checks
Budd: checks
*** SHOWDOWN ***
Budd: shows [8d 8h]
Budd collected 500.0 from pot
*** SUMMARY ***
Total pot 500 | Rake 0
Board [3s 9d Qs Ks 3d]
Seat 2: Hattori showed [Ah 2d] and lost
Seat 5: Budd showed [8d 8h] and won (500.0)


PokerStars Hand #78087: Hold'em No Limit (50/100) - 2019/07/11 21:41:27 ET
Table 'Pluribus Session 78' 6-max (Play Money) Seat #6 is the button
Seat 1: Hattori (10000 in chips)
Seat 2: MrBlue (10000 in chips)
Seat 3: Pluribus (10000 in chips)
Seat 4: Budd (10000 in chips)
Seat 5: MrWhite (10000 in chips)
Seat 6: MrOrange (10000 in chips)
Hattori: posts small blind 50
MrBlue: posts big blind 100
*** HOLE CARDS ***
Dealt to Hattori [Tc As]
Dealt to MrBlue [2s 6s]
Dealt to Pluribus [4s Td]
Dealt to Budd [8s Jc]
Dealt to MrWhite [4h 3c]
Dealt to MrOrange [2c Th]
Pluribus: folds
Budd: folds
MrWhite: folds
MrOrange: folds
Hattori: raises 135 to 235
MrBlue: raises 534 to 769
Hattori: calls 534
*** FLOP *** [3h 6h Ac]
Hattori: checks
MrBlue: checks
*** TURN *** [3h 6h Ac] [9h]
Hattori: bets 1200
MrBlue: folds
Uncalled bet (1200) returned to Hattori
Hattori collected 1538.0 from pot
*** SUMMARY ***
Total pot 1538 | Rake 0
Board [3h 6h Ac 9h]


PokerStars Hand #78088: Hold'em No Limit (50/100) - 2019/07/11 21:41:28 ET
Table 'Pluribus Session 78' 6-max (Play Money) Seat #6 is the button
Seat 1: MrBlue (10000 in chips)
Seat 2: Pluribus (10000 in chips)
Seat 3: Budd (10000 in chips)
Seat 4: MrWhite (10000 in chips)
Seat 5: MrOrange (10000 in chips)
Seat 6: Hattori (10000 in chips)
MrBlue: posts small blind 50
Pluribus: posts big blind 100
*** HOLE CARDS ***
Dealt to MrBlue [8d 3h]
Dealt to Pluribus [6h 5h]
Dealt to Budd [5s 7d]
Dealt to MrWhite [5c 2s]
Dealt to MrOrange [9d Jc]
Dealt to Hattori [Jd Ac]
Budd: folds
MrWhite: folds
MrOrange: folds
Hattori: raises 125 to 225
MrBlue: folds
Pluribus: raises 1000 to 1225
Hattori: calls 1000
*** FLOP *** [7h 8s 2c]
Pluribus: checks
Hattori: bets 1250
Pluribus: calls 1250
*** TURN *** [7h 8s 2c] [2h]
Pluribus: checks
Hattori: checks
*** RIVER *** [7h 8s 2c] [2h] [6s]
Pluribus: bets 2500
Hattori: folds
Uncalled bet (2500) returned to Pluribus
Pluribus collected 5000.0 from pot
*** SUMMARY ***
Total pot 5000 | Rake 0
Board [7h 8s 2c 2h 6s]


PokerStars Hand #78089: Hold'em No Limit (50/100) - 2019/07/11 21:41:29 ET
Table 'Pluribus Session 78' 6-max (Play Money) Seat #6 is the button
Seat 1: Pluribus (10000 in chips)
Seat 2: Budd (10000 in chips)
Seat 3: MrWhite (10000 in chips)
Seat 4: MrOrange (10000 in chips)
Seat 5: Hattori (10000 in chips)
Seat 6: MrBlue (10000 in chips)
Pluribus: posts small blind 50
Budd: posts big blind 100
*** HOLE CARDS ***
Dealt to Pluribus [Js 7s]
Dealt to Budd [3s 3c]
Dealt to MrWhite [4h 4s]
Dealt to MrOrange [6d Kh]
Dealt to Hattori [5s 6h]
Dealt to MrBlue [Ac 8s]
MrWhite: raises 125 to 225
MrOrange: folds
Hattori: folds
MrBlue: folds
Pluribus: folds
Budd: calls 125
*** FLOP *** [Ad Qc 9c]
Budd: checks
MrWhite: checks
*** TURN *** [Ad Qc 9c] [Ks]
Budd: checks
MrWhite: checks
*** RIVER *** [Ad Qc 9c] [Ks] [8h]
Budd: checks
MrWhite: checks
*** SHOWDOWN ***
MrWhite: shows [4h 4s]
MrWhite collected 500.0 from pot
*** SUMMARY ***
Total pot 500 | Rake 0
Board [Ad Qc 9c Ks 8h]
Seat 2: Budd showed [3s 3c] and lost
Seat 3: MrWhite showed [4h 4s] and won (500.0)


PokerStars Hand #78090: Hold'em No Limit (50/100) - 2019/07/11 21:41:30 ET
Table 'Pluribus Session 78' 6-max (Play Money) Seat #6 is the button
Seat 1: Budd (10000 in chips)
Seat 2: MrWhite (10000 in chips)
Seat 3: MrOrange (10000 in chips)
Seat 4: Hattori (10000 in chips)
Seat 5: MrBlue (10000 in chips)
Seat 6: Pluribus (10000 in chips)
Budd: posts small blind 50
MrWhite: posts big blind 100
*** HOLE CARDS ***
Dealt to Budd [Ac 8d]
Dealt to MrWhite [As Kc]
Dealt to MrOrange [9s 3d]
Dealt to Hattori [Qh 4s]
Dealt to MrBlue [Jh Qd]
Dealt to Pluribus [6s 5d]
MrOrange: folds
Hattori: folds
MrBlue: raises 125 to 225
Pluribus: folds
Budd: folds
MrWhite: raises 500 to 725
MrBlue: folds
Uncalled bet (500) returned to MrWhite
MrWhite collected 500.0 from pot
*** SUMMARY ***
Total pot 500 | Rake 0


PokerStars Hand #78091: Hold'em No Limit (50/100) - 2019/07/11 21:41:31 ET
Table 'Pluribus Session 78' 6-max (Play Money) Seat #6 is the button
Seat 1: MrWhite (10000 in chips)
Seat 2: MrOrange (10000 in chips)
Seat 3: Hattori (10000 in chips)
Seat 4: MrBlue (10000 in chips)
Seat 5: Pluribus (10000 in chips)
Seat 6: Budd (10000 in chips)
MrWhite: posts small blind 50
MrOrange: posts big blind 100
*** HOLE CARDS ***
Dealt to MrWhite [2d 7d]
Dealt to MrOrange [2h 7h]
Dealt to Hattori [Kc 6s]
Dealt to MrBlue [3h 4c]
Dealt to Pluribus [3c 4d]
Dealt to Budd [9c 6h]
Hattori: folds
MrBlue: folds
Pluribus: folds
Budd: folds
MrWhite: folds
Uncalled bet (50) returned to MrOrange
MrOrange collected 100.0 from pot
*** SUMMARY ***
Total pot 100 | Rake 0


PokerStars Hand #78092: Hold'em No Limit (50/100) - 2019/07/11 21:41:32 ET
Table 'Pluribus Session 78' 6-max (Play Money) Seat #6 is the button
Seat 1: MrOrange (10000 in chips)
Seat 2: Hattori (10000 in chips)
Seat 3: MrBlue (10000 in chips)
Seat 4: Pluribus (10000 in chips)
Seat 5: Budd (10000 in chips)
Seat 6: MrWhite (10000 in chips)
MrOrange: posts small blind 50
Hattori: posts big blind 100
*** HOLE CARDS ***
Dealt to MrOrange [7c Jh]
Dealt to Hattori [2h 5c]
Dealt to MrBlue [7s Ah]
Dealt to Pluribus [5d 4c]
Dealt to Budd [Qs As]
Dealt to MrWhite [3d 4d]
MrBlue: folds
Pluribus: folds
Budd: raises 125 to 225
MrWhite: raises 450 to 675
MrOrange: folds
Hattori: folds
Budd: calls 450
*** FLOP *** [Tc 3c 9c]
Budd: checks
MrWhite: checks
*** TURN *** [Tc 3c 9c] [5s]
Budd: checks
MrWhite: checks
*** RIVER *** [Tc 3c 9c] [5s] [9h]
Budd: checks
MrWhite: checks
*** SHOWDOWN ***
MrWhite: shows [3d 4d]
MrWhite collected 1500.0 from pot
*** SUMMARY ***
Total pot 1500 | Rake 0
Board [Tc 3c 9c 5s 9h]
Seat 5: Budd showed [Qs As] and lost
Seat 6: MrWhite showed [3d 4d] and won (1500.0)


PokerStars Hand #78093: Hold'em No Limit (50/100) - 2019/07/11 21:41:33 ET
Table 'Pluribus Session 78' 6-max (Play Money) Seat #6 is the button
Seat 1: Hattori (10000 in chips)
Seat 2: MrBlue (10000 in chips)
Seat 3: Pluribus (10000 in chips)
Seat 4: Budd (10000 in chips)
Seat 5: MrWhite (10000 in chips)
Seat 6: MrOrange (10000 in chips)
Hattori: posts small blind 50
MrBlue: posts big blind 100
*** HOLE CARDS ***
Dealt to Hattori [Qd 2d]
Dealt to MrBlue [7c Ts]
Dealt to Pluribus [6c Kh]
Dealt to Budd [2s 9d]
Dealt to MrWhite [3c 8h]
Dealt to MrOrange [Ah As]
Pluribus: folds
Budd: folds
MrWhite: folds
MrOrange: raises 124 to 224
Hattori: folds
MrBlue: calls 124
*** FLOP *** [3h 5d 2c]
MrBlue: checks
MrOrange: checks
*** TURN *** [3h 5d 2c] [Jc]
MrBlue: checks
MrOrange: bets 300
MrBlue: folds
Uncalled bet (300) returned to MrOrange
MrOrange collected 498.0 from pot
*** SUMMARY ***
Total pot 498 | Rake 0
Board [3h 5d 2c Jc]


PokerStars Hand #78094: Hold'em No Limit (50/100) - 2019/07/11 21:41:34 ET
Table 'Pluribus Session 78' 6-max (Play Money) Seat #6 is the button
Seat 1: MrBlue (10000 in chips)
Seat 2: Pluribus (10000 in chips)
Seat 3: Budd (10000 in chips)
Seat 4: MrWhite (10000 in chips)
Seat 5: MrOrange (10000 in chips)
Seat 6: Hattori (10000 in chips)
MrBlue: posts small blind 50
Pluribus: posts big blind 100
*** HOLE CARDS ***
Dealt to MrBlue [9c 5h]
Dealt to Pluribus [7c 8d]
Dealt to Budd [Ks 3h]
Dealt to MrWhite [Kh Jh]
Dealt to MrOrange [6s As]
Dealt to Hattori [5d Qd]
Budd: folds
MrWhite: raises 125 to 225
MrOrange: folds
Hattori: folds
MrBlue: folds
Pluribus: folds
Uncalled bet (125) returned to MrWhite
MrWhite collected 250.0 from pot
*** SUMMARY ***
Total pot 250 | Rake 0


PokerStars Hand #78095: Hold'em No Limit (50/100) - 2019/07/11 21:41:35 ET
Table 'Pluribus Session 78' 6-max (Play Money) Seat #6 is the button
Seat 1: Pluribus (10000 in chips)
Seat 2: Budd (10000 in chips)
Seat 3: MrWhite (10000 in chips)
Seat 4: MrOrange (10000 in chips)
Seat 5: Hattori (10000 in chips)
Seat 6: MrBlue (10000 in chips)
Pluribus: posts small blind 50
Budd: posts big blind 100
*** HOLE CARDS ***
Dealt to Pluribus [7s 3h]
Dealt to Budd [6d 5d]
Dealt to MrWhite [Ks 3c]
Dealt to MrOrange [Qs 8c]
Dealt to Hattori [As Ts]
Dealt to MrBlue [Th 6h]
MrWhite: folds
MrOrange: folds
Hattori: raises 111 to 211
MrBlue: folds
Pluribus: folds
Budd: calls 111
*** FLOP *** [2h Js Kd]
Budd: checks
Hattori: bets 110
Budd: folds
Uncalled bet (110) returned to Hattori
Hattori collected 472.0 from pot
*** SUMMARY ***
Total pot 472 | Rake 0
Board [2h Js Kd]


PokerStars Hand #78096: Hold'em No Limit (50/100) - 2019/07/11 21:41:36 ET
Table 'Pluribus Session 78' 6-max (Play Money) Seat #6 is the button
Seat 1: Budd (10000 in chips)
Seat 2: MrWhite (10000 in chips)
Seat 3: MrOrange (10000 in chips)
Seat 4: Hattori (10000 in chips)
Seat 5: MrBlue (10000 in chips)
Seat 6: Pluribus (10000 in chips)
Budd: posts small blind 50
MrWhite: posts big blind 100
*** HOLE CARDS ***
Dealt to Budd [3d Kd]
Dealt to MrWhite [Qh Qd]
Dealt to MrOrange [9h 7d]
Dealt to Hattori [2s 5s]
Dealt to MrBlue [Ad 2c]
Dealt to Pluribus [9c 8d]
MrOrange: folds
Hattori: folds
MrBlue: raises 125 to 225
Pluribus: folds
Budd: folds
MrWhite: raises 500 to 725
MrBlue: folds
Uncalled bet (500) returned to MrWhite
MrWhite collected 500.0 from pot
*** SUMMARY ***
Total pot 500 | Rake 0


PokerStars Hand #78097: Hold'em No Limit (50/100) - 2019/07/11 21:41:37 ET
Table 'Pluribus Session 78' 6-max (Play Money) Seat #6 is the button
Seat 1: MrWhite (10000 in chips)
Seat 2: MrOrange (10000 in chips)
Seat 3: Hattori (10000 in chips)
Seat 4: MrBlue (10000 in chips)
Seat 5: Pluribus (10000 in chips)
Seat 6: Budd (10000 in chips)
MrWhite: posts small blind 50
MrOrange: posts big blind 100
*** HOLE CARDS ***
Dealt to MrWhite [Kd Td]
Dealt to MrOrange [2s Qs]
Dealt to Hattori [Ad 3c]
Dealt to MrBlue [8s Tc]
Dealt to Pluribus [Kc 5d]
Dealt to Budd [Th Qc]
Hattori: folds
MrBlue: folds
Pluribus: folds
Budd: raises 150 to 250
MrWhite: calls 200
MrOrange: calls 150
*** FLOP *** [Ac 9d Jc]
MrWhite: checks
MrOrange: checks
Budd: bets 375
MrWhite: calls 375
MrOrange: folds
*** TURN *** [Ac 9d Jc] [2d]
MrWhite: checks
Budd: checks
*** RIVER *** [Ac 9d Jc] [2d] [7h]
MrWhite: checks
Budd: checks
*** SHOWDOWN ***
MrWhite: shows [Kd Td]
MrWhite collected 1500.0 from pot
*** SUMMARY ***
Total pot 1500 | Rake 0
Board [Ac 9d Jc 2d 7h]
Seat 1: MrWhite showed [Kd Td] and won (1500.0)
Seat 6: Budd showed [Th Qc] and lost


PokerStars Hand #78098: Hold'em No Limit (50/100) - 2019/07/11 21:41:38 ET
Table 'Pluribus Session 78' 6-max (Play Money) Seat #6 is the button
Seat 1: MrOrange (10000 in chips)
Seat 2: Hattori (10000 in chips)
Seat 3: MrBlue (10000 in chips)
Seat 4: Pluribus (10000 in chips)
Seat 5: Budd (10000 in chips)
Seat 6: MrWhite (10000 in chips)
MrOrange: posts small blind 50
Hattori: posts big blind 100
*** HOLE CARDS ***
Dealt to MrOrange [8d 2c]
Dealt to Hattori [6d 4h]
Dealt to MrBlue [Kd 6h]
Dealt to Pluribus [Ah 6c]
Dealt to Budd [Jd Kh]
Dealt to MrWhite [Jh 3h]
MrBlue: folds
Pluribus: folds
Budd: raises 125 to 225
MrWhite: folds
MrOrange: folds
Hattori: folds
Uncalled bet (125) returned to Budd
Budd collected 250.0 from pot
*** SUMMARY ***
Total pot 250 | Rake 0


PokerStars Hand #78099: Hold'em No Limit (50/100) - 2019/07/11 21:41:39 ET
Table 'Pluribus Session 78' 6-max (Play Money) Seat #6 is the button
Seat 1: Hattori (10000 in chips)
Seat 2: MrBlue (10000 in chips)
Seat 3: Pluribus (10000 in chips)
Seat 4: Budd (10000 in chips)
Seat 5: MrWhite (10000 in chips)
Seat 6: MrOrange (10000 in chips)
Hattori: posts small blind 50
MrBlue: posts big blind 100
*** HOLE CARDS ***
Dealt to Hattori [6d 5d]
Dealt to MrBlue [5s Ac]
Dealt to Pluribus [7c 7s]
Dealt to Budd [8s 5c]
Dealt to MrWhite [Qc 2d]
Dealt to MrOrange [Qh 9h]
Pluribus: raises 150 to 250
Budd: folds
MrWhite: folds
MrOrange: folds
Hattori: raises 1075 to 1325
MrBlue: folds
Pluribus: calls 1075
*** FLOP *** [Th Kh 2c]
Hattori: checks
Pluribus: checks
*** TURN *** [Th Kh 2c] [2s]
Hattori: checks
Pluribus: checks
*** RIVER *** [Th Kh 2c] [2s] [Kd]
Hattori: bets 800
Pluribus: folds
Uncalled bet (800) returned to Hattori
Hattori collected 2750.0 from pot
*** SUMMARY ***
Total pot 2750 | Rake 0
Board [Th Kh 2c 2s Kd]


PokerStars Hand #78100: Hold'em No Limit (50/100) - 2019/07/11 21:41:40 ET
Table 'Pluribus Session 78' 6-max (Play Money) Seat #6 is the button
Seat 1: MrBlue (10000 in chips)
Seat 2: Pluribus (10000 in chips)
Seat 3: Budd (10000 in chips)
Seat 4: MrWhite (10000 in chips)
Seat 5: MrOrange (10000 in chips)
Seat 6: Hattori (10000 in chips)
MrBlue: posts small blind 50
Pluribus: posts big blind 100
*** HOLE CARDS ***
Dealt to MrBlue [As 8s]
Dealt to Pluribus [2h 6d]
Dealt to Budd [9c 9s]
Dealt to MrWhite [Ts 2d]
Dealt to MrOrange [Td Js]
Dealt to Hattori [Ah 6s]
Budd: raises 125 to 225
MrWhite: folds
MrOrange: folds
Hattori: folds
MrBlue: calls 175
Pluribus: folds
*** FLOP *** [5d 9h 5h]
MrBlue: checks
Budd: bets 175
MrBlue: folds
Uncalled bet (175) returned to Budd
Budd collected 550.0 from pot
*** SUMMARY ***
Total pot 550 | Rake 0
Board [5d 9h 5h]


PokerStars Hand #78101: Hold'em No Limit (50/100) - 2019/07/11 21:41:41 ET
Table 'Pluribus Session 78' 6-max (Play Money) Seat #6 is the button
Seat 1: Pluribus (10000 in chips)
Seat 2: Budd (10000 in chips)
Seat 3: MrWhite (10000 in chips)
Seat 4: MrOrange (10000 in chips)
Seat 5: Hattori (10000 in chips)
Seat 6: MrBlue (10000 in chips)
Pluribus: posts small blind 50
Budd: posts big blind 100
*** HOLE CARDS ***
Dealt to Pluribus [8s 9c]
Dealt to Budd [6d Ac]
Dealt to MrWhite [2h Jc]
Dealt to MrOrange [2s 3h]
Dealt to Hattori [Kd 9h]
Dealt to MrBlue [Qs 2c]
MrWhite: folds
MrOrange: folds
Hattori: folds
MrBlue: folds
Pluribus: raises 150 to 250
Budd: calls 150
*** FLOP *** [3s 7s 5c]
Pluribus: checks
Budd: bets 150
Pluribus: raises 800 to 950
Budd: folds
Uncalled bet (800) returned to Pluribus
Pluribus collected 800.0 from pot
*** SUMMARY ***
Total pot 800 | Rake 0
Board [3s 7s 5c]


PokerStars Hand #78102: Hold'em No Limit (50/100) - 2019/07/11 21:41:42 ET
Table 'Pluribus Session 78' 6-max (Play Money) Seat #6 is the button
Seat 1: Budd (10000 in chips)
Seat 2: MrWhite (10000 in chips)
Seat 3: MrOrange (10000 in chips)
Seat 4: Hattori (10000 in chips)
Seat 5: MrBlue (10000 in chips)
Seat 6: Pluribus (10000 in chips)
Budd: posts small blind 50
MrWhite: posts big blind 100
*** HOLE CARDS ***
Dealt to Budd [Kc Jd]
Dealt to MrWhite [4d Tc]
Dealt to MrOrange [8d Th]
Dealt to Hattori [3h 8s]
Dealt to MrBlue [8c Qc]
Dealt to Pluribus [5h 6h]
MrOrange: folds
Hattori: folds
MrBlue: raises 125 to 225
Pluribus: calls 225
Budd: folds
MrWhite: folds
*** FLOP *** [As 5c Js]
MrBlue: checks
Pluribus: bets 600
MrBlue: folds
Uncalled bet (600) returned to Pluribus
Pluribus collected 600.0 from pot
*** SUMMARY ***
Total pot 600 | Rake 0
Board [As 5c Js]


PokerStars Hand #78103: Hold'em No Limit (50/100) - 2019/07/11 21:41:43 ET
Table 'Pluribus Session 78' 6-max (Play Money) Seat #6 is the button
Seat 1: MrWhite (10000 in chips)
Seat 2: MrOrange (10000 in chips)
Seat 3: Hattori (10000 in chips)
Seat 4: MrBlue (10000 in chips)
Seat 5: Pluribus (10000 in chips)
Seat 6: Budd (10000 in chips)
MrWhite: posts small blind 50
MrOrange: posts big blind 100
*** HOLE CARDS ***
Dealt to MrWhite [Ah Qc]
Dealt to MrOrange [Jh 2d]
Dealt to Hattori [Ac 5d]
Dealt to MrBlue [8c 7d]
Dealt to Pluribus [9h 6s]
Dealt to Budd [9c Jd]
Hattori: folds
MrBlue: folds
Pluribus: folds
Budd: raises 150 to 250
MrWhite: raises 600 to 850
MrOrange: folds
Budd: folds
Uncalled bet (600) returned to MrWhite
MrWhite collected 600.0 from pot
*** SUMMARY ***
Total pot 600 | Rake 0


PokerStars Hand #78104: Hold'em No Limit (50/100) - 2019/07/11 21:41:44 ET
Table 'Pluribus Session 78' 6-max (Play Money) Seat #6 is the button
Seat 1: MrOrange (10000 in chips)
Seat 2: Hattori (10000 in chips)
Seat 3: MrBlue (10000 in chips)
Seat 4: Pluribus (10000 in chips)
Seat 5: Budd (10000 in chips)
Seat 6: MrWhite (10000 in chips)
MrOrange: posts small blind 50
Hattori: posts big blind 100
*** HOLE CARDS ***
Dealt to MrOrange [5c As]
Dealt to Hattori [3d Kh]
Dealt to MrBlue [8s Td]
Dealt to Pluribus [Tc 9s]
Dealt to Budd [Ah 5s]
Dealt to MrWhite [3c Ks]
MrBlue: folds
Pluribus: folds
Budd: folds
MrWhite: folds
MrOrange: raises 150 to 250
Hattori: calls 150
*** FLOP *** [8c Kd Qh]
MrOrange: checks
Hattori: checks
*** TURN *** [8c Kd Qh] [Qc]
MrOrange: checks
Hattori: checks
*** RIVER *** [8c Kd Qh] [Qc] [8h]
MrOrange: checks
Hattori: bets 500
MrOrange: calls 500
*** SHOWDOWN ***
Hattori: shows [3d Kh]
Hattori collected 1500.0 from pot
*** SUMMARY ***
Total pot 1500 | Rake 0
Board [8c Kd Qh Qc 8h]
Seat 1: MrOrange showed [5c As] and lost
Seat 2: Hattori showed [3d Kh] and won (1500.0)


PokerStars Hand #78105: Hold'em No Limit (50/100) - 2019/07/11 21:41:45 ET
Table 'Pluribus Session 78' 6-max (Play Money) Seat #6 is the button
Seat 1: Hattori (10000 in chips)
Seat 2: MrBlue (10000 in chips)
Seat 3: Pluribus (10000 in chips)
Seat 4: Budd (10000 in chips)
Seat 5: MrWhite (10000 in chips)
Seat 6: MrOrange (10000 in chips)
Hattori: posts small blind 50
MrBlue: posts big blind 100
*** HOLE CARDS ***
Dealt to Hattori [2s 3s]
Dealt to MrBlue [Qs 6s]
Dealt to Pluribus [7s Kd]
Dealt to Budd [Ts Qc]
Dealt to MrWhite [9d Js]
Dealt to MrOrange [Jd 9h]
Pluribus: folds
Budd: folds
MrWhite: raises 125 to 225
MrOrange: folds
Hattori: folds
MrBlue: calls 125
*** FLOP *** [Jh Qd 6h]
MrBlue: checks
MrWhite: checks
*** TURN *** [Jh Qd 6h] [Ks]
MrBlue: bets 200
MrWhite: calls 200
*** RIVER *** [Jh Qd 6h] [Ks] [5h]
MrBlue: bets 675
MrWhite: folds
Uncalled bet (675) returned to MrBlue
MrBlue collected 900.0 from pot
*** SUMMARY ***
Total pot 900 | Rake 0
Board [Jh Qd 6h Ks 5h]


PokerStars Hand #78106: Hold'em No Limit (50/100) - 2019/07/11 21:41:46 ET
Table 'Pluribus Session 78' 6-max (Play Money) Seat #6 is the button
Seat 1: MrBlue (10000 in chips)
Seat 2: Pluribus (10000 in chips)
Seat 3: Budd (10000 in chips)
Seat 4: MrWhite (10000 in chips)
Seat 5: MrOrange (10000 in chips)
Seat 6: Hattori (10000 in chips)
MrBlue: posts small blind 50
Pluribus: posts big blind 100
*** HOLE CARDS ***
Dealt to MrBlue [5h 2s]
Dealt to Pluribus [Ah Tc]
Dealt to Budd [7d 4d]
Dealt to MrWhite [Kh 5s]
Dealt to MrOrange [Td Th]
Dealt to Hattori [9c Jd]
Budd: folds
MrWhite: folds
MrOrange: raises 110 to 210
Hattori: folds
MrBlue: folds
Pluribus: calls 110
*** FLOP *** [Ac Ad 4h]
Pluribus: checks
MrOrange: bets 150
Pluribus: calls 150
*** TURN *** [Ac Ad 4h] [Jc]
Pluribus: checks
MrOrange: checks
*** RIVER *** [Ac Ad 4h] [Jc] [9d]
Pluribus: checks
MrOrange: checks
*** SHOWDOWN ***
Pluribus: shows [Ah Tc]
Pluribus collected 770.0 from pot
*** SUMMARY ***
Total pot 770 | Rake 0
Board [Ac Ad 4h Jc 9d]
Seat 2: Pluribus showed [Ah Tc] and won (770.0)
Seat 5: MrOrange showed [Td Th] and lost


PokerStars Hand #78107: Hold'em No Limit (50/100) - 2019/07/11 21:41:47 ET
Table 'Pluribus Session 78' 6-max (Play Money) Seat #6 is the button
Seat 1: Pluribus (10000 in chips)
Seat 2: Budd (10000 in chips)
Seat 3: MrWhite (10000 in chips)
Seat 4: MrOrange (10000 in chips)
Seat 5: Hattori (10000 in chips)
Seat 6: MrBlue (10000 in chips)
Pluribus: posts small blind 50
Budd: posts big blind 100
*** HOLE CARDS ***
Dealt to Pluribus [6d 5d]
Dealt to Budd [Td 5c]
Dealt to MrWhite [Ts 5s]
Dealt to MrOrange [Qs 3d]
Dealt to Hattori [Qh 5h]
Dealt to MrBlue [Tc 9s]
MrWhite: folds
MrOrange: folds
Hattori: raises 111 to 211
MrBlue: folds
Pluribus: raises 989 to 1200
Budd: folds
Hattori: folds
Uncalled bet (989) returned to Pluribus
Pluribus collected 522.0 from pot
*** SUMMARY ***
Total pot 522 | Rake 0


PokerStars Hand #78108: Hold'em No Limit (50/100) - 2019/07/11 21:41:48 ET
Table 'Pluribus Session 78' 6-max (Play Money) Seat #6 is the button
Seat 1: Budd (10000 in chips)
Seat 2: MrWhite (10000 in chips)
Seat 3: MrOrange (10000 in chips)
Seat 4: Hattori (10000 in chips)
Seat 5: MrBlue (10000 in chips)
Seat 6: Pluribus (10000 in chips)
Budd: posts small blind 50
MrWhite: posts big blind 100
*** HOLE CARDS ***
Dealt to Budd [Ts 8c]
Dealt to MrWhite [9s 4s]
Dealt to MrOrange [7h Js]
Dealt to Hattori [6d 2h]
Dealt to MrBlue [Qs Qd]
Dealt to Pluribus [5s Td]
MrOrange: folds
Hattori: folds
MrBlue: raises 125 to 225
Pluribus: folds
Budd: folds
MrWhite: calls 125
*** FLOP *** [3c Ad 6s]
MrWhite: checks
MrBlue: checks
*** TURN *** [3c Ad 6s] [Th]
MrWhite: checks
MrBlue: checks
*** RIVER *** [3c Ad 6s] [Th] [7d]
MrWhite: bets 375
MrBlue: calls 375
*** SHOWDOWN ***
MrBlue: shows [Qs Qd]
MrBlue collected 1250.0 from pot
*** SUMMARY ***
Total pot 1250 | Rake 0
Board [3c Ad 6s Th 7d]
Seat 2: MrWhite showed [9s 4s] and lost
Seat 5: MrBlue showed [Qs Qd] and won (1250.0)


PokerStars Hand #78109: Hold'em No Limit (50/100) - 2019/07/11 21:41:49 ET
Table 'Pluribus Session 78' 6-max (Play Money) Seat #6 is the button
Seat 1: MrWhite (10000 in chips)
Seat 2: MrOrange (10000 in chips)
Seat 3: Hattori (10000 in chips)
Seat 4: MrBlue (10000 in chips)
Seat 5: Pluribus (10000 in chips)
Seat 6: Budd (10000 in chips)
MrWhite: posts small blind 50
MrOrange: posts big blind 100
*** HOLE CARDS ***
Dealt to MrWhite [Jh 9c]
Dealt to MrOrange [6h 3h]
Dealt to Hattori [7c Jc]
Dealt to MrBlue [Kc 5s]
Dealt to Pluribus [Kd Ks]
Dealt to Budd [Tc Qd]
Hattori: folds
MrBlue: folds
Pluribus: raises 100 to 200
Budd: folds
MrWhite: folds
MrOrange: calls 100
*** FLOP *** [4s 5d 7d]
MrOrange: checks
Pluribus: checks
*** TURN *** [4s 5d 7d] [Qc]
MrOrange: bets 800
Pluribus: calls 800
*** RIVER *** [4s 5d 7d] [Qc] [8h]
MrOrange: bets 1750
Pluribus: folds
Uncalled bet (1750) returned to MrOrange
MrOrange collected 2050.0 from pot
*** SUMMARY ***
Total pot 2050 | Rake 0
Board [4s 5d 7d Qc 8h]


PokerStars Hand #78110: Hold'em No Limit (50/100) - 2019/07/11 21:41:50 ET
Table 'Pluribus Session 78' 6-max (Play Money) Seat #6 is the button
Seat 1: MrOrange (10000 in chips)
Seat 2: Hattori (10000 in chips)
Seat 3: MrBlue (10000 in chips)
Seat 4: Pluribus (10000 in chips)
Seat 5: Budd (10000 in chips)
Seat 6: MrWhite (10000 in chips)
MrOrange: posts small blind 50
Hattori: posts big blind 100
*** HOLE CARDS ***
Dealt to MrOrange [9d 6d]
Dealt to Hattori [Td 2s]
Dealt to MrBlue [Qh As]
Dealt to Pluribus [Qs Tc]
Dealt to Budd [Qc 7s]
Dealt to MrWhite [Ah Ts]
MrBlue: raises 125 to 225
Pluribus: folds
Budd: folds
MrWhite: folds
MrOrange: folds
Hattori: folds
Uncalled bet (125) returned to MrBlue
MrBlue collected 250.0 from pot
*** SUMMARY ***
Total pot 250 | Rake 0


PokerStars Hand #78111: Hold'em No Limit (50/100) - 2019/07/11 21:41:51 ET
Table 'Pluribus Session 78' 6-max (Play Money) Seat #6 is the button
Seat 1: Hattori (10000 in chips)
Seat 2: MrBlue (10000 in chips)
Seat 3: Pluribus (10000 in chips)
Seat 4: Budd (10000 in chips)
Seat 5: MrWhite (10000 in chips)
Seat 6: MrOrange (10000 in chips)
Hattori: posts small blind 50
MrBlue: posts big blind 100
*** HOLE CARDS ***
Dealt to Hattori [4h 4c]
Dealt to MrBlue [7s Jd]
Dealt to Pluribus [2d Tc]
Dealt to Budd [As 7h]
Dealt to MrWhite [Th 8d]
Dealt to MrOrange [7c 9d]
Pluribus: folds
Budd: folds
MrWhite: folds
MrOrange: folds
Hattori: raises 135 to 235
MrBlue: calls 135
*** FLOP *** [9c 5d 9s]
Hattori: checks
MrBlue: checks
*** TURN *** [9c 5d 9s] [3s]
Hattori: bets 150
MrBlue: folds
Uncalled bet (150) returned to Hattori
Hattori collected 470.0 from pot
*** SUMMARY ***
Total pot 470 | Rake 0
Board [9c 5d 9s 3s]


PokerStars Hand #78112: Hold'em No Limit (50/100) - 2019/07/11 21:41:52 ET
Table 'Pluribus Session 78' 6-max (Play Money) Seat #6 is the button
Seat 1: MrBlue (10000 in chips)
Seat 2: Pluribus (10000 in chips)
Seat 3: Budd (10000 in chips)
Seat 4: MrWhite (10000 in chips)
Seat 5: MrOrange (10000 in chips)
Seat 6: Hattori (10000 in chips)
MrBlue: posts small blind 50
Pluribus: posts big blind 100
*** HOLE CARDS ***
Dealt to MrBlue [Qh 7h]
Dealt to Pluribus [5d Jh]
Dealt to Budd [Js 4h]
Dealt to MrWhite [Kh 7c]
Dealt to MrOrange [6d Kd]
Dealt to Hattori [Ts Qd]
Budd: folds
MrWhite: folds
MrOrange: folds
Hattori: raises 150 to 250
MrBlue: folds
Pluribus: folds
Uncalled bet (150) returned to Hattori
Hattori collected 250.0 from pot
*** SUMMARY ***
Total pot 250 | Rake 0


PokerStars Hand #78113: Hold'em No Limit (50/100) - 2019/07/11 21:41:53 ET
Table 'Pluribus Session 78' 6-max (Play Money) Seat #6 is the button
Seat 1: Pluribus (10000 in chips)
Seat 2: Budd (10000 in chips)
Seat 3: MrWhite (10000 in chips)
Seat 4: MrOrange (10000 in chips)
Seat 5: Hattori (10000 in chips)
Seat 6: MrBlue (10000 in chips)
Pluribus: posts small blind 50
Budd: posts big blind 100
*** HOLE CARDS ***
Dealt to Pluribus [5d 5h]
Dealt to Budd [2d 8c]
Dealt to MrWhite [5c Qd]
Dealt to MrOrange [7c Kc]
Dealt to Hattori [Jc 6c]
Dealt to MrBlue [Kh 7s]
MrWhite: folds
MrOrange: folds
Hattori: folds
MrBlue: folds
Pluribus: calls 50
Budd: raises 250 to 350
Pluribus: calls 250
*** FLOP *** [7d Ad Tc]
Pluribus: checks
Budd: checks
*** TURN *** [7d Ad Tc] [6s]
Pluribus: checks
Budd: checks
*** RIVER *** [7d Ad Tc] [6s] [As]
Pluribus: checks
Budd: bets 350
Pluribus: folds
Uncalled bet (350) returned to Budd
Budd collected 700.0 from pot
*** SUMMARY ***
Total pot 700 | Rake 0
Board [7d Ad Tc 6s As]


PokerStars Hand #78114: Hold'em No Limit (50/100) - 2019/07/11 21:41:54 ET
Table 'Pluribus Session 78' 6-max (Play Money) Seat #6 is the button
Seat 1: Budd (10000 in chips)
Seat 2: MrWhite (10000 in chips)
Seat 3: MrOrange (10000 in chips)
Seat 4: Hattori (10000 in chips)
Seat 5: MrBlue (10000 in chips)
Seat 6: Pluribus (10000 in chips)
Budd: posts small blind 50
MrWhite: posts big blind 100
*** HOLE CARDS ***
Dealt to Budd [2h 7h]
Dealt to MrWhite [Ah 3h]
Dealt to MrOrange [9s 4s]
Dealt to Hattori [8c 9c]
Dealt to MrBlue [Ad 9d]
Dealt to Pluribus [8h Qs]
MrOrange: folds
Hattori: raises 100 to 200
MrBlue: calls 200
Pluribus: folds
Budd: folds
MrWhite: calls 100
*** FLOP *** [5s 4d Kc]
MrWhite: checks
Hattori: checks
MrBlue: bets 250
MrWhite: folds
Hattori: folds
Uncalled bet (250) returned to MrBlue
MrBlue collected 650.0 from pot
*** SUMMARY ***
Total pot 650 | Rake 0
Board [5s 4d Kc]


PokerStars Hand #78115: Hold'em No Limit (50/100) - 2019/07/11 21:41:55 ET
Table 'Pluribus Session 78' 6-max (Play Money) Seat #6 is the button
Seat 1: MrWhite (10000 in chips)
Seat 2: MrOrange (10000 in chips)
Seat 3: Hattori (10000 in chips)
Seat 4: MrBlue (10000 in chips)
Seat 5: Pluribus (10000 in chips)
Seat 6: Budd (10000 in chips)
MrWhite: posts small blind 50
MrOrange: posts big blind 100
*** HOLE CARDS ***
Dealt to MrWhite [8h 7c]
Dealt to MrOrange [8c 5h]
Dealt to Hattori [6c As]
Dealt to MrBlue [Tc Ac]
Dealt to Pluribus [9c 5s]
Dealt to Budd [Qc Qh]
Hattori: folds
MrBlue: raises 125 to 225
Pluribus: folds
Budd: raises 495 to 720
MrWhite: folds
MrOrange: folds
MrBlue: calls 495
*** FLOP *** [3c 4d Ts]
MrBlue: checks
Budd: bets 550
MrBlue: calls 550
*** TURN *** [3c 4d Ts] [6h]
MrBlue: checks
Budd: bets 1800
MrBlue: calls 1800
*** RIVER *** [3c 4d Ts] [6h] [9s]
MrBlue: checks
Budd: checks
*** SHOWDOWN ***
Budd: shows [Qc Qh]
Budd collected 6290.0 from pot
*** SUMMARY ***
Total pot 6290 | Rake 0
Board [3c 4d Ts 6h 9s]
Seat 4: MrBlue showed [Tc Ac] and lost
Seat 6: Budd showed [Qc Qh] and won (6290.0)


PokerStars Hand #78116: Hold'em No Limit (50/100) - 2019/07/11 21:41:56 ET
Table 'Pluribus Session 78' 6-max (Play Money) Seat #6 is the button
Seat 1: MrOrange (10000 in chips)
Seat 2: Hattori (10000 in chips)
Seat 3: MrBlue (10000 in chips)
Seat 4: Pluribus (10000 in chips)
Seat 5: Budd (10000 in chips)
Seat 6: MrWhite (10000 in chips)
MrOrange: posts small blind 50
Hattori: posts big blind 100
*** HOLE CARDS ***
Dealt to MrOrange [6d Ac]
Dealt to Hattori [7d Th]
Dealt to MrBlue [7s Js]
Dealt to Pluribus [Jd 7h]
Dealt to Budd [6s 4d]
Dealt to MrWhite [9s 7c]
MrBlue: folds
Pluribus: folds
Budd: folds
MrWhite: folds
MrOrange: raises 150 to 250
Hattori: calls 150
*** FLOP *** [6c 2h 2d]
MrOrange: bets 150
Hattori: calls 150
*** TURN *** [6c 2h 2d] [6h]
MrOrange: checks
Hattori: checks
*** RIVER *** [6c 2h 2d] [6h] [Ts]
MrOrange: bets 1440
Hattori: calls 1440
*** SHOWDOWN ***
MrOrange: shows [6d Ac]
MrOrange collected 3680.0 from pot
*** SUMMARY ***
Total pot 3680 | Rake 0
Board [6c 2h 2d 6h Ts]
Seat 1: MrOrange showed [6d Ac] and won (3680.0)
Seat 2: Hattori showed [7d Th] and lost


PokerStars Hand #78117: Hold'em No Limit (50/100) - 2019/07/11 21:41:57 ET
Table 'Pluribus Session 78' 6-max (Play Money) Seat #6 is the button
Seat 1: Hattori (10000 in chips)
Seat 2: MrBlue (10000 in chips)
Seat 3: Pluribus (10000 in chips)
Seat 4: Budd (10000 in chips)
Seat 5: MrWhite (10000 in chips)
Seat 6: MrOrange (10000 in chips)
Hattori: posts small blind 50
MrBlue: posts big blind 100
*** HOLE CARDS ***
Dealt to Hattori [Ks 3d]
Dealt to MrBlue [Qd 7c]
Dealt to Pluribus [Jd Ah]
Dealt to Budd [6d Kc]
Dealt to MrWhite [7s 2c]
Dealt to MrOrange [Qh 9d]
Pluribus: raises 100 to 200
Budd: folds
MrWhite: folds
MrOrange: folds
Hattori: folds
MrBlue: folds
Uncalled bet (100) returned to Pluribus
Pluribus collected 250.0 from pot
*** SUMMARY ***
Total pot 250 | Rake 0


PokerStars Hand #78118: Hold'em No Limit (50/100) - 2019/07/11 21:41:58 ET
Table 'Pluribus Session 78' 6-max (Play Money) Seat #6 is the button
Seat 1: MrBlue (10000 in chips)
Seat 2: Pluribus (10000 in chips)
Seat 3: Budd (10000 in chips)
Seat 4: MrWhite (10000 in chips)
Seat 5: MrOrange (10000 in chips)
Seat 6: Hattori (10000 in chips)
MrBlue: posts small blind 50
Pluribus: posts big blind 100
*** HOLE CARDS ***
Dealt to MrBlue [8h Ah]
Dealt to Pluribus [9s 2h]
Dealt to Budd [3h 6h]
Dealt to MrWhite [3d Ac]
Dealt to MrOrange [Jc 8d]
Dealt to Hattori [7h Ad]
Budd: folds
MrWhite: folds
MrOrange: folds
Hattori: raises 125 to 225
MrBlue: calls 175
Pluribus: folds
*** FLOP *** [Ks 5d 5h]
MrBlue: checks
Hattori: checks
*** TURN *** [Ks 5d 5h] [3c]
MrBlue: checks
Hattori: checks
*** RIVER *** [Ks 5d 5h] [3c] [6c]
MrBlue: checks
Hattori: checks
*** SHOWDOWN ***
MrBlue: shows [8h Ah]
MrBlue collected 550.0 from pot
*** SUMMARY ***
Total pot 550 | Rake 0
Board [Ks 5d 5h 3c 6c]
Seat 1: MrBlue showed [8h Ah] and won (550.0)
Seat 6: Hattori showed [7h Ad] and lost


PokerStars Hand #78119: Hold'em No Limit (50/100) - 2019/07/11 21:41:59 ET
Table 'Pluribus Session 78' 6-max (Play Money) Seat #6 is the button
Seat 1: Pluribus (10000 in chips)
Seat 2: Budd (10000 in chips)
Seat 3: MrWhite (10000 in chips)
Seat 4: MrOrange (10000 in chips)
Seat 5: Hattori (10000 in chips)
Seat 6: MrBlue (10000 in chips)
Pluribus: posts small blind 50
Budd: posts big blind 100
*** HOLE CARDS ***
Dealt to Pluribus [Jd 4s]
Dealt to Budd [9h 7c]
Dealt to MrWhite [8d 4c]
Dealt to MrOrange [Kh As]
Dealt to Hattori [5d 9s]
Dealt to MrBlue [4d 6h]
MrWhite: folds
MrOrange: raises 110 to 210
Hattori: folds
MrBlue: folds
Pluribus: folds
Budd: folds
Uncalled bet (110) returned to MrOrange
MrOrange collected 250.0 from pot
*** SUMMARY ***
Total pot 250 | Rake 0


PokerStars Hand #78120: Hold'em No Limit (50/100) - 2019/07/11 21:42:00 ET
Table 'Pluribus Session 78' 6-max (Play Money) Seat #6 is the button
Seat 1: Budd (10000 in chips)
Seat 2: MrWhite (10000 in chips)
Seat 3: MrOrange (10000 in chips)
Seat 4: Hattori (10000 in chips)
Seat 5: MrBlue (10000 in chips)
Seat 6: Pluribus (10000 in chips)
Budd: posts small blind 50
MrWhite: posts big blind 100
*** HOLE CARDS ***
Dealt to Budd [2d 7s]
Dealt to MrWhite [Qs 4s]
Dealt to MrOrange [2c 5c]
Dealt to Hattori [Ks 8d]
Dealt to MrBlue [As Js]
Dealt to Pluribus [3c 3h]
MrOrange: folds
Hattori: folds
MrBlue: raises 125 to 225
Pluribus: calls 225
Budd: folds
MrWhite: calls 125
*** FLOP *** [2s Ad 3d]
MrWhite: checks
MrBlue: bets 362
Pluribus: calls 362
MrWhite: folds
*** TURN *** [2s Ad 3d] [9d]
MrBlue: checks
Pluribus: bets 362
MrBlue: calls 362
*** RIVER *** [2s Ad 3d] [9d] [6c]
MrBlue: checks
Pluribus: bets 2173
MrBlue: folds
Uncalled bet (2173) returned to Pluribus
Pluribus collected 2173.0 from pot
*** SUMMARY ***
Total pot 2173 | Rake 0
Board [2s Ad 3d 9d 6c]


PokerStars Hand #78121: Hold'em No Limit (50/100) - 2019/07/11 21:42:01 ET
Table 'Pluribus Session 78' 6-max (Play Money) Seat #6 is the button
Seat 1: MrWhite (10000 in chips)
Seat 2: MrOrange (10000 in chips)
Seat 3: Hattori (10000 in chips)
Seat 4: MrBlue (10000 in chips)
Seat 5: Pluribus (10000 in chips)
Seat 6: Budd (10000 in chips)
MrWhite: posts small blind 50
MrOrange: posts big blind 100
*** HOLE CARDS ***
Dealt to MrWhite [6h 9c]
Dealt to MrOrange [Ts 3s]
Dealt to Hattori [Qc 9d]
Dealt to MrBlue [2c 4d]
Dealt to Pluribus [Ah 6d]
Dealt to Budd [Kh Js]
Hattori: folds
MrBlue: folds
Pluribus: folds
Budd: raises 150 to 250
MrWhite: folds
MrOrange: folds
Uncalled bet (150) returned to Budd
Budd collected 250.0 from pot
*** SUMMARY ***
Total pot 250 | Rake 0


PokerStars Hand #78122: Hold'em No Limit (50/100) - 2019/07/11 21:42:02 ET
Table 'Pluribus Session 78' 6-max (Play Money) Seat #6 is the button
Seat 1: MrOrange (10000 in chips)
Seat 2: Hattori (10000 in chips)
Seat 3: MrBlue (10000 in chips)
Seat 4: Pluribus (10000 in chips)
Seat 5: Budd (10000 in chips)
Seat 6: MrWhite (10000 in chips)
MrOrange: posts small blind 50
Hattori: posts big blind 100
*** HOLE CARDS ***
Dealt to MrOrange [Td Kd]
Dealt to Hattori [Ac 9d]
Dealt to MrBlue [6s 9h]
Dealt to Pluribus [8s Jh]
Dealt to Budd [Ad 6h]
Dealt to MrWhite [9s Th]
MrBlue: folds
Pluribus: folds
Budd: folds
MrWhite: folds
MrOrange: raises 200 to 300
Hattori: calls 200
*** FLOP *** [8d 7d 8c]
MrOrange: checks
Hattori: checks
*** TURN *** [8d 7d 8c] [4h]
MrOrange: checks
Hattori: checks
*** RIVER *** [8d 7d 8c] [4h] [Qs]
MrOrange: checks
Hattori: checks
*** SHOWDOWN ***
Hattori: shows [Ac 9d]
Hattori collected 600.0 from pot
*** SUMMARY ***
Total pot 600 | Rake 0
Board [8d 7d 8c 4h Qs]
Seat 1: MrOrange showed [Td Kd] and lost
Seat 2: Hattori showed [Ac 9d] and won (600.0)


PokerStars Hand #78123: Hold'em No Limit (50/100) - 2019/07/11 21:42:03 ET
Table 'Pluribus Session 78' 6-max (Play Money) Seat #6 is the button
Seat 1: Hattori (10000 in chips)
Seat 2: MrBlue (10000 in chips)
Seat 3: Pluribus (10000 in chips)
Seat 4: Budd (10000 in chips)
Seat 5: MrWhite (10000 in chips)
Seat 6: MrOrange (10000 in chips)
Hattori: posts small blind 50
MrBlue: posts big blind 100
*** HOLE CARDS ***
Dealt to Hattori [Qs 9h]
Dealt to MrBlue [9d Kc]
Dealt to Pluribus [6h Ah]
Dealt to Budd [Ks 2c]
Dealt to MrWhite [9c Kd]
Dealt to MrOrange [5h Ac]
Pluribus: raises 100 to 200
Budd: folds
MrWhite: folds
MrOrange: folds
Hattori: folds
MrBlue: calls 100
*** FLOP *** [4d 3h 5c]
MrBlue: checks
Pluribus: checks
*** TURN *** [4d 3h 5c] [Ts]
MrBlue: checks
Pluribus: checks
*** RIVER *** [4d 3h 5c] [Ts] [Jh]
MrBlue: checks
Pluribus: checks
*** SHOWDOWN ***
Pluribus: shows [6h Ah]
Pluribus collected 450.0 from pot
*** SUMMARY ***
Total pot 450 | Rake 0
Board [4d 3h 5c Ts Jh]
Seat 2: MrBlue showed [9d Kc] and lost
Seat 3: Pluribus showed [6h Ah] and won (450.0)


PokerStars Hand #78124: Hold'em No Limit (50/100) - 2019/07/11 21:42:04 ET
Table 'Pluribus Session 78' 6-max (Play Money) Seat #6 is the button
Seat 1: MrBlue (10000 in chips)
Seat 2: Pluribus (10000 in chips)
Seat 3: Budd (10000 in chips)
Seat 4: MrWhite (10000 in chips)
Seat 5: MrOrange (10000 in chips)
Seat 6: Hattori (10000 in chips)
MrBlue: posts small blind 50
Pluribus: posts big blind 100
*** HOLE CARDS ***
Dealt to MrBlue [Kh 5h]
Dealt to Pluribus [Qd 2c]
Dealt to Budd [Kd Td]
Dealt to MrWhite [Kc 2h]
Dealt to MrOrange [Qc Jh]
Dealt to Hattori [5d 4s]
Budd: raises 125 to 225
MrWhite: folds
MrOrange: folds
Hattori: folds
MrBlue: calls 175
Pluribus: folds
*** FLOP *** [3c 7s 8d]
MrBlue: checks
Budd: checks
*** TURN *** [3c 7s 8d] [2s]
MrBlue: checks
Budd: bets 225
MrBlue: folds
Uncalled bet (225) returned to Budd
Budd collected 550.0 from pot
*** SUMMARY ***
Total pot 550 | Rake 0
Board [3c 7s 8d 2s]


PokerStars Hand #78125: Hold'em No Limit (50/100) - 2019/07/11 21:42:05 ET
Table 'Pluribus Session 78' 6-max (Play Money) Seat #6 is the button
Seat 1: Pluribus (10000 in chips)
Seat 2: Budd (10000 in chips)
Seat 3: MrWhite (10000 in chips)
Seat 4: MrOrange (10000 in chips)
Seat 5: Hattori (10000 in chips)
Seat 6: MrBlue (10000 in chips)
Pluribus: posts small blind 50
Budd: posts big blind 100
*** HOLE CARDS ***
Dealt to Pluribus [9c 7h]
Dealt to Budd [2s 9s]
Dealt to MrWhite [3s Qs]
Dealt to MrOrange [6s Qc]
Dealt to Hattori [Kh 9h]
Dealt to MrBlue [2h 7c]
MrWhite: folds
MrOrange: folds
Hattori: raises 111 to 211
MrBlue: folds
Pluribus: folds
Budd: calls 111
*** FLOP *** [3h 8h Js]
Budd: checks
Hattori: bets 125
Budd: folds
Uncalled bet (125) returned to Hattori
Hattori collected 472.0 from pot
*** SUMMARY ***
Total pot 472 | Rake 0
Board [3h 8h Js]


PokerStars Hand #78126: Hold'em No Limit (50/100) - 2019/07/11 21:42:06 ET
Table 'Pluribus Session 78' 6-max (Play Money) Seat #6 is the button
Seat 1: Budd (10000 in chips)
Seat 2: MrWhite (10000 in chips)
Seat 3: MrOrange (10000 in chips)
Seat 4: Hattori (10000 in chips)
Seat 5: MrBlue (10000 in chips)
Seat 6: Pluribus (10000 in chips)
Budd: posts small blind 50
MrWhite: posts big blind 100
*** HOLE CARDS ***
Dealt to Budd [5s 5h]
Dealt to MrWhite [8c Ts]
Dealt to MrOrange [Th 4d]
Dealt to Hattori [Kc Qd]
Dealt to MrBlue [Jc 7s]
Dealt to Pluribus [6c 9d]
MrOrange: folds
Hattori: raises 100 to 200
MrBlue: folds
Pluribus: folds
Budd: folds
MrWhite: calls 100
*** FLOP *** [9c Jh 8h]
MrWhite: checks
Hattori: bets 110
MrWhite: calls 110
*** TURN *** [9c Jh 8h] [2h]
MrWhite: checks
Hattori: checks
*** RIVER *** [9c Jh 8h] [2h] [4s]
MrWhite: checks
Hattori: bets 670
MrWhite: folds
Uncalled bet (670) returned to Hattori
Hattori collected 670.0 from pot
*** SUMMARY ***
Total pot 670 | Rake 0
Board [9c Jh 8h 2h 4s]


PokerStars Hand #78127: Hold'em No Limit (50/100) - 2019/07/11 21:42:07 ET
Table 'Pluribus Session 78' 6-max (Play Money) Seat #6 is the button
Seat 1: MrWhite (10000 in chips)
Seat 2: MrOrange (10000 in chips)
Seat 3: Hattori (10000 in chips)
Seat 4: MrBlue (10000 in chips)
Seat 5: Pluribus (10000 in chips)
Seat 6: Budd (10000 in chips)
MrWhite: posts small blind 50
MrOrange: posts big blind 100
*** HOLE CARDS ***
Dealt to MrWhite [9s 3s]
Dealt to MrOrange [8s 6s]
Dealt to Hattori [6c 5s]
Dealt to MrBlue [Jc Qh]
Dealt to Pluribus [Kd Td]
Dealt to Budd [9h 8c]
Hattori: folds
MrBlue: folds
Pluribus: raises 125 to 225
Budd: folds
MrWhite: folds
MrOrange: raises 975 to 1200
Pluribus: calls 975
*** FLOP *** [Ks Qd 2c]
MrOrange: bets 750
Pluribus: calls 750
*** TURN *** [Ks Qd 2c] [3h]
MrOrange: checks
Pluribus: bets 1975
MrOrange: folds
Uncalled bet (1975) returned to Pluribus
Pluribus collected 3950.0 from pot
*** SUMMARY ***
Total pot 3950 | Rake 0
Board [Ks Qd 2c 3h]


PokerStars Hand #78128: Hold'em No Limit (50/100) - 2019/07/11 21:42:08 ET
Table 'Pluribus Session 78' 6-max (Play Money) Seat #6 is the button
Seat 1: MrOrange (10000 in chips)
Seat 2: Hattori (10000 in chips)
Seat 3: MrBlue (10000 in chips)
Seat 4: Pluribus (10000 in chips)
Seat 5: Budd (10000 in chips)
Seat 6: MrWhite (10000 in chips)
MrOrange: posts small blind 50
Hattori: posts big blind 100
*** HOLE CARDS ***
Dealt to MrOrange [Jc 5c]
Dealt to Hattori [2c 7d]
Dealt to MrBlue [2h Ad]
Dealt to Pluribus [6d 8s]
Dealt to Budd [9s 8c]
Dealt to MrWhite [9h 6c]
MrBlue: folds
Pluribus: folds
Budd: folds
MrWhite: folds
MrOrange: raises 200 to 300
Hattori: folds
Uncalled bet (200) returned to MrOrange
MrOrange collected 200.0 from pot
*** SUMMARY ***
Total pot 200 | Rake 0


PokerStars Hand #78129: Hold'em No Limit (50/100) - 2019/07/11 21:42:09 ET
Table 'Pluribus Session 78' 6-max (Play Money) Seat #6 is the button
Seat 1: Hattori (10000 in chips)
Seat 2: MrBlue (10000 in chips)
Seat 3: Pluribus (10000 in chips)
Seat 4: Budd (10000 in chips)
Seat 5: MrWhite (10000 in chips)
Seat 6: MrOrange (10000 in chips)
Hattori: posts small blind 50
MrBlue: posts big blind 100
*** HOLE CARDS ***
Dealt to Hattori [7s Kd]
Dealt to MrBlue [Ac Jc]
Dealt to Pluribus [8h 2h]
Dealt to Budd [6h As]
Dealt to MrWhite [Td 3h]
Dealt to MrOrange [Qc Tc]
Pluribus: folds
Budd: folds
MrWhite: folds
MrOrange: raises 124 to 224
Hattori: folds
MrBlue: raises 851 to 1075
MrOrange: calls 851
*** FLOP *** [Ks 9c 6s]
MrBlue: bets 800
MrOrange: calls 800
*** TURN *** [Ks 9c 6s] [Th]
MrBlue: bets 2100
MrOrange: calls 2100
*** RIVER *** [Ks 9c 6s] [Th] [Ad]
MrBlue: checks
MrOrange: checks
*** SHOWDOWN ***
MrBlue: shows [Ac Jc]
MrBlue collected 8000.0 from pot
*** SUMMARY ***
Total pot 8000 | Rake 0
Board [Ks 9c 6s Th Ad]
Seat 2: MrBlue showed [Ac Jc] and won (8000.0)
Seat 6: MrOrange showed [Qc Tc] and lost


PokerStars Hand #78130: Hold'em No Limit (50/100) - 2019/07/11 21:42:10 ET
Table 'Pluribus Session 78' 6-max (Play Money) Seat #6 is the button
Seat 1: MrBlue (10000 in chips)
Seat 2: Pluribus (10000 in chips)
Seat 3: Budd (10000 in chips)
Seat 4: MrWhite (10000 in chips)
Seat 5: MrOrange (10000 in chips)
Seat 6: Hattori (10000 in chips)
MrBlue: posts small blind 50
Pluribus: posts big blind 100
*** HOLE CARDS ***
Dealt to MrBlue [5c 2h]
Dealt to Pluribus [3s Js]
Dealt to Budd [6s 7d]
Dealt to MrWhite [7h Qh]
Dealt to MrOrange [Ks 3c]
Dealt to Hattori [9h 8c]
Budd: folds
MrWhite: folds
MrOrange: folds
Hattori: raises 125 to 225
MrBlue: folds
Pluribus: calls 125
*** FLOP *** [8s Ad 5s]
Pluribus: checks
Hattori: checks
*** TURN *** [8s Ad 5s] [6d]
Pluribus: bets 750
Hattori: calls 750
*** RIVER *** [8s Ad 5s] [6d] [9c]
Pluribus: bets 1500
Hattori: calls 1500
*** SHOWDOWN ***
Hattori: shows [9h 8c]
Hattori collected 5000.0 from pot
*** SUMMARY ***
Total pot 5000 | Rake 0
Board [8s Ad 5s 6d 9c]
Seat 2: Pluribus showed [3s Js] and lost
Seat 6: Hattori showed [9h 8c] and won (5000.0)


PokerStars Hand #78131: Hold'em No Limit (50/100) - 2019/07/11 21:42:11 ET
Table 'Pluribus Session 78' 6-max (Play Money) Seat #6 is the button
Seat 1: Pluribus (10000 in chips)
Seat 2: Budd (10000 in chips)
Seat 3: MrWhite (10000 in chips)
Seat 4: MrOrange (10000 in chips)
Seat 5: Hattori (10000 in chips)
Seat 6: MrBlue (10000 in chips)
Pluribus: posts small blind 50
Budd: posts big blind 100
*** HOLE CARDS ***
Dealt to Pluribus [2d 9s]
Dealt to Budd [4h Kd]
Dealt to MrWhite [4c 2h]
Dealt to MrOrange [7s 9h]
Dealt to Hattori [5h Ac]
Dealt to MrBlue [Ks Kc]
MrWhite: folds
MrOrange: folds
Hattori: folds
MrBlue: raises 125 to 225
Pluribus: folds
Budd: folds
Uncalled bet (125) returned to MrBlue
MrBlue collected 250.0 from pot
*** SUMMARY ***
Total pot 250 | Rake 0


PokerStars Hand #78132: Hold'em No Limit (50/100) - 2019/07/11 21:42:12 ET
Table 'Pluribus Session 78' 6-max (Play Money) Seat #6 is the button
Seat 1: Budd (10000 in chips)
Seat 2: MrWhite (10000 in chips)
Seat 3: MrOrange (10000 in chips)
Seat 4: Hattori (10000 in chips)
Seat 5: MrBlue (10000 in chips)
Seat 6: Pluribus (10000 in chips)
Budd: posts small blind 50
MrWhite: posts big blind 100
*** HOLE CARDS ***
Dealt to Budd [5c 6d]
Dealt to MrWhite [4h 8c]
Dealt to MrOrange [4c Tc]
Dealt to Hattori [2s Jc]
Dealt to MrBlue [7d Td]
Dealt to Pluribus [7c 7h]
MrOrange: folds
Hattori: folds
MrBlue: raises 125 to 225
Pluribus: calls 225
Budd: folds
MrWhite: folds
*** FLOP *** [2c 2d Ts]
MrBlue: bets 250
Pluribus: calls 250
*** TURN *** [2c 2d Ts] [Ks]
MrBlue: checks
Pluribus: checks
*** RIVER *** [2c 2d Ts] [Ks] [As]
MrBlue: checks
Pluribus: checks
*** SHOWDOWN ***
MrBlue: shows [7d Td]
MrBlue collected 1100.0 from pot
*** SUMMARY ***
Total pot 1100 | Rake 0
Board [2c 2d Ts Ks As]
Seat 5: MrBlue showed [7d Td] and won (1100.0)
Seat 6: Pluribus showed [7c 7h] and lost


PokerStars Hand #78133: Hold'em No Limit (50/100) - 2019/07/11 21:42:13 ET
Table 'Pluribus Session 78' 6-max (Play Money) Seat #6 is the button
Seat 1: MrWhite (10000 in chips)
Seat 2: MrOrange (10000 in chips)
Seat 3: Hattori (10000 in chips)
Seat 4: MrBlue (10000 in chips)
Seat 5: Pluribus (10000 in chips)
Seat 6: Budd (10000 in chips)
MrWhite: posts small blind 50
MrOrange: posts big blind 100
*** HOLE CARDS ***
Dealt to MrWhite [8c 2c]
Dealt to MrOrange [9c 6c]
Dealt to Hattori [Kh 3h]
Dealt to MrBlue [9d 7d]
Dealt to Pluribus [8h 5c]
Dealt to Budd [Tc 2h]
Hattori: folds
MrBlue: raises 125 to 225
Pluribus: folds
Budd: folds
MrWhite: folds
MrOrange: raises 1025 to 1250
MrBlue: folds
Uncalled bet (1025) returned to MrOrange
MrOrange collected 500.0 from pot
*** SUMMARY ***
Total pot 500 | Rake 0


PokerStars Hand #78134: Hold'em No Limit (50/100) - 2019/07/11 21:42:14 ET
Table 'Pluribus Session 78' 6-max (Play Money) Seat #6 is the button
Seat 1: MrOrange (10000 in chips)
Seat 2: Hattori (10000 in chips)
Seat 3: MrBlue (10000 in chips)
Seat 4: Pluribus (10000 in chips)
Seat 5: Budd (10000 in chips)
Seat 6: MrWhite (10000 in chips)
MrOrange: posts small blind 50
Hattori: posts big blind 100
*** HOLE CARDS ***
Dealt to MrOrange [5h Td]
Dealt to Hattori [Qd Kd]
Dealt to MrBlue [Ac 4d]
Dealt to Pluribus [9h Qc]
Dealt to Budd [8s 9d]
Dealt to MrWhite [3d 2s]
MrBlue: folds
Pluribus: folds
Budd: folds
MrWhite: folds
MrOrange: folds
Uncalled bet (50) returned to Hattori
Hattori collected 100.0 from pot
*** SUMMARY ***
Total pot 100 | Rake 0


PokerStars Hand #78135: Hold'em No Limit (50/100) - 2019/07/11 21:42:15 ET
Table 'Pluribus Session 78' 6-max (Play Money) Seat #6 is the button
Seat 1: Hattori (10000 in chips)
Seat 2: MrBlue (10000 in chips)
Seat 3: Pluribus (10000 in chips)
Seat 4: Budd (10000 in chips)
Seat 5: MrWhite (10000 in chips)
Seat 6: MrOrange (10000 in chips)
Hattori: posts small blind 50
MrBlue: posts big blind 100
*** HOLE CARDS ***
Dealt to Hattori [4h 7c]
Dealt to MrBlue [5d Ks]
Dealt to Pluribus [2c 9s]
Dealt to Budd [3d Qs]
Dealt to MrWhite [3c 2d]
Dealt to MrOrange [Tc Th]
Pluribus: folds
Budd: folds
MrWhite: folds
MrOrange: raises 124 to 224
Hattori: folds
MrBlue: calls 124
*** FLOP *** [8c Ad Js]
MrBlue: checks
MrOrange: checks
*** TURN *** [8c Ad Js] [As]
MrBlue: checks
MrOrange: checks
*** RIVER *** [8c Ad Js] [As] [5s]
MrBlue: checks
MrOrange: checks
*** SHOWDOWN ***
MrOrange: shows [Tc Th]
MrOrange collected 498.0 from pot
*** SUMMARY ***
Total pot 498 | Rake 0
Board [8c Ad Js As 5s]
Seat 2: MrBlue showed [5d Ks] and lost
Seat 6: MrOrange showed [Tc Th] and won (498.0)


PokerStars Hand #78136: Hold'em No Limit (50/100) - 2019/07/11 21:42:16 ET
Table 'Pluribus Session 78' 6-max (Play Money) Seat #6 is the button
Seat 1: MrBlue (10000 in chips)
Seat 2: Pluribus (10000 in chips)
Seat 3: Budd (10000 in chips)
Seat 4: MrWhite (10000 in chips)
Seat 5: MrOrange (10000 in chips)
Seat 6: Hattori (10000 in chips)
MrBlue: posts small blind 50
Pluribus: posts big blind 100
*** HOLE CARDS ***
Dealt to MrBlue [Qd Jc]
Dealt to Pluribus [7s 9h]
Dealt to Budd [As Ad]
Dealt to MrWhite [9c Kd]
Dealt to MrOrange [Ah Qh]
Dealt to Hattori [8s 4s]
Budd: raises 125 to 225
MrWhite: folds
MrOrange: calls 225
Hattori: folds
MrBlue: folds
Pluribus: folds
*** FLOP *** [5h 9s 6c]
Budd: checks
MrOrange: checks
*** TURN *** [5h 9s 6c] [Tc]
Budd: bets 900
MrOrange: folds
Uncalled bet (900) returned to Budd
Budd collected 600.0 from pot
*** SUMMARY ***
Total pot 600 | Rake 0
Board [5h 9s 6c Tc]


PokerStars Hand #78137: Hold'em No Limit (50/100) - 2019/07/11 21:42:17 ET
Table 'Pluribus Session 78' 6-max (Play Money) Seat #6 is the button
Seat 1: Pluribus (10000 in chips)
Seat 2: Budd (10000 in chips)
Seat 3: MrWhite (10000 in chips)
Seat 4: MrOrange (10000 in chips)
Seat 5: Hattori (10000 in chips)
Seat 6: MrBlue (10000 in chips)
Pluribus: posts small blind 50
Budd: posts big blind 100
*** HOLE CARDS ***
Dealt to Pluribus [Ah 5s]
Dealt to Budd [8s Qc]
Dealt to MrWhite [2h 9s]
Dealt to MrOrange [Td 4c]
Dealt to Hattori [6d Kd]
Dealt to MrBlue [Ac Ks]
MrWhite: folds
MrOrange: folds
Hattori: raises 111 to 211
MrBlue: raises 555 to 766
Pluribus: folds
Budd: folds
Hattori: folds
Uncalled bet (555) returned to MrBlue
MrBlue collected 572.0 from pot
*** SUMMARY ***
Total pot 572 | Rake 0


PokerStars Hand #78138: Hold'em No Limit (50/100) - 2019/07/11 21:42:18 ET
Table 'Pluribus Session 78' 6-max (Play Money) Seat #6 is the button
Seat 1: Budd (10000 in chips)
Seat 2: MrWhite (10000 in chips)
Seat 3: MrOrange (10000 in chips)
Seat 4: Hattori (10000 in chips)
Seat 5: MrBlue (10000 in chips)
Seat 6: Pluribus (10000 in chips)
Budd: posts small blind 50
MrWhite: posts big blind 100
*** HOLE CARDS ***
Dealt to Budd [Jh 3h]
Dealt to MrWhite [7s Js]
Dealt to MrOrange [5d 2d]
Dealt to Hattori [4h Ac]
Dealt to MrBlue [Th 8h]
Dealt to Pluribus [As 9s]
MrOrange: folds
Hattori: folds
MrBlue: raises 125 to 225
Pluribus: calls 225
Budd: folds
MrWhite: calls 125
*** FLOP *** [5c 5h 9c]
MrWhite: checks
MrBlue: checks
Pluribus: bets 362
MrWhite: folds
MrBlue: folds
Uncalled bet (362) returned to Pluribus
Pluribus collected 725.0 from pot
*** SUMMARY ***
Total pot 725 | Rake 0
Board [5c 5h 9c]


PokerStars Hand #78139: Hold'em No Limit (50/100) - 2019/07/11 21:42:19 ET
Table 'Pluribus Session 78' 6-max (Play Money) Seat #6 is the button
Seat 1: MrWhite (10000 in chips)
Seat 2: MrOrange (10000 in chips)
Seat 3: Hattori (10000 in chips)
Seat 4: MrBlue (10000 in chips)
Seat 5: Pluribus (10000 in chips)
Seat 6: Budd (10000 in chips)
MrWhite: posts small blind 50
MrOrange: posts big blind 100
*** HOLE CARDS ***
Dealt to MrWhite [4h 3d]
Dealt to MrOrange [9h 2s]
Dealt to Hattori [5c Ts]
Dealt to MrBlue [2h Kc]
Dealt to Pluribus [Jd 7c]
Dealt to Budd [7d As]
Hattori: folds
MrBlue: folds
Pluribus: folds
Budd: raises 150 to 250
MrWhite: folds
MrOrange: folds
Uncalled bet (150) returned to Budd
Budd collected 250.0 from pot
*** SUMMARY ***
Total pot 250 | Rake 0


PokerStars Hand #78140: Hold'em No Limit (50/100) - 2019/07/11 21:42:20 ET
Table 'Pluribus Session 78' 6-max (Play Money) Seat #6 is the button
Seat 1: MrOrange (10000 in chips)
Seat 2: Hattori (10000 in chips)
Seat 3: MrBlue (10000 in chips)
Seat 4: Pluribus (10000 in chips)
Seat 5: Budd (10000 in chips)
Seat 6: MrWhite (10000 in chips)
MrOrange: posts small blind 50
Hattori: posts big blind 100
*** HOLE CARDS ***
Dealt to MrOrange [8h Ac]
Dealt to Hattori [5s Ts]
Dealt to MrBlue [Jc 8c]
Dealt to Pluribus [7c 3s]
Dealt to Budd [8s 5h]
Dealt to MrWhite [4c 6s]
MrBlue: raises 125 to 225
Pluribus: folds
Budd: folds
MrWhite: folds
MrOrange: folds
Hattori: calls 125
*** FLOP *** [7d 2s 5d]
Hattori: checks
MrBlue: checks
*** TURN *** [7d 2s 5d] [4h]
Hattori: bets 150
MrBlue: calls 150
*** RIVER *** [7d 2s 5d] [4h] [Jd]
Hattori: checks
MrBlue: bets 600
Hattori: calls 600
*** SHOWDOWN ***
MrBlue: shows [Jc 8c]
MrBlue collected 2000.0 from pot
*** SUMMARY ***
Total pot 2000 | Rake 0
Board [7d 2s 5d 4h Jd]
Seat 2: Hattori showed [5s Ts] and lost
Seat 3: MrBlue showed [Jc 8c] and won (2000.0)


PokerStars Hand #78141: Hold'em No Limit (50/100) - 2019/07/11 21:42:21 ET
Table 'Pluribus Session 78' 6-max (Play Money) Seat #6 is the button
Seat 1: Hattori (10000 in chips)
Seat 2: MrBlue (10000 in chips)
Seat 3: Pluribus (10000 in chips)
Seat 4: Budd (10000 in chips)
Seat 5: MrWhite (10000 in chips)
Seat 6: MrOrange (10000 in chips)
Hattori: posts small blind 50
MrBlue: posts big blind 100
*** HOLE CARDS ***
Dealt to Hattori [5h Td]
Dealt to MrBlue [Tc 4s]
Dealt to Pluribus [Jc 4c]
Dealt to Budd [Ah 8d]
Dealt to MrWhite [As 2c]
Dealt to MrOrange [5c 2s]
Pluribus: folds
Budd: folds
MrWhite: folds
MrOrange: folds
Hattori: folds
Uncalled bet (50) returned to MrBlue
MrBlue collected 100.0 from pot
*** SUMMARY ***
Total pot 100 | Rake 0


PokerStars Hand #78142: Hold'em No Limit (50/100) - 2019/07/11 21:42:22 ET
Table 'Pluribus Session 78' 6-max (Play Money) Seat #6 is the button
Seat 1: MrBlue (10000 in chips)
Seat 2: Pluribus (10000 in chips)
Seat 3: Budd (10000 in chips)
Seat 4: MrWhite (10000 in chips)
Seat 5: MrOrange (10000 in chips)
Seat 6: Hattori (10000 in chips)
MrBlue: posts small blind 50
Pluribus: posts big blind 100
*** HOLE CARDS ***
Dealt to MrBlue [2d Ah]
Dealt to Pluribus [Qc 2s]
Dealt to Budd [6s 4s]
Dealt to MrWhite [Kh Ts]
Dealt to MrOrange [8s 3s]
Dealt to Hattori [8d 4d]
Budd: folds
MrWhite: folds
MrOrange: folds
Hattori: folds
MrBlue: raises 200 to 300
Pluribus: folds
Uncalled bet (200) returned to MrBlue
MrBlue collected 200.0 from pot
*** SUMMARY ***
Total pot 200 | Rake 0


PokerStars Hand #78143: Hold'em No Limit (50/100) - 2019/07/11 21:42:23 ET
Table 'Pluribus Session 78' 6-max (Play Money) Seat #6 is the button
Seat 1: Pluribus (10000 in chips)
Seat 2: Budd (10000 in chips)
Seat 3: MrWhite (10000 in chips)
Seat 4: MrOrange (10000 in chips)
Seat 5: Hattori (10000 in chips)
Seat 6: MrBlue (10000 in chips)
Pluribus: posts small blind 50
Budd: posts big blind 100
*** HOLE CARDS ***
Dealt to Pluribus [Js 3s]
Dealt to Budd [Th 5s]
Dealt to MrWhite [Qd 7c]
Dealt to MrOrange [Jh 6h]
Dealt to Hattori [8c Ad]
Dealt to MrBlue [5c 8d]
MrWhite: folds
MrOrange: folds
Hattori: raises 111 to 211
MrBlue: folds
Pluribus: folds
Budd: folds
Uncalled bet (111) returned to Hattori
Hattori collected 250.0 from pot
*** SUMMARY ***
Total pot 250 | Rake 0


PokerStars Hand #78144: Hold'em No Limit (50/100) - 2019/07/11 21:42:24 ET
Table 'Pluribus Session 78' 6-max (Play Money) Seat #6 is the button
Seat 1: Budd (10000 in chips)
Seat 2: MrWhite (10000 in chips)
Seat 3: MrOrange (10000 in chips)
Seat 4: Hattori (10000 in chips)
Seat 5: MrBlue (10000 in chips)
Seat 6: Pluribus (10000 in chips)
Budd: posts small blind 50
MrWhite: posts big blind 100
*** HOLE CARDS ***
Dealt to Budd [Ac 8c]
Dealt to MrWhite [3c 2c]
Dealt to MrOrange [Ah 6c]
Dealt to Hattori [Ts Th]
Dealt to MrBlue [Js 2s]
Dealt to Pluribus [6d 7s]
MrOrange: calls 100
Hattori: raises 250 to 350
MrBlue: folds
Pluribus: folds
Budd: folds
MrWhite: folds
MrOrange: folds
Uncalled bet (250) returned to Hattori
Hattori collected 350.0 from pot
*** SUMMARY ***
Total pot 350 | Rake 0


PokerStars Hand #78145: Hold'em No Limit (50/100) - 2019/07/11 21:42:25 ET
Table 'Pluribus Session 78' 6-max (Play Money) Seat #6 is the button
Seat 1: MrWhite (10000 in chips)
Seat 2: MrOrange (10000 in chips)
Seat 3: Hattori (10000 in chips)
Seat 4: MrBlue (10000 in chips)
Seat 5: Pluribus (10000 in chips)
Seat 6: Budd (10000 in chips)
MrWhite: posts small blind 50
MrOrange: posts big blind 100
*** HOLE CARDS ***
Dealt to MrWhite [7h 7s]
Dealt to MrOrange [6s 4d]
Dealt to Hattori [6d 8h]
Dealt to MrBlue [Td 3h]
Dealt to Pluribus [9c As]
Dealt to Budd [5d Ah]
Hattori: folds
MrBlue: folds
Pluribus: raises 125 to 225
Budd: folds
MrWhite: calls 175
MrOrange: folds
*** FLOP *** [7c 6c 8c]
MrWhite: checks
Pluribus: checks
*** TURN *** [7c 6c 8c] [Th]
MrWhite: checks
Pluribus: bets 137
MrWhite: calls 137
*** RIVER *** [7c 6c 8c] [Th] [Ks]
MrWhite: checks
Pluribus: bets 824
MrWhite: calls 824
*** SHOWDOWN ***
Pluribus: shows [9c As]
Pluribus collected 2472.0 from pot
*** SUMMARY ***
Total pot 2472 | Rake 0
Board [7c 6c 8c Th Ks]
Seat 1: MrWhite showed [7h 7s] and lost
Seat 5: Pluribus showed [9c As] and won (2472.0)


PokerStars Hand #78146: Hold'em No Limit (50/100) - 2019/07/11 21:42:26 ET
Table 'Pluribus Session 78' 6-max (Play Money) Seat #6 is the button
Seat 1: MrOrange (10000 in chips)
Seat 2: Hattori (10000 in chips)
Seat 3: MrBlue (10000 in chips)
Seat 4: Pluribus (10000 in chips)
Seat 5: Budd (10000 in chips)
Seat 6: MrWhite (10000 in chips)
MrOrange: posts small blind 50
Hattori: posts big blind 100
*** HOLE CARDS ***
Dealt to MrOrange [Js 9s]
Dealt to Hattori [6c Td]
Dealt to MrBlue [Qc 3d]
Dealt to Pluribus [8s 5h]
Dealt to Budd [4h 2h]
Dealt to MrWhite [3h 4s]
MrBlue: folds
Pluribus: folds
Budd: folds
MrWhite: folds
MrOrange: folds
Uncalled bet (50) returned to Hattori
Hattori collected 100.0 from pot
*** SUMMARY ***
Total pot 100 | Rake 0


PokerStars Hand #78147: Hold'em No Limit (50/100) - 2019/07/11 21:42:27 ET
Table 'Pluribus Session 78' 6-max (Play Money) Seat #6 is the button
Seat 1: Hattori (10000 in chips)
Seat 2: MrBlue (10000 in chips)
Seat 3: Pluribus (10000 in chips)
Seat 4: Budd (10000 in chips)
Seat 5: MrWhite (10000 in chips)
Seat 6: MrOrange (10000 in chips)
Hattori: posts small blind 50
MrBlue: posts big blind 100
*** HOLE CARDS ***
Dealt to Hattori [Ad 4h]
Dealt to MrBlue [Qs 6h]
Dealt to Pluribus [4d Js]
Dealt to Budd [6c As]
Dealt to MrWhite [Th 8h]
Dealt to MrOrange [7d 2h]
Pluribus: folds
Budd: folds
MrWhite: raises 125 to 225
MrOrange: folds
Hattori: folds
MrBlue: folds
Uncalled bet (125) returned to MrWhite
MrWhite collected 250.0 from pot
*** SUMMARY ***
Total pot 250 | Rake 0


PokerStars Hand #78148: Hold'em No Limit (50/100) - 2019/07/11 21:42:28 ET
Table 'Pluribus Session 78' 6-max (Play Money) Seat #6 is the button
Seat 1: MrBlue (10000 in chips)
Seat 2: Pluribus (10000 in chips)
Seat 3: Budd (10000 in chips)
Seat 4: MrWhite (10000 in chips)
Seat 5: MrOrange (10000 in chips)
Seat 6: Hattori (10000 in chips)
MrBlue: posts small blind 50
Pluribus: posts big blind 100
*** HOLE CARDS ***
Dealt to MrBlue [Kd Th]
Dealt to Pluribus [5h Jd]
Dealt to Budd [2s 5c]
Dealt to MrWhite [3d As]
Dealt to MrOrange [8h 2c]
Dealt to Hattori [Kc Jh]
Budd: folds
MrWhite: folds
MrOrange: folds
Hattori: raises 125 to 225
MrBlue: calls 175
Pluribus: folds
*** FLOP *** [9c 9h Ah]
MrBlue: checks
Hattori: bets 125
MrBlue: folds
Uncalled bet (125) returned to Hattori
Hattori collected 550.0 from pot
*** SUMMARY ***
Total pot 550 | Rake 0
Board [9c 9h Ah]
