PokerStars Hand #77033: Hold'em No Limit (50/100) - 2019/07/11 21:23:53 ET
Table 'Pluribus Session 77' 6-max (Play Money) Seat #6 is the button
Seat 1: Hattori (10000 in chips)
Seat 2: MrBlue (10000 in chips)
Seat 3: Pluribus (10000 in chips)
Seat 4: Budd (10000 in chips)
Seat 5: MrWhite (10000 in chips)
Seat 6: MrOrange (10000 in chips)
Hattori: posts small blind 50
MrBlue: posts big blind 100
*** HOLE CARDS ***
Dealt to Hattori [8d 5h]
Dealt to MrBlue [6s Ts]
Dealt to Pluribus [4d 9h]
Dealt to Budd [7c 7d]
Dealt to MrWhite [4s Qc]
Dealt to MrOrange [Kh Kc]
Pluribus: folds
Budd: raises 125 to 225
MrWhite: folds
MrOrange: raises 475 to 700
Hattori: folds
MrBlue: folds
Budd: calls 475
*** FLOP *** [4c 2s 7h]
Budd: checks
MrOrange: bets 555
Budd: calls 555
*** TURN *** [4c 2s 7h] [Js]
Budd: checks
MrOrange: bets 1750
Budd: calls 1750
*** RIVER *** [4c 2s 7h] [Js] [2h]
Budd: checks
MrOrange: bets 6995 and is all-in
Budd: calls 6995 and is all-in
*** SHOWDOWN ***
Budd: shows [7c 7d]
Budd collected 20150.0 from pot
*** SUMMARY ***
Total pot 20150 | Rake 0
Board [4c 2s 7h Js 2h]
Seat 4: Budd showed [7c 7d] and won (20150.0)
Seat 6: MrOrange showed [Kh Kc] and lost


PokerStars Hand #77034: Hold'em No Limit (50/100) - 2019/07/11 21:23:54 ET
Table 'Pluribus Session 77' 6-max (Play Money) Seat #6 is the button
Seat 1: MrBlue (10000 in chips)
Seat 2: Pluribus (10000 in chips)
Seat 3: Budd (10000 in chips)
Seat 4: MrWhite (10000 in chips)
Seat 5: MrOrange (10000 in chips)
Seat 6: Hattori (10000 in chips)
MrBlue: posts small blind 50
Pluribus: posts big blind 100
*** HOLE CARDS ***
Dealt to MrBlue [7c 2h]
Dealt to Pluribus [7h 6h]
Dealt to Budd [6s 5d]
Dealt to MrWhite [Js 4d]
Dealt to MrOrange [Ad Jh]
Dealt to Hattori [Jc 3h]
Budd: folds
MrWhite: folds
MrOrange: raises 110 to 210
Hattori: folds
MrBlue: folds
Pluribus: raises 1790 to 2000
MrOrange: folds
Uncalled bet (1790) returned to Pluribus
Pluribus collected 470.0 from pot
*** SUMMARY ***
Total pot 470 | Rake 0


PokerStars Hand #77035: Hold'em No Limit (50/100) - 2019/07/11 21:23:55 ET
Table 'Pluribus Session 77' 6-max (Play Money) Seat #6 is the button
Seat 1: Pluribus (10000 in chips)
Seat 2: Budd (10000 in chips)
Seat 3: MrWhite (10000 in chips)
Seat 4: MrOrange (10000 in chips)
Seat 5: Hattori (10000 in chips)
Seat 6: MrBlue (10000 in chips)
Pluribus: posts small blind 50
Budd: posts big blind 100
*** HOLE CARDS ***
Dealt to Pluribus [Tc 4s]
Dealt to Budd [5c 6d]
Dealt to MrWhite [6h Ah]
Dealt to MrOrange [Kd 7h]
Dealt to Hattori [4c Td]
Dealt to MrBlue [2d 2c]
MrWhite: raises 125 to 225
MrOrange: folds
Hattori: folds
MrBlue: raises 535 to 760
Pluribus: folds
Budd: folds
MrWhite: folds
Uncalled bet (535) returned to MrBlue
MrBlue collected 600.0 from pot
*** SUMMARY ***
Total pot 600 | Rake 0


PokerStars Hand #77036: Hold'em No Limit (50/100) - 2019/07/11 21:23:56 ET
Table 'Pluribus Session 77' 6-max (Play Money) Seat #6 is the button
Seat 1: Budd (10000 in chips)
Seat 2: MrWhite (10000 in chips)
Seat 3: MrOrange (10000 in chips)
Seat 4: Hattori (10000 in chips)
Seat 5: MrBlue (10000 in chips)
Seat 6: Pluribus (10000 in chips)
Budd: posts small blind 50
MrWhite: posts big blind 100
*** HOLE CARDS ***
Dealt to Budd [8d Ks]
Dealt to MrWhite [7s 2h]
Dealt to MrOrange [Jh Kd]
Dealt to Hattori [2d 4s]
Dealt to MrBlue [4c Td]
Dealt to Pluribus [7h Kh]
MrOrange: folds
Hattori: folds
MrBlue: folds
Pluribus: raises 125 to 225
Budd: folds
MrWhite: folds
Uncalled bet (125) returned to Pluribus
Pluribus collected 250.0 from pot
*** SUMMARY ***
Total pot 250 | Rake 0


PokerStars Hand #77037: Hold'em No Limit (50/100) - 2019/07/11 21:23:57 ET
Table 'Pluribus Session 77' 6-max (Play Money) Seat #6 is the button
Seat 1: MrWhite (10000 in chips)
Seat 2: MrOrange (10000 in chips)
Seat 3: Hattori (10000 in chips)
Seat 4: MrBlue (10000 in chips)
Seat 5: Pluribus (10000 in chips)
Seat 6: Budd (10000 in chips)
MrWhite: posts small blind 50
MrOrange: posts big blind 100
*** HOLE CARDS ***
Dealt to MrWhite [4h 3d]
Dealt to MrOrange [9s Tc]
Dealt to Hattori [2h 6s]
Dealt to MrBlue [4s 8s]
Dealt to Pluribus [5d Qh]
Dealt to Budd [8d 3c]
Hattori: folds
MrBlue: folds
Pluribus: folds
Budd: folds
MrWhite: folds
Uncalled bet (50) returned to MrOrange
MrOrange collected 100.0 from pot
*** SUMMARY ***
Total pot 100 | Rake 0


PokerStars Hand #77038: Hold'em No Limit (50/100) - 2019/07/11 21:23:58 ET
Table 'Pluribus Session 77' 6-max (Play Money) Seat #6 is the button
Seat 1: MrOrange (10000 in chips)
Seat 2: Hattori (10000 in chips)
Seat 3: MrBlue (10000 in chips)
Seat 4: Pluribus (10000 in chips)
Seat 5: Budd (10000 in chips)
Seat 6: MrWhite (10000 in chips)
MrOrange: posts small blind 50
Hattori: posts big blind 100
*** HOLE CARDS ***
Dealt to MrOrange [4s Ad]
Dealt to Hattori [3h 6d]
Dealt to MrBlue [9h Jd]
Dealt to Pluribus [7s 7d]
Dealt to Budd [Kh Td]
Dealt to MrWhite [Tc 4d]
MrBlue: folds
Pluribus: raises 100 to 200
Budd: folds
MrWhite: folds
MrOrange: folds
Hattori: folds
Uncalled bet (100) returned to Pluribus
Pluribus collected 250.0 from pot
*** SUMMARY ***
Total pot 250 | Rake 0


PokerStars Hand #77039: Hold'em No Limit (50/100) - 2019/07/11 21:23:59 ET
Table 'Pluribus Session 77' 6-max (Play Money) Seat #6 is the button
Seat 1: Hattori (10000 in chips)
Seat 2: MrBlue (10000 in chips)
Seat 3: Pluribus (10000 in chips)
Seat 4: Budd (10000 in chips)
Seat 5: MrWhite (10000 in chips)
Seat 6: MrOrange (10000 in chips)
Hattori: posts small blind 50
MrBlue: posts big blind 100
*** HOLE CARDS ***
Dealt to Hattori [6h Ac]
Dealt to MrBlue [Ah 7h]
Dealt to Pluribus [4h Tc]
Dealt to Budd [4c 9c]
Dealt to MrWhite [Qh 3s]
Dealt to MrOrange [7d Qc]
Pluribus: folds
Budd: folds
MrWhite: folds
MrOrange: folds
Hattori: raises 135 to 235
MrBlue: calls 135
*** FLOP *** [2c Kd 3c]
Hattori: checks
MrBlue: checks
*** TURN *** [2c Kd 3c] [Jh]
Hattori: checks
MrBlue: checks
*** RIVER *** [2c Kd 3c] [Jh] [Qd]
Hattori: checks
MrBlue: checks
*** SHOWDOWN ***
MrBlue: shows [Ah 7h]
MrBlue collected 470.0 from pot
*** SUMMARY ***
Total pot 470 | Rake 0
Board [2c Kd 3c Jh Qd]
Seat 1: Hattori showed [6h Ac] and lost
Seat 2: MrBlue showed [Ah 7h] and won (470.0)


PokerStars Hand #77040: Hold'em No Limit (50/100) - 2019/07/11 21:24:00 ET
Table 'Pluribus Session 77' 6-max (Play Money) Seat #6 is the button
Seat 1: MrBlue (10000 in chips)
Seat 2: Pluribus (10000 in chips)
Seat 3: Budd (10000 in chips)
Seat 4: MrWhite (10000 in chips)
Seat 5: MrOrange (10000 in chips)
Seat 6: Hattori (10000 in chips)
MrBlue: posts small blind 50
Pluribus: posts big blind 100
*** HOLE CARDS ***
Dealt to MrBlue [9c 7c]
Dealt to Pluribus [Kc 4d]
Dealt to Budd [Js 3d]
Dealt to MrWhite [Qh 4h]
Dealt to MrOrange [8c As]
Dealt to Hattori [8h 3s]
Budd: folds
MrWhite: folds
MrOrange: folds
Hattori: folds
MrBlue: raises 200 to 300
Pluribus: raises 1200 to 1500
MrBlue: folds
Uncalled bet (1200) returned to Pluribus
Pluribus collected 600.0 from pot
*** SUMMARY ***
Total pot 600 | Rake 0


PokerStars Hand #77041: Hold'em No Limit (50/100) - 2019/07/11 21:24:01 ET
Table 'Pluribus Session 77' 6-max (Play Money) Seat #6 is the button
Seat 1: Pluribus (10000 in chips)
Seat 2: Budd (10000 in chips)
Seat 3: MrWhite (10000 in chips)
Seat 4: MrOrange (10000 in chips)
Seat 5: Hattori (10000 in chips)
Seat 6: MrBlue (10000 in chips)
Pluribus: posts small blind 50
Budd: posts big blind 100
*** HOLE CARDS ***
Dealt to Pluribus [4d Qh]
Dealt to Budd [Th 7h]
Dealt to MrWhite [5s 7d]
Dealt to MrOrange [2s Qc]
Dealt to Hattori [Kh 8s]
Dealt to MrBlue [Ks 4h]
MrWhite: folds
MrOrange: folds
Hattori: folds
MrBlue: folds
Pluribus: folds
Uncalled bet (50) returned to Budd
Budd collected 100.0 from pot
*** SUMMARY ***
Total pot 100 | Rake 0


PokerStars Hand #77042: Hold'em No Limit (50/100) - 2019/07/11 21:24:02 ET
Table 'Pluribus Session 77' 6-max (Play Money) Seat #6 is the button
Seat 1: Budd (10000 in chips)
Seat 2: MrWhite (10000 in chips)
Seat 3: MrOrange (10000 in chips)
Seat 4: Hattori (10000 in chips)
Seat 5: MrBlue (10000 in chips)
Seat 6: Pluribus (10000 in chips)
Budd: posts small blind 50
MrWhite: posts big blind 100
*** HOLE CARDS ***
Dealt to Budd [8c 6h]
Dealt to MrWhite [7h Js]
Dealt to MrOrange [Ad Jh]
Dealt to Hattori [9s 2h]
Dealt to MrBlue [Td Ts]
Dealt to Pluribus [5c 3s]
MrOrange: raises 100 to 200
Hattori: folds
MrBlue: calls 200
Pluribus: folds
Budd: folds
MrWhite: calls 100
*** FLOP *** [Qd Kc 9d]
MrWhite: checks
MrOrange: bets 450
MrBlue: calls 450
MrWhite: folds
*** TURN *** [Qd Kc 9d] [Ac]
MrOrange: checks
MrBlue: bets 2350
MrOrange: folds
Uncalled bet (2350) returned to MrBlue
MrBlue collected 1550.0 from pot
*** SUMMARY ***
Total pot 1550 | Rake 0
Board [Qd Kc 9d Ac]


PokerStars Hand #77043: Hold'em No Limit (50/100) - 2019/07/11 21:24:03 ET
Table 'Pluribus Session 77' 6-max (Play Money) Seat #6 is the button
Seat 1: MrWhite (10000 in chips)
Seat 2: MrOrange (10000 in chips)
Seat 3: Hattori (10000 in chips)
Seat 4: MrBlue (10000 in chips)
Seat 5: Pluribus (10000 in chips)
Seat 6: Budd (10000 in chips)
MrWhite: posts small blind 50
MrOrange: posts big blind 100
*** HOLE CARDS ***
Dealt to MrWhite [2h 3c]
Dealt to MrOrange [2d 9d]
Dealt to Hattori [3s 8c]
Dealt to MrBlue [4h Kc]
Dealt to Pluribus [Jh Qd]
Dealt to Budd [6c 7h]
Hattori: folds
MrBlue: folds
Pluribus: raises 100 to 200
Budd: folds
MrWhite: folds
MrOrange: folds
Uncalled bet (100) returned to Pluribus
Pluribus collected 250.0 from pot
*** SUMMARY ***
Total pot 250 | Rake 0


PokerStars Hand #77044: Hold'em No Limit (50/100) - 2019/07/11 21:24:04 ET
Table 'Pluribus Session 77' 6-max (Play Money) Seat #6 is the button
Seat 1: MrOrange (10000 in chips)
Seat 2: Hattori (10000 in chips)
Seat 3: MrBlue (10000 in chips)
Seat 4: Pluribus (10000 in chips)
Seat 5: Budd (10000 in chips)
Seat 6: MrWhite (10000 in chips)
MrOrange: posts small blind 50
Hattori: posts big blind 100
*** HOLE CARDS ***
Dealt to MrOrange [Kc Ks]
Dealt to Hattori [7h Qs]
Dealt to MrBlue [Ah As]
Dealt to Pluribus [6h 8c]
Dealt to Budd [Ts Js]
Dealt to MrWhite [3d 5c]
MrBlue: raises 125 to 225
Pluribus: folds
Budd: calls 225
MrWhite: folds
MrOrange: raises 1125 to 1350
Hattori: folds
MrBlue: raises 1675 to 3025
Budd: folds
MrOrange: raises 6975 to 10000 and is all-in
MrBlue: calls 6975 and is all-in
*** FLOP *** [7s 3c 7c]
*** TURN *** [7s 3c 7c] [5s]
*** RIVER *** [7s 3c 7c] [5s] [Jc]
*** SHOWDOWN ***
MrBlue: shows [Ah As]
MrBlue collected 20325.0 from pot
*** SUMMARY ***
Total pot 20325 | Rake 0
Board [7s 3c 7c 5s Jc]
Seat 1: MrOrange showed [Kc Ks] and lost
Seat 3: MrBlue showed [Ah As] and won (20325.0)


PokerStars Hand #77045: Hold'em No Limit (50/100) - 2019/07/11 21:24:05 ET
Table 'Pluribus Session 77' 6-max (Play Money) Seat #6 is the button
Seat 1: Hattori (10000 in chips)
Seat 2: MrBlue (10000 in chips)
Seat 3: Pluribus (10000 in chips)
Seat 4: Budd (10000 in chips)
Seat 5: MrWhite (10000 in chips)
Seat 6: MrOrange (10000 in chips)
Hattori: posts small blind 50
MrBlue: posts big blind 100
*** HOLE CARDS ***
Dealt to Hattori [6c 6s]
Dealt to MrBlue [2h Th]
Dealt to Pluribus [Ts Ad]
Dealt to Budd [3c 8h]
Dealt to MrWhite [Jc 3d]
Dealt to MrOrange [8s Ks]
Pluribus: raises 100 to 200
Budd: folds
MrWhite: folds
MrOrange: folds
Hattori: calls 150
MrBlue: calls 100
*** FLOP *** [4c 6h 5h]
Hattori: bets 200
MrBlue: calls 200
Pluribus: folds
*** TURN *** [4c 6h 5h] [4s]
Hattori: checks
MrBlue: bets 750
Hattori: calls 750
*** RIVER *** [4c 6h 5h] [4s] [7d]
Hattori: checks
MrBlue: bets 4625
Hattori: raises 4225 to 8850 and is all-in
MrBlue: folds
Uncalled bet (4225) returned to Hattori
Hattori collected 11750.0 from pot
*** SUMMARY ***
Total pot 11750 | Rake 0
Board [4c 6h 5h 4s 7d]


PokerStars Hand #77046: Hold'em No Limit (50/100) - 2019/07/11 21:24:06 ET
Table 'Pluribus Session 77' 6-max (Play Money) Seat #6 is the button
Seat 1: MrBlue (10000 in chips)
Seat 2: Pluribus (10000 in chips)
Seat 3: Budd (10000 in chips)
Seat 4: MrWhite (10000 in chips)
Seat 5: MrOrange (10000 in chips)
Seat 6: Hattori (10000 in chips)
MrBlue: posts small blind 50
Pluribus: posts big blind 100
*** HOLE CARDS ***
Dealt to MrBlue [Ks Qc]
Dealt to Pluribus [4c 4h]
Dealt to Budd [5s 2d]
Dealt to MrWhite [7s Tc]
Dealt to MrOrange [Ts 3h]
Dealt to Hattori [Qd Jc]
Budd: folds
MrWhite: folds
MrOrange: folds
Hattori: raises 111 to 211
MrBlue: calls 161
Pluribus: calls 111
*** FLOP *** [6s 9h 3d]
MrBlue: checks
Pluribus: checks
Hattori: checks
*** TURN *** [6s 9h 3d] [2c]
MrBlue: checks
Pluribus: checks
Hattori: checks
*** RIVER *** [6s 9h 3d] [2c] [7h]
MrBlue: checks
Pluribus: checks
Hattori: checks
*** SHOWDOWN ***
Pluribus: shows [4c 4h]
Pluribus collected 633.0 from pot
*** SUMMARY ***
Total pot 633 | Rake 0
Board [6s 9h 3d 2c 7h]
Seat 1: MrBlue showed [Ks Qc] and lost
Seat 2: Pluribus showed [4c 4h] and won (633.0)
Seat 6: Hattori showed [Qd Jc] and lost


PokerStars Hand #77047: Hold'em No Limit (50/100) - 2019/07/11 21:24:07 ET
Table 'Pluribus Session 77' 6-max (Play Money) Seat #6 is the button
Seat 1: Pluribus (10000 in chips)
Seat 2: Budd (10000 in chips)
Seat 3: MrWhite (10000 in chips)
Seat 4: MrOrange (10000 in chips)
Seat 5: Hattori (10000 in chips)
Seat 6: MrBlue (10000 in chips)
Pluribus: posts small blind 50
Budd: posts big blind 100
*** HOLE CARDS ***
Dealt to Pluribus [6d 9c]
Dealt to Budd [3h 6h]
Dealt to MrWhite [4c 5h]
Dealt to MrOrange [2c Qd]
Dealt to Hattori [Ts Th]
Dealt to MrBlue [9h Qh]
MrWhite: folds
MrOrange: folds
Hattori: raises 111 to 211
MrBlue: calls 211
Pluribus: folds
Budd: calls 111
*** FLOP *** [8h Ac 9d]
Budd: checks
Hattori: checks
MrBlue: bets 325
Budd: folds
Hattori: calls 325
*** TURN *** [8h Ac 9d] [5s]
Hattori: checks
MrBlue: bets 1128
Hattori: folds
Uncalled bet (1128) returned to MrBlue
MrBlue collected 1333.0 from pot
*** SUMMARY ***
Total pot 1333 | Rake 0
Board [8h Ac 9d 5s]


PokerStars Hand #77048: Hold'em No Limit (50/100) - 2019/07/11 21:24:08 ET
Table 'Pluribus Session 77' 6-max (Play Money) Seat #6 is the button
Seat 1: Budd (10000 in chips)
Seat 2: MrWhite (10000 in chips)
Seat 3: MrOrange (10000 in chips)
Seat 4: Hattori (10000 in chips)
Seat 5: MrBlue (10000 in chips)
Seat 6: Pluribus (10000 in chips)
Budd: posts small blind 50
MrWhite: posts big blind 100
*** HOLE CARDS ***
Dealt to Budd [4h 9s]
Dealt to MrWhite [8c Ac]
Dealt to MrOrange [Kh As]
Dealt to Hattori [6s 2c]
Dealt to MrBlue [8s Jh]
Dealt to Pluribus [2d 4s]
MrOrange: raises 100 to 200
Hattori: folds
MrBlue: folds
Pluribus: folds
Budd: folds
MrWhite: calls 100
*** FLOP *** [3s 3c Tc]
MrWhite: checks
MrOrange: checks
*** TURN *** [3s 3c Tc] [7s]
MrWhite: checks
MrOrange: checks
*** RIVER *** [3s 3c Tc] [7s] [5d]
MrWhite: checks
MrOrange: checks
*** SHOWDOWN ***
MrOrange: shows [Kh As]
MrOrange collected 450.0 from pot
*** SUMMARY ***
Total pot 450 | Rake 0
Board [3s 3c Tc 7s 5d]
Seat 2: MrWhite showed [8c Ac] and lost
Seat 3: MrOrange showed [Kh As] and won (450.0)


PokerStars Hand #77049: Hold'em No Limit (50/100) - 2019/07/11 21:24:09 ET
Table 'Pluribus Session 77' 6-max (Play Money) Seat #6 is the button
Seat 1: MrWhite (10000 in chips)
Seat 2: MrOrange (10000 in chips)
Seat 3: Hattori (10000 in chips)
Seat 4: MrBlue (10000 in chips)
Seat 5: Pluribus (10000 in chips)
Seat 6: Budd (10000 in chips)
MrWhite: posts small blind 50
MrOrange: posts big blind 100
*** HOLE CARDS ***
Dealt to MrWhite [Js Jc]
Dealt to MrOrange [As 7c]
Dealt to Hattori [8h 6c]
Dealt to MrBlue [Th Qh]
Dealt to Pluribus [Jd 4d]
Dealt to Budd [Tc Ah]
Hattori: folds
MrBlue: raises 125 to 225
Pluribus: folds
Budd: folds
MrWhite: raises 550 to 775
MrOrange: folds
MrBlue: calls 550
*** FLOP *** [2c 9s Ac]
MrWhite: checks
MrBlue: checks
*** TURN *** [2c 9s Ac] [4c]
MrWhite: checks
MrBlue: bets 1237
MrWhite: calls 1237
*** RIVER *** [2c 9s Ac] [4c] [3d]
MrWhite: checks
MrBlue: bets 3125
MrWhite: folds
Uncalled bet (3125) returned to MrBlue
MrBlue collected 4124.0 from pot
*** SUMMARY ***
Total pot 4124 | Rake 0
Board [2c 9s Ac 4c 3d]


PokerStars Hand #77050: Hold'em No Limit (50/100) - 2019/07/11 21:24:10 ET
Table 'Pluribus Session 77' 6-max (Play Money) Seat #6 is the button
Seat 1: MrOrange (10000 in chips)
Seat 2: Hattori (10000 in chips)
Seat 3: MrBlue (10000 in chips)
Seat 4: Pluribus (10000 in chips)
Seat 5: Budd (10000 in chips)
Seat 6: MrWhite (10000 in chips)
MrOrange: posts small blind 50
Hattori: posts big blind 100
*** HOLE CARDS ***
Dealt to MrOrange [Qd Qh]
Dealt to Hattori [2s 4s]
Dealt to MrBlue [7c Kh]
Dealt to Pluribus [Tc Kd]
Dealt to Budd [3d 2c]
Dealt to MrWhite [9c As]
MrBlue: folds
Pluribus: folds
Budd: folds
MrWhite: raises 125 to 225
MrOrange: raises 875 to 1100
Hattori: folds
MrWhite: folds
Uncalled bet (875) returned to MrOrange
MrOrange collected 550.0 from pot
*** SUMMARY ***
Total pot 550 | Rake 0


PokerStars Hand #77051: Hold'em No Limit (50/100) - 2019/07/11 21:24:11 ET
Table 'Pluribus Session 77' 6-max (Play Money) Seat #6 is the button
Seat 1: Hattori (10000 in chips)
Seat 2: MrBlue (10000 in chips)
Seat 3: Pluribus (10000 in chips)
Seat 4: Budd (10000 in chips)
Seat 5: MrWhite (10000 in chips)
Seat 6: MrOrange (10000 in chips)
Hattori: posts small blind 50
MrBlue: posts big blind 100
*** HOLE CARDS ***
Dealt to Hattori [6d Ts]
Dealt to MrBlue [8c Jd]
Dealt to Pluribus [Td 4h]
Dealt to Budd [Qh 5c]
Dealt to MrWhite [Kc 3s]
Dealt to MrOrange [7d Qd]
Pluribus: folds
Budd: folds
MrWhite: folds
MrOrange: folds
Hattori: folds
Uncalled bet (50) returned to MrBlue
MrBlue collected 100.0 from pot
*** SUMMARY ***
Total pot 100 | Rake 0


PokerStars Hand #77052: Hold'em No Limit (50/100) - 2019/07/11 21:24:12 ET
Table 'Pluribus Session 77' 6-max (Play Money) Seat #6 is the button
Seat 1: MrBlue (10000 in chips)
Seat 2: Pluribus (10000 in chips)
Seat 3: Budd (10000 in chips)
Seat 4: MrWhite (10000 in chips)
Seat 5: MrOrange (10000 in chips)
Seat 6: Hattori (10000 in chips)
MrBlue: posts small blind 50
Pluribus: posts big blind 100
*** HOLE CARDS ***
Dealt to MrBlue [6c 9c]
Dealt to Pluribus [Tc 8h]
Dealt to Budd [2c 4c]
Dealt to MrWhite [Th 6h]
Dealt to MrOrange [As 8s]
Dealt to Hattori [2h 5c]
Budd: folds
MrWhite: folds
MrOrange: raises 110 to 210
Hattori: folds
MrBlue: folds
Pluribus: calls 110
*** FLOP *** [8c 4h Qh]
Pluribus: checks
MrOrange: bets 150
Pluribus: calls 150
*** TURN *** [8c 4h Qh] [Ad]
Pluribus: checks
MrOrange: bets 1100
Pluribus: folds
Uncalled bet (1100) returned to MrOrange
MrOrange collected 770.0 from pot
*** SUMMARY ***
Total pot 770 | Rake 0
Board [8c 4h Qh Ad]


PokerStars Hand #77053: Hold'em No Limit (50/100) - 2019/07/11 21:24:13 ET
Table 'Pluribus Session 77' 6-max (Play Money) Seat #6 is the button
Seat 1: Pluribus (10000 in chips)
Seat 2: Budd (10000 in chips)
Seat 3: MrWhite (10000 in chips)
Seat 4: MrOrange (10000 in chips)
Seat 5: Hattori (10000 in chips)
Seat 6: MrBlue (10000 in chips)
Pluribus: posts small blind 50
Budd: posts big blind 100
*** HOLE CARDS ***
Dealt to Pluribus [7s 6c]
Dealt to Budd [Jd Td]
Dealt to MrWhite [8c 5s]
Dealt to MrOrange [6h 4d]
Dealt to Hattori [6d 7d]
Dealt to MrBlue [8d Kh]
MrWhite: folds
MrOrange: folds
Hattori: raises 111 to 211
MrBlue: folds
Pluribus: folds
Budd: calls 111
*** FLOP *** [2c 3h Jh]
Budd: checks
Hattori: bets 125
Budd: raises 325 to 450
Hattori: folds
Uncalled bet (325) returned to Budd
Budd collected 722.0 from pot
*** SUMMARY ***
Total pot 722 | Rake 0
Board [2c 3h Jh]


PokerStars Hand #77054: Hold'em No Limit (50/100) - 2019/07/11 21:24:14 ET
Table 'Pluribus Session 77' 6-max (Play Money) Seat #6 is the button
Seat 1: Budd (10000 in chips)
Seat 2: MrWhite (10000 in chips)
Seat 3: MrOrange (10000 in chips)
Seat 4: Hattori (10000 in chips)
Seat 5: MrBlue (10000 in chips)
Seat 6: Pluribus (10000 in chips)
Budd: posts small blind 50
MrWhite: posts big blind 100
*** HOLE CARDS ***
Dealt to Budd [9s 3d]
Dealt to MrWhite [4h Th]
Dealt to MrOrange [7d Jc]
Dealt to Hattori [Ks 7c]
Dealt to MrBlue [Tc Ts]
Dealt to Pluribus [6h 8d]
MrOrange: folds
Hattori: folds
MrBlue: raises 125 to 225
Pluribus: folds
Budd: folds
MrWhite: calls 125
*** FLOP *** [4c 5c 2d]
MrWhite: checks
MrBlue: bets 375
MrWhite: folds
Uncalled bet (375) returned to MrBlue
MrBlue collected 500.0 from pot
*** SUMMARY ***
Total pot 500 | Rake 0
Board [4c 5c 2d]


PokerStars Hand #77055: Hold'em No Limit (50/100) - 2019/07/11 21:24:15 ET
Table 'Pluribus Session 77' 6-max (Play Money) Seat #6 is the button
Seat 1: MrWhite (10000 in chips)
Seat 2: MrOrange (10000 in chips)
Seat 3: Hattori (10000 in chips)
Seat 4: MrBlue (10000 in chips)
Seat 5: Pluribus (10000 in chips)
Seat 6: Budd (10000 in chips)
MrWhite: posts small blind 50
MrOrange: posts big blind 100
*** HOLE CARDS ***
Dealt to MrWhite [2s As]
Dealt to MrOrange [8c Td]
Dealt to Hattori [Ks 9h]
Dealt to MrBlue [7h 4c]
Dealt to Pluribus [Qh 9s]
Dealt to Budd [Qs 4s]
Hattori: folds
MrBlue: folds
Pluribus: folds
Budd: raises 150 to 250
MrWhite: raises 600 to 850
MrOrange: folds
Budd: folds
Uncalled bet (600) returned to MrWhite
MrWhite collected 600.0 from pot
*** SUMMARY ***
Total pot 600 | Rake 0


PokerStars Hand #77056: Hold'em No Limit (50/100) - 2019/07/11 21:24:16 ET
Table 'Pluribus Session 77' 6-max (Play Money) Seat #6 is the button
Seat 1: MrOrange (10000 in chips)
Seat 2: Hattori (10000 in chips)
Seat 3: MrBlue (10000 in chips)
Seat 4: Pluribus (10000 in chips)
Seat 5: Budd (10000 in chips)
Seat 6: MrWhite (10000 in chips)
MrOrange: posts small blind 50
Hattori: posts big blind 100
*** HOLE CARDS ***
Dealt to MrOrange [Ac 4d]
Dealt to Hattori [9h 2s]
Dealt to MrBlue [6s 7d]
Dealt to Pluribus [Qc 3h]
Dealt to Budd [7s 5h]
Dealt to MrWhite [Qs 5c]
MrBlue: folds
Pluribus: folds
Budd: folds
MrWhite: folds
MrOrange: raises 150 to 250
Hattori: folds
Uncalled bet (150) returned to MrOrange
MrOrange collected 200.0 from pot
*** SUMMARY ***
Total pot 200 | Rake 0


PokerStars Hand #77057: Hold'em No Limit (50/100) - 2019/07/11 21:24:17 ET
Table 'Pluribus Session 77' 6-max (Play Money) Seat #6 is the button
Seat 1: Hattori (10000 in chips)
Seat 2: MrBlue (10000 in chips)
Seat 3: Pluribus (10000 in chips)
Seat 4: Budd (10000 in chips)
Seat 5: MrWhite (10000 in chips)
Seat 6: MrOrange (10000 in chips)
Hattori: posts small blind 50
MrBlue: posts big blind 100
*** HOLE CARDS ***
Dealt to Hattori [2h 3h]
Dealt to MrBlue [8h Qh]
Dealt to Pluribus [Th Tc]
Dealt to Budd [Kd 8d]
Dealt to MrWhite [5c 6s]
Dealt to MrOrange [8s 5s]
Pluribus: raises 100 to 200
Budd: folds
MrWhite: folds
MrOrange: folds
Hattori: folds
MrBlue: calls 100
*** FLOP *** [4c 6c Jd]
MrBlue: checks
Pluribus: bets 225
MrBlue: folds
Uncalled bet (225) returned to Pluribus
Pluribus collected 450.0 from pot
*** SUMMARY ***
Total pot 450 | Rake 0
Board [4c 6c Jd]


PokerStars Hand #77058: Hold'em No Limit (50/100) - 2019/07/11 21:24:18 ET
Table 'Pluribus Session 77' 6-max (Play Money) Seat #6 is the button
Seat 1: MrBlue (10000 in chips)
Seat 2: Pluribus (10000 in chips)
Seat 3: Budd (10000 in chips)
Seat 4: MrWhite (10000 in chips)
Seat 5: MrOrange (10000 in chips)
Seat 6: Hattori (10000 in chips)
MrBlue: posts small blind 50
Pluribus: posts big blind 100
*** HOLE CARDS ***
Dealt to MrBlue [Ks 3h]
Dealt to Pluribus [9s Jd]
Dealt to Budd [2s Ac]
Dealt to MrWhite [Kd 5d]
Dealt to MrOrange [9d 6s]
Dealt to Hattori [6h Ts]
Budd: folds
MrWhite: folds
MrOrange: folds
Hattori: folds
MrBlue: raises 200 to 300
Pluribus: raises 525 to 825
MrBlue: folds
Uncalled bet (525) returned to Pluribus
Pluribus collected 600.0 from pot
*** SUMMARY ***
Total pot 600 | Rake 0


PokerStars Hand #77059: Hold'em No Limit (50/100) - 2019/07/11 21:24:19 ET
Table 'Pluribus Session 77' 6-max (Play Money) Seat #6 is the button
Seat 1: Pluribus (10000 in chips)
Seat 2: Budd (10000 in chips)
Seat 3: MrWhite (10000 in chips)
Seat 4: MrOrange (10000 in chips)
Seat 5: Hattori (10000 in chips)
Seat 6: MrBlue (10000 in chips)
Pluribus: posts small blind 50
Budd: posts big blind 100
*** HOLE CARDS ***
Dealt to Pluribus [3h 9c]
Dealt to Budd [Th 6c]
Dealt to MrWhite [Jc 6s]
Dealt to MrOrange [6h Jh]
Dealt to Hattori [4h 7s]
Dealt to MrBlue [5c 7c]
MrWhite: folds
MrOrange: folds
Hattori: folds
MrBlue: raises 125 to 225
Pluribus: folds
Budd: folds
Uncalled bet (125) returned to MrBlue
MrBlue collected 250.0 from pot
*** SUMMARY ***
Total pot 250 | Rake 0


PokerStars Hand #77060: Hold'em No Limit (50/100) - 2019/07/11 21:24:20 ET
Table 'Pluribus Session 77' 6-max (Play Money) Seat #6 is the button
Seat 1: Budd (10000 in chips)
Seat 2: MrWhite (10000 in chips)
Seat 3: MrOrange (10000 in chips)
Seat 4: Hattori (10000 in chips)
Seat 5: MrBlue (10000 in chips)
Seat 6: Pluribus (10000 in chips)
Budd: posts small blind 50
MrWhite: posts big blind 100
*** HOLE CARDS ***
Dealt to Budd [5h 8h]
Dealt to MrWhite [Th Qh]
Dealt to MrOrange [7s Ad]
Dealt to Hattori [6h 8s]
Dealt to MrBlue [2d Qd]
Dealt to Pluribus [Ah 4h]
MrOrange: folds
Hattori: folds
MrBlue: raises 125 to 225
Pluribus: raises 525 to 750
Budd: folds
MrWhite: calls 650
MrBlue: calls 525
*** FLOP *** [3c 5s Qc]
MrWhite: checks
MrBlue: checks
Pluribus: checks
*** TURN *** [3c 5s Qc] [7h]
MrWhite: checks
MrBlue: checks
Pluribus: checks
*** RIVER *** [3c 5s Qc] [7h] [Kh]
MrWhite: checks
MrBlue: checks
Pluribus: bets 1150
MrWhite: folds
MrBlue: calls 1150
*** SHOWDOWN ***
MrBlue: shows [2d Qd]
MrBlue collected 4600.0 from pot
*** SUMMARY ***
Total pot 4600 | Rake 0
Board [3c 5s Qc 7h Kh]
Seat 5: MrBlue showed [2d Qd] and won (4600.0)
Seat 6: Pluribus showed [Ah 4h] and lost


PokerStars Hand #77061: Hold'em No Limit (50/100) - 2019/07/11 21:24:21 ET
Table 'Pluribus Session 77' 6-max (Play Money) Seat #6 is the button
Seat 1: MrWhite (10000 in chips)
Seat 2: MrOrange (10000 in chips)
Seat 3: Hattori (10000 in chips)
Seat 4: MrBlue (10000 in chips)
Seat 5: Pluribus (10000 in chips)
Seat 6: Budd (10000 in chips)
MrWhite: posts small blind 50
MrOrange: posts big blind 100
*** HOLE CARDS ***
Dealt to MrWhite [Js Kh]
Dealt to MrOrange [Qh Ah]
Dealt to Hattori [Ts 5h]
Dealt to MrBlue [Kd 8c]
Dealt to Pluribus [7d 2h]
Dealt to Budd [7c Tc]
Hattori: folds
MrBlue: folds
Pluribus: folds
Budd: raises 150 to 250
MrWhite: folds
MrOrange: raises 950 to 1200
Budd: folds
Uncalled bet (950) returned to MrOrange
MrOrange collected 550.0 from pot
*** SUMMARY ***
Total pot 550 | Rake 0


PokerStars Hand #77062: Hold'em No Limit (50/100) - 2019/07/11 21:24:22 ET
Table 'Pluribus Session 77' 6-max (Play Money) Seat #6 is the button
Seat 1: MrOrange (10000 in chips)
Seat 2: Hattori (10000 in chips)
Seat 3: MrBlue (10000 in chips)
Seat 4: Pluribus (10000 in chips)
Seat 5: Budd (10000 in chips)
Seat 6: MrWhite (10000 in chips)
MrOrange: posts small blind 50
Hattori: posts big blind 100
*** HOLE CARDS ***
Dealt to MrOrange [3h Qh]
Dealt to Hattori [5h Kc]
Dealt to MrBlue [8d As]
Dealt to Pluribus [4d 3d]
Dealt to Budd [9d 7h]
Dealt to MrWhite [8c Kh]
MrBlue: folds
Pluribus: folds
Budd: folds
MrWhite: folds
MrOrange: raises 150 to 250
Hattori: calls 150
*** FLOP *** [5s 7c Th]
MrOrange: checks
Hattori: checks
*** TURN *** [5s 7c Th] [Js]
MrOrange: checks
Hattori: checks
*** RIVER *** [5s 7c Th] [Js] [8h]
MrOrange: bets 335
Hattori: folds
Uncalled bet (335) returned to MrOrange
MrOrange collected 500.0 from pot
*** SUMMARY ***
Total pot 500 | Rake 0
Board [5s 7c Th Js 8h]


PokerStars Hand #77063: Hold'em No Limit (50/100) - 2019/07/11 21:24:23 ET
Table 'Pluribus Session 77' 6-max (Play Money) Seat #6 is the button
Seat 1: Hattori (10000 in chips)
Seat 2: MrBlue (10000 in chips)
Seat 3: Pluribus (10000 in chips)
Seat 4: Budd (10000 in chips)
Seat 5: MrWhite (10000 in chips)
Seat 6: MrOrange (10000 in chips)
Hattori: posts small blind 50
MrBlue: posts big blind 100
*** HOLE CARDS ***
Dealt to Hattori [Th 6d]
Dealt to MrBlue [6c Ks]
Dealt to Pluribus [6s 7s]
Dealt to Budd [8s 7h]
Dealt to MrWhite [9d 5c]
Dealt to MrOrange [2s 7c]
Pluribus: raises 100 to 200
Budd: folds
MrWhite: folds
MrOrange: folds
Hattori: folds
MrBlue: calls 100
*** FLOP *** [4d As Jd]
MrBlue: checks
Pluribus: bets 900
MrBlue: folds
Uncalled bet (900) returned to Pluribus
Pluribus collected 450.0 from pot
*** SUMMARY ***
Total pot 450 | Rake 0
Board [4d As Jd]


PokerStars Hand #77064: Hold'em No Limit (50/100) - 2019/07/11 21:24:24 ET
Table 'Pluribus Session 77' 6-max (Play Money) Seat #6 is the button
Seat 1: MrBlue (10000 in chips)
Seat 2: Pluribus (10000 in chips)
Seat 3: Budd (10000 in chips)
Seat 4: MrWhite (10000 in chips)
Seat 5: MrOrange (10000 in chips)
Seat 6: Hattori (10000 in chips)
MrBlue: posts small blind 50
Pluribus: posts big blind 100
*** HOLE CARDS ***
Dealt to MrBlue [Qh Ah]
Dealt to Pluribus [8h 3s]
Dealt to Budd [6c Kc]
Dealt to MrWhite [6h 7d]
Dealt to MrOrange [6d 2h]
Dealt to Hattori [8s 7s]
Budd: folds
MrWhite: folds
MrOrange: folds
Hattori: raises 125 to 225
MrBlue: raises 850 to 1075
Pluribus: folds
Hattori: calls 850
*** FLOP *** [Jh Ac 3d]
MrBlue: bets 808
Hattori: folds
Uncalled bet (808) returned to MrBlue
MrBlue collected 2250.0 from pot
*** SUMMARY ***
Total pot 2250 | Rake 0
Board [Jh Ac 3d]


PokerStars Hand #77065: Hold'em No Limit (50/100) - 2019/07/11 21:24:25 ET
Table 'Pluribus Session 77' 6-max (Play Money) Seat #6 is the button
Seat 1: Pluribus (10000 in chips)
Seat 2: Budd (10000 in chips)
Seat 3: MrWhite (10000 in chips)
Seat 4: MrOrange (10000 in chips)
Seat 5: Hattori (10000 in chips)
Seat 6: MrBlue (10000 in chips)
Pluribus: posts small blind 50
Budd: posts big blind 100
*** HOLE CARDS ***
Dealt to Pluribus [2d 2c]
Dealt to Budd [8h 5h]
Dealt to MrWhite [5c 9c]
Dealt to MrOrange [7s 7c]
Dealt to Hattori [9s 8c]
Dealt to MrBlue [3h Ac]
MrWhite: folds
MrOrange: raises 110 to 210
Hattori: folds
MrBlue: folds
Pluribus: calls 160
Budd: calls 110
*** FLOP *** [7h Kc Kd]
Pluribus: checks
Budd: checks
MrOrange: bets 222
Pluribus: calls 222
Budd: folds
*** TURN *** [7h Kc Kd] [Ad]
Pluribus: checks
MrOrange: bets 1555
Pluribus: folds
Uncalled bet (1555) returned to MrOrange
MrOrange collected 1074.0 from pot
*** SUMMARY ***
Total pot 1074 | Rake 0
Board [7h Kc Kd Ad]


PokerStars Hand #77066: Hold'em No Limit (50/100) - 2019/07/11 21:24:26 ET
Table 'Pluribus Session 77' 6-max (Play Money) Seat #6 is the button
Seat 1: Budd (10000 in chips)
Seat 2: MrWhite (10000 in chips)
Seat 3: MrOrange (10000 in chips)
Seat 4: Hattori (10000 in chips)
Seat 5: MrBlue (10000 in chips)
Seat 6: Pluribus (10000 in chips)
Budd: posts small blind 50
MrWhite: posts big blind 100
*** HOLE CARDS ***
Dealt to Budd [Kd Kh]
Dealt to MrWhite [2h Jd]
Dealt to MrOrange [5d 8h]
Dealt to Hattori [7h 8s]
Dealt to MrBlue [Jc As]
Dealt to Pluribus [3d 5s]
MrOrange: folds
Hattori: folds
MrBlue: raises 125 to 225
Pluribus: folds
Budd: raises 675 to 900
MrWhite: folds
MrBlue: folds
Uncalled bet (675) returned to Budd
Budd collected 550.0 from pot
*** SUMMARY ***
Total pot 550 | Rake 0


PokerStars Hand #77067: Hold'em No Limit (50/100) - 2019/07/11 21:24:27 ET
Table 'Pluribus Session 77' 6-max (Play Money) Seat #6 is the button
Seat 1: MrWhite (10000 in chips)
Seat 2: MrOrange (10000 in chips)
Seat 3: Hattori (10000 in chips)
Seat 4: MrBlue (10000 in chips)
Seat 5: Pluribus (10000 in chips)
Seat 6: Budd (10000 in chips)
MrWhite: posts small blind 50
MrOrange: posts big blind 100
*** HOLE CARDS ***
Dealt to MrWhite [5d 8s]
Dealt to MrOrange [3h 3s]
Dealt to Hattori [Kc 4c]
Dealt to MrBlue [3c 8h]
Dealt to Pluribus [2c 5s]
Dealt to Budd [Qh Qs]
Hattori: folds
MrBlue: folds
Pluribus: folds
Budd: raises 150 to 250
MrWhite: folds
MrOrange: calls 150
*** FLOP *** [7h Js 8d]
MrOrange: checks
Budd: checks
*** TURN *** [7h Js 8d] [Ks]
MrOrange: checks
Budd: checks
*** RIVER *** [7h Js 8d] [Ks] [6d]
MrOrange: checks
Budd: bets 550
MrOrange: folds
Uncalled bet (550) returned to Budd
Budd collected 550.0 from pot
*** SUMMARY ***
Total pot 550 | Rake 0
Board [7h Js 8d Ks 6d]


PokerStars Hand #77068: Hold'em No Limit (50/100) - 2019/07/11 21:24:28 ET
Table 'Pluribus Session 77' 6-max (Play Money) Seat #6 is the button
Seat 1: MrOrange (10000 in chips)
Seat 2: Hattori (10000 in chips)
Seat 3: MrBlue (10000 in chips)
Seat 4: Pluribus (10000 in chips)
Seat 5: Budd (10000 in chips)
Seat 6: MrWhite (10000 in chips)
MrOrange: posts small blind 50
Hattori: posts big blind 100
*** HOLE CARDS ***
Dealt to MrOrange [2d 6d]
Dealt to Hattori [4c 4d]
Dealt to MrBlue [Qh 3c]
Dealt to Pluribus [5c 4s]
Dealt to Budd [Js Kd]
Dealt to MrWhite [3s As]
MrBlue: folds
Pluribus: folds
Budd: raises 125 to 225
MrWhite: raises 450 to 675
MrOrange: folds
Hattori: folds
Budd: folds
Uncalled bet (450) returned to MrWhite
MrWhite collected 600.0 from pot
*** SUMMARY ***
Total pot 600 | Rake 0


PokerStars Hand #77069: Hold'em No Limit (50/100) - 2019/07/11 21:24:29 ET
Table 'Pluribus Session 77' 6-max (Play Money) Seat #6 is the button
Seat 1: Hattori (10000 in chips)
Seat 2: MrBlue (10000 in chips)
Seat 3: Pluribus (10000 in chips)
Seat 4: Budd (10000 in chips)
Seat 5: MrWhite (10000 in chips)
Seat 6: MrOrange (10000 in chips)
Hattori: posts small blind 50
MrBlue: posts big blind 100
*** HOLE CARDS ***
Dealt to Hattori [2c 5s]
Dealt to MrBlue [Ad 4c]
Dealt to Pluribus [9h Qs]
Dealt to Budd [2d 9s]
Dealt to MrWhite [Jd Jh]
Dealt to MrOrange [5h As]
Pluribus: folds
Budd: folds
MrWhite: raises 125 to 225
MrOrange: folds
Hattori: folds
MrBlue: calls 125
*** FLOP *** [4d 6c 7c]
MrBlue: checks
MrWhite: bets 375
MrBlue: calls 375
*** TURN *** [4d 6c 7c] [8c]
MrBlue: checks
MrWhite: checks
*** RIVER *** [4d 6c 7c] [8c] [Kd]
MrBlue: bets 1085
MrWhite: folds
Uncalled bet (1085) returned to MrBlue
MrBlue collected 1250.0 from pot
*** SUMMARY ***
Total pot 1250 | Rake 0
Board [4d 6c 7c 8c Kd]


PokerStars Hand #77070: Hold'em No Limit (50/100) - 2019/07/11 21:24:30 ET
Table 'Pluribus Session 77' 6-max (Play Money) Seat #6 is the button
Seat 1: MrBlue (10000 in chips)
Seat 2: Pluribus (10000 in chips)
Seat 3: Budd (10000 in chips)
Seat 4: MrWhite (10000 in chips)
Seat 5: MrOrange (10000 in chips)
Seat 6: Hattori (10000 in chips)
MrBlue: posts small blind 50
Pluribus: posts big blind 100
*** HOLE CARDS ***
Dealt to MrBlue [6s 9c]
Dealt to Pluribus [8c 9h]
Dealt to Budd [Qs 9s]
Dealt to MrWhite [5d 4d]
Dealt to MrOrange [Jh Ad]
Dealt to Hattori [Kh 2d]
Budd: raises 125 to 225
MrWhite: folds
MrOrange: folds
Hattori: folds
MrBlue: folds
Pluribus: folds
Uncalled bet (125) returned to Budd
Budd collected 250.0 from pot
*** SUMMARY ***
Total pot 250 | Rake 0


PokerStars Hand #77071: Hold'em No Limit (50/100) - 2019/07/11 21:24:31 ET
Table 'Pluribus Session 77' 6-max (Play Money) Seat #6 is the button
Seat 1: Pluribus (10000 in chips)
Seat 2: Budd (10000 in chips)
Seat 3: MrWhite (10000 in chips)
Seat 4: MrOrange (10000 in chips)
Seat 5: Hattori (10000 in chips)
Seat 6: MrBlue (10000 in chips)
Pluribus: posts small blind 50
Budd: posts big blind 100
*** HOLE CARDS ***
Dealt to Pluribus [Kd 9d]
Dealt to Budd [3d 8s]
Dealt to MrWhite [Kh 9s]
Dealt to MrOrange [9h 4c]
Dealt to Hattori [4d Jd]
Dealt to MrBlue [5c 3s]
MrWhite: folds
MrOrange: folds
Hattori: folds
MrBlue: folds
Pluribus: raises 100 to 200
Budd: folds
Uncalled bet (100) returned to Pluribus
Pluribus collected 200.0 from pot
*** SUMMARY ***
Total pot 200 | Rake 0


PokerStars Hand #77072: Hold'em No Limit (50/100) - 2019/07/11 21:24:32 ET
Table 'Pluribus Session 77' 6-max (Play Money) Seat #6 is the button
Seat 1: Budd (10000 in chips)
Seat 2: MrWhite (10000 in chips)
Seat 3: MrOrange (10000 in chips)
Seat 4: Hattori (10000 in chips)
Seat 5: MrBlue (10000 in chips)
Seat 6: Pluribus (10000 in chips)
Budd: posts small blind 50
MrWhite: posts big blind 100
*** HOLE CARDS ***
Dealt to Budd [4h Ah]
Dealt to MrWhite [Ac Td]
Dealt to MrOrange [9h 9s]
Dealt to Hattori [2d 5s]
Dealt to MrBlue [4s 7c]
Dealt to Pluribus [Qd Ts]
MrOrange: raises 100 to 200
Hattori: folds
MrBlue: folds
Pluribus: folds
Budd: folds
MrWhite: calls 100
*** FLOP *** [Kh Kc 6h]
MrWhite: checks
MrOrange: bets 150
MrWhite: calls 150
*** TURN *** [Kh Kc 6h] [4d]
MrWhite: checks
MrOrange: bets 444
MrWhite: folds
Uncalled bet (444) returned to MrOrange
MrOrange collected 750.0 from pot
*** SUMMARY ***
Total pot 750 | Rake 0
Board [Kh Kc 6h 4d]


PokerStars Hand #77073: Hold'em No Limit (50/100) - 2019/07/11 21:24:33 ET
Table 'Pluribus Session 77' 6-max (Play Money) Seat #6 is the button
Seat 1: MrWhite (10000 in chips)
Seat 2: MrOrange (10000 in chips)
Seat 3: Hattori (10000 in chips)
Seat 4: MrBlue (10000 in chips)
Seat 5: Pluribus (10000 in chips)
Seat 6: Budd (10000 in chips)
MrWhite: posts small blind 50
MrOrange: posts big blind 100
*** HOLE CARDS ***
Dealt to MrWhite [6d 6h]
Dealt to MrOrange [Qs Ac]
Dealt to Hattori [Ah 4d]
Dealt to MrBlue [Qd 2d]
Dealt to Pluribus [2h Js]
Dealt to Budd [8d 9s]
Hattori: folds
MrBlue: folds
Pluribus: folds
Budd: raises 150 to 250
MrWhite: calls 200
MrOrange: raises 1100 to 1350
Budd: folds
MrWhite: folds
Uncalled bet (1100) returned to MrOrange
MrOrange collected 750.0 from pot
*** SUMMARY ***
Total pot 750 | Rake 0


PokerStars Hand #77074: Hold'em No Limit (50/100) - 2019/07/11 21:24:34 ET
Table 'Pluribus Session 77' 6-max (Play Money) Seat #6 is the button
Seat 1: MrOrange (10000 in chips)
Seat 2: Hattori (10000 in chips)
Seat 3: MrBlue (10000 in chips)
Seat 4: Pluribus (10000 in chips)
Seat 5: Budd (10000 in chips)
Seat 6: MrWhite (10000 in chips)
MrOrange: posts small blind 50
Hattori: posts big blind 100
*** HOLE CARDS ***
Dealt to MrOrange [Kc 7h]
Dealt to Hattori [6s Jh]
Dealt to MrBlue [9c 5c]
Dealt to Pluribus [Kh 9d]
Dealt to Budd [Td Ac]
Dealt to MrWhite [3s 6h]
MrBlue: folds
Pluribus: folds
Budd: raises 125 to 225
MrWhite: folds
MrOrange: folds
Hattori: folds
Uncalled bet (125) returned to Budd
Budd collected 250.0 from pot
*** SUMMARY ***
Total pot 250 | Rake 0


PokerStars Hand #77075: Hold'em No Limit (50/100) - 2019/07/11 21:24:35 ET
Table 'Pluribus Session 77' 6-max (Play Money) Seat #6 is the button
Seat 1: Hattori (10000 in chips)
Seat 2: MrBlue (10000 in chips)
Seat 3: Pluribus (10000 in chips)
Seat 4: Budd (10000 in chips)
Seat 5: MrWhite (10000 in chips)
Seat 6: MrOrange (10000 in chips)
Hattori: posts small blind 50
MrBlue: posts big blind 100
*** HOLE CARDS ***
Dealt to Hattori [Ad 7s]
Dealt to MrBlue [8d 3c]
Dealt to Pluribus [Ac Ah]
Dealt to Budd [4d Kh]
Dealt to MrWhite [5c 9h]
Dealt to MrOrange [Tc Th]
Pluribus: raises 187 to 287
Budd: folds
MrWhite: folds
MrOrange: calls 287
Hattori: folds
MrBlue: folds
*** FLOP *** [5d As 8c]
Pluribus: checks
MrOrange: checks
*** TURN *** [5d As 8c] [Qh]
Pluribus: checks
MrOrange: checks
*** RIVER *** [5d As 8c] [Qh] [3s]
Pluribus: checks
MrOrange: checks
*** SHOWDOWN ***
Pluribus: shows [Ac Ah]
Pluribus collected 724.0 from pot
*** SUMMARY ***
Total pot 724 | Rake 0
Board [5d As 8c Qh 3s]
Seat 3: Pluribus showed [Ac Ah] and won (724.0)
Seat 6: MrOrange showed [Tc Th] and lost


PokerStars Hand #77076: Hold'em No Limit (50/100) - 2019/07/11 21:24:36 ET
Table 'Pluribus Session 77' 6-max (Play Money) Seat #6 is the button
Seat 1: MrBlue (10000 in chips)
Seat 2: Pluribus (10000 in chips)
Seat 3: Budd (10000 in chips)
Seat 4: MrWhite (10000 in chips)
Seat 5: MrOrange (10000 in chips)
Seat 6: Hattori (10000 in chips)
MrBlue: posts small blind 50
Pluribus: posts big blind 100
*** HOLE CARDS ***
Dealt to MrBlue [5h 8d]
Dealt to Pluribus [3h 4h]
Dealt to Budd [Qc 4d]
Dealt to MrWhite [7h 5c]
Dealt to MrOrange [6d 6h]
Dealt to Hattori [8c Jc]
Budd: folds
MrWhite: folds
MrOrange: raises 110 to 210
Hattori: raises 540 to 750
MrBlue: folds
Pluribus: folds
MrOrange: calls 540
*** FLOP *** [Kc 7s Ac]
MrOrange: checks
Hattori: bets 425
MrOrange: folds
Uncalled bet (425) returned to Hattori
Hattori collected 1650.0 from pot
*** SUMMARY ***
Total pot 1650 | Rake 0
Board [Kc 7s Ac]


PokerStars Hand #77077: Hold'em No Limit (50/100) - 2019/07/11 21:24:37 ET
Table 'Pluribus Session 77' 6-max (Play Money) Seat #6 is the button
Seat 1: Pluribus (10000 in chips)
Seat 2: Budd (10000 in chips)
Seat 3: MrWhite (10000 in chips)
Seat 4: MrOrange (10000 in chips)
Seat 5: Hattori (10000 in chips)
Seat 6: MrBlue (10000 in chips)
Pluribus: posts small blind 50
Budd: posts big blind 100
*** HOLE CARDS ***
Dealt to Pluribus [8d 5s]
Dealt to Budd [6d Qh]
Dealt to MrWhite [Td 9d]
Dealt to MrOrange [3c Ah]
Dealt to Hattori [2s Js]
Dealt to MrBlue [4h 8s]
MrWhite: raises 125 to 225
MrOrange: folds
Hattori: folds
MrBlue: folds
Pluribus: folds
Budd: folds
Uncalled bet (125) returned to MrWhite
MrWhite collected 250.0 from pot
*** SUMMARY ***
Total pot 250 | Rake 0


PokerStars Hand #77078: Hold'em No Limit (50/100) - 2019/07/11 21:24:38 ET
Table 'Pluribus Session 77' 6-max (Play Money) Seat #6 is the button
Seat 1: Budd (10000 in chips)
Seat 2: MrWhite (10000 in chips)
Seat 3: MrOrange (10000 in chips)
Seat 4: Hattori (10000 in chips)
Seat 5: MrBlue (10000 in chips)
Seat 6: Pluribus (10000 in chips)
Budd: posts small blind 50
MrWhite: posts big blind 100
*** HOLE CARDS ***
Dealt to Budd [2h 9c]
Dealt to MrWhite [9s Tc]
Dealt to MrOrange [Ts Ks]
Dealt to Hattori [8h 3d]
Dealt to MrBlue [Kd Kh]
Dealt to Pluribus [8s Td]
MrOrange: raises 100 to 200
Hattori: folds
MrBlue: calls 200
Pluribus: folds
Budd: folds
MrWhite: calls 100
*** FLOP *** [8c Qh 5d]
MrWhite: checks
MrOrange: checks
MrBlue: bets 300
MrWhite: folds
MrOrange: folds
Uncalled bet (300) returned to MrBlue
MrBlue collected 650.0 from pot
*** SUMMARY ***
Total pot 650 | Rake 0
Board [8c Qh 5d]


PokerStars Hand #77079: Hold'em No Limit (50/100) - 2019/07/11 21:24:39 ET
Table 'Pluribus Session 77' 6-max (Play Money) Seat #6 is the button
Seat 1: MrWhite (10000 in chips)
Seat 2: MrOrange (10000 in chips)
Seat 3: Hattori (10000 in chips)
Seat 4: MrBlue (10000 in chips)
Seat 5: Pluribus (10000 in chips)
Seat 6: Budd (10000 in chips)
MrWhite: posts small blind 50
MrOrange: posts big blind 100
*** HOLE CARDS ***
Dealt to MrWhite [Jd 6h]
Dealt to MrOrange [2h 2d]
Dealt to Hattori [7c Kh]
Dealt to MrBlue [9h Td]
Dealt to Pluribus [3h 8c]
Dealt to Budd [Ac 7h]
Hattori: folds
MrBlue: folds
Pluribus: folds
Budd: raises 150 to 250
MrWhite: folds
MrOrange: calls 150
*** FLOP *** [5d Th 7s]
MrOrange: checks
Budd: bets 200
MrOrange: folds
Uncalled bet (200) returned to Budd
Budd collected 550.0 from pot
*** SUMMARY ***
Total pot 550 | Rake 0
Board [5d Th 7s]


PokerStars Hand #77080: Hold'em No Limit (50/100) - 2019/07/11 21:24:40 ET
Table 'Pluribus Session 77' 6-max (Play Money) Seat #6 is the button
Seat 1: MrOrange (10000 in chips)
Seat 2: Hattori (10000 in chips)
Seat 3: MrBlue (10000 in chips)
Seat 4: Pluribus (10000 in chips)
Seat 5: Budd (10000 in chips)
Seat 6: MrWhite (10000 in chips)
MrOrange: posts small blind 50
Hattori: posts big blind 100
*** HOLE CARDS ***
Dealt to MrOrange [Ts 9h]
Dealt to Hattori [Kc 9c]
Dealt to MrBlue [Qc 6d]
Dealt to Pluribus [Ac 7d]
Dealt to Budd [5s 5d]
Dealt to MrWhite [5c 7h]
MrBlue: folds
Pluribus: folds
Budd: raises 125 to 225
MrWhite: folds
MrOrange: folds
Hattori: calls 125
*** FLOP *** [4d Ah 3d]
Hattori: checks
Budd: bets 175
Hattori: folds
Uncalled bet (175) returned to Budd
Budd collected 500.0 from pot
*** SUMMARY ***
Total pot 500 | Rake 0
Board [4d Ah 3d]


PokerStars Hand #77081: Hold'em No Limit (50/100) - 2019/07/11 21:24:41 ET
Table 'Pluribus Session 77' 6-max (Play Money) Seat #6 is the button
Seat 1: Hattori (10000 in chips)
Seat 2: MrBlue (10000 in chips)
Seat 3: Pluribus (10000 in chips)
Seat 4: Budd (10000 in chips)
Seat 5: MrWhite (10000 in chips)
Seat 6: MrOrange (10000 in chips)
Hattori: posts small blind 50
MrBlue: posts big blind 100
*** HOLE CARDS ***
Dealt to Hattori [2d 6s]
Dealt to MrBlue [8c 5s]
Dealt to Pluribus [4h Kc]
Dealt to Budd [As 6h]
Dealt to MrWhite [7d Ad]
Dealt to MrOrange [Js 5d]
Pluribus: folds
Budd: folds
MrWhite: raises 125 to 225
MrOrange: folds
Hattori: folds
MrBlue: calls 125
*** FLOP *** [Qc 3h 9c]
MrBlue: checks
MrWhite: checks
*** TURN *** [Qc 3h 9c] [Kh]
MrBlue: checks
MrWhite: checks
*** RIVER *** [Qc 3h 9c] [Kh] [Ks]
MrBlue: bets 200
MrWhite: folds
Uncalled bet (200) returned to MrBlue
MrBlue collected 500.0 from pot
*** SUMMARY ***
Total pot 500 | Rake 0
Board [Qc 3h 9c Kh Ks]


PokerStars Hand #77082: Hold'em No Limit (50/100) - 2019/07/11 21:24:42 ET
Table 'Pluribus Session 77' 6-max (Play Money) Seat #6 is the button
Seat 1: MrBlue (10000 in chips)
Seat 2: Pluribus (10000 in chips)
Seat 3: Budd (10000 in chips)
Seat 4: MrWhite (10000 in chips)
Seat 5: MrOrange (10000 in chips)
Seat 6: Hattori (10000 in chips)
MrBlue: posts small blind 50
Pluribus: posts big blind 100
*** HOLE CARDS ***
Dealt to MrBlue [Qd 8s]
Dealt to Pluribus [Kh Jc]
Dealt to Budd [7s Qs]
Dealt to MrWhite [3s Tc]
Dealt to MrOrange [8d 5d]
Dealt to Hattori [4c 6d]
Budd: folds
MrWhite: folds
MrOrange: folds
Hattori: folds
MrBlue: raises 200 to 300
Pluribus: calls 200
*** FLOP *** [Kc 6s 5s]
MrBlue: checks
Pluribus: checks
*** TURN *** [Kc 6s 5s] [6h]
MrBlue: checks
Pluribus: bets 300
MrBlue: folds
Uncalled bet (300) returned to Pluribus
Pluribus collected 600.0 from pot
*** SUMMARY ***
Total pot 600 | Rake 0
Board [Kc 6s 5s 6h]


PokerStars Hand #77083: Hold'em No Limit (50/100) - 2019/07/11 21:24:43 ET
Table 'Pluribus Session 77' 6-max (Play Money) Seat #6 is the button
Seat 1: Pluribus (10000 in chips)
Seat 2: Budd (10000 in chips)
Seat 3: MrWhite (10000 in chips)
Seat 4: MrOrange (10000 in chips)
Seat 5: Hattori (10000 in chips)
Seat 6: MrBlue (10000 in chips)
Pluribus: posts small blind 50
Budd: posts big blind 100
*** HOLE CARDS ***
Dealt to Pluribus [Qc 9c]
Dealt to Budd [Ad Td]
Dealt to MrWhite [4h Qs]
Dealt to MrOrange [6h 5s]
Dealt to Hattori [Ts Th]
Dealt to MrBlue [2h 5h]
MrWhite: folds
MrOrange: folds
Hattori: raises 111 to 211
MrBlue: folds
Pluribus: calls 161
Budd: raises 989 to 1200
Hattori: calls 989
Pluribus: folds
*** FLOP *** [3c Kh Jd]
Budd: bets 900
Hattori: folds
Uncalled bet (900) returned to Budd
Budd collected 2611.0 from pot
*** SUMMARY ***
Total pot 2611 | Rake 0
Board [3c Kh Jd]


PokerStars Hand #77084: Hold'em No Limit (50/100) - 2019/07/11 21:24:44 ET
Table 'Pluribus Session 77' 6-max (Play Money) Seat #6 is the button
Seat 1: Budd (10000 in chips)
Seat 2: MrWhite (10000 in chips)
Seat 3: MrOrange (10000 in chips)
Seat 4: Hattori (10000 in chips)
Seat 5: MrBlue (10000 in chips)
Seat 6: Pluribus (10000 in chips)
Budd: posts small blind 50
MrWhite: posts big blind 100
*** HOLE CARDS ***
Dealt to Budd [Qs Kc]
Dealt to MrWhite [Ts 9c]
Dealt to MrOrange [6s Th]
Dealt to Hattori [Qc 3s]
Dealt to MrBlue [4c 6h]
Dealt to Pluribus [5c Jc]
MrOrange: folds
Hattori: folds
MrBlue: folds
Pluribus: raises 150 to 250
Budd: raises 800 to 1050
MrWhite: folds
Pluribus: folds
Uncalled bet (800) returned to Budd
Budd collected 600.0 from pot
*** SUMMARY ***
Total pot 600 | Rake 0


PokerStars Hand #77085: Hold'em No Limit (50/100) - 2019/07/11 21:24:45 ET
Table 'Pluribus Session 77' 6-max (Play Money) Seat #6 is the button
Seat 1: MrWhite (10000 in chips)
Seat 2: MrOrange (10000 in chips)
Seat 3: Hattori (10000 in chips)
Seat 4: MrBlue (10000 in chips)
Seat 5: Pluribus (10000 in chips)
Seat 6: Budd (10000 in chips)
MrWhite: posts small blind 50
MrOrange: posts big blind 100
*** HOLE CARDS ***
Dealt to MrWhite [8d 7h]
Dealt to MrOrange [Kd Ac]
Dealt to Hattori [9s 4h]
Dealt to MrBlue [2d Ad]
Dealt to Pluribus [Qs Kc]
Dealt to Budd [8s 5h]
Hattori: folds
MrBlue: raises 125 to 225
Pluribus: raises 525 to 750
Budd: folds
MrWhite: folds
MrOrange: raises 1100 to 1850
MrBlue: folds
Pluribus: folds
Uncalled bet (1100) returned to MrOrange
MrOrange collected 1775.0 from pot
*** SUMMARY ***
Total pot 1775 | Rake 0


PokerStars Hand #77086: Hold'em No Limit (50/100) - 2019/07/11 21:24:46 ET
Table 'Pluribus Session 77' 6-max (Play Money) Seat #6 is the button
Seat 1: MrOrange (10000 in chips)
Seat 2: Hattori (10000 in chips)
Seat 3: MrBlue (10000 in chips)
Seat 4: Pluribus (10000 in chips)
Seat 5: Budd (10000 in chips)
Seat 6: MrWhite (10000 in chips)
MrOrange: posts small blind 50
Hattori: posts big blind 100
*** HOLE CARDS ***
Dealt to MrOrange [Ah 5d]
Dealt to Hattori [Ts 7s]
Dealt to MrBlue [6s Jc]
Dealt to Pluribus [4c 3c]
Dealt to Budd [9h 8s]
Dealt to MrWhite [3h 6h]
MrBlue: folds
Pluribus: folds
Budd: folds
MrWhite: folds
MrOrange: folds
Uncalled bet (50) returned to Hattori
Hattori collected 100.0 from pot
*** SUMMARY ***
Total pot 100 | Rake 0


PokerStars Hand #77087: Hold'em No Limit (50/100) - 2019/07/11 21:24:47 ET
Table 'Pluribus Session 77' 6-max (Play Money) Seat #6 is the button
Seat 1: Hattori (10000 in chips)
Seat 2: MrBlue (10000 in chips)
Seat 3: Pluribus (10000 in chips)
Seat 4: Budd (10000 in chips)
Seat 5: MrWhite (10000 in chips)
Seat 6: MrOrange (10000 in chips)
Hattori: posts small blind 50
MrBlue: posts big blind 100
*** HOLE CARDS ***
Dealt to Hattori [4s Ac]
Dealt to MrBlue [3h 3c]
Dealt to Pluribus [8h 2d]
Dealt to Budd [7h 9s]
Dealt to MrWhite [5d Qs]
Dealt to MrOrange [8s 4h]
Pluribus: folds
Budd: folds
MrWhite: folds
MrOrange: folds
Hattori: raises 135 to 235
MrBlue: calls 135
*** FLOP *** [Th 6d 6c]
Hattori: checks
MrBlue: bets 200
Hattori: calls 200
*** TURN *** [Th 6d 6c] [6h]
Hattori: checks
MrBlue: checks
*** RIVER *** [Th 6d 6c] [6h] [2c]
Hattori: checks
MrBlue: checks
*** SHOWDOWN ***
MrBlue: shows [3h 3c]
MrBlue collected 870.0 from pot
*** SUMMARY ***
Total pot 870 | Rake 0
Board [Th 6d 6c 6h 2c]
Seat 1: Hattori showed [4s Ac] and lost
Seat 2: MrBlue showed [3h 3c] and won (870.0)


PokerStars Hand #77088: Hold'em No Limit (50/100) - 2019/07/11 21:24:48 ET
Table 'Pluribus Session 77' 6-max (Play Money) Seat #6 is the button
Seat 1: MrBlue (10000 in chips)
Seat 2: Pluribus (10000 in chips)
Seat 3: Budd (10000 in chips)
Seat 4: MrWhite (10000 in chips)
Seat 5: MrOrange (10000 in chips)
Seat 6: Hattori (10000 in chips)
MrBlue: posts small blind 50
Pluribus: posts big blind 100
*** HOLE CARDS ***
Dealt to MrBlue [2d 9d]
Dealt to Pluribus [4d Ks]
Dealt to Budd [7s Th]
Dealt to MrWhite [Ac 3c]
Dealt to MrOrange [Qd Ts]
Dealt to Hattori [2h Ad]
Budd: folds
MrWhite: raises 125 to 225
MrOrange: folds
Hattori: folds
MrBlue: folds
Pluribus: folds
Uncalled bet (125) returned to MrWhite
MrWhite collected 250.0 from pot
*** SUMMARY ***
Total pot 250 | Rake 0


PokerStars Hand #77089: Hold'em No Limit (50/100) - 2019/07/11 21:24:49 ET
Table 'Pluribus Session 77' 6-max (Play Money) Seat #6 is the button
Seat 1: Pluribus (10000 in chips)
Seat 2: Budd (10000 in chips)
Seat 3: MrWhite (10000 in chips)
Seat 4: MrOrange (10000 in chips)
Seat 5: Hattori (10000 in chips)
Seat 6: MrBlue (10000 in chips)
Pluribus: posts small blind 50
Budd: posts big blind 100
*** HOLE CARDS ***
Dealt to Pluribus [Qs Kd]
Dealt to Budd [9d 8s]
Dealt to MrWhite [Kc Jc]
Dealt to MrOrange [Td Tc]
Dealt to Hattori [2c 4s]
Dealt to MrBlue [9h Qc]
MrWhite: raises 125 to 225
MrOrange: calls 225
Hattori: folds
MrBlue: folds
Pluribus: folds
Budd: calls 125
*** FLOP *** [2h 7c 4d]
Budd: checks
MrWhite: bets 543
MrOrange: calls 543
Budd: folds
*** TURN *** [2h 7c 4d] [Th]
MrWhite: checks
MrOrange: bets 1055
MrWhite: folds
Uncalled bet (1055) returned to MrOrange
MrOrange collected 1811.0 from pot
*** SUMMARY ***
Total pot 1811 | Rake 0
Board [2h 7c 4d Th]


PokerStars Hand #77090: Hold'em No Limit (50/100) - 2019/07/11 21:24:50 ET
Table 'Pluribus Session 77' 6-max (Play Money) Seat #6 is the button
Seat 1: Budd (10000 in chips)
Seat 2: MrWhite (10000 in chips)
Seat 3: MrOrange (10000 in chips)
Seat 4: Hattori (10000 in chips)
Seat 5: MrBlue (10000 in chips)
Seat 6: Pluribus (10000 in chips)
Budd: posts small blind 50
MrWhite: posts big blind 100
*** HOLE CARDS ***
Dealt to Budd [9c 4c]
Dealt to MrWhite [Ad 7d]
Dealt to MrOrange [3s 6h]
Dealt to Hattori [2c 9h]
Dealt to MrBlue [Ah 9s]
Dealt to Pluribus [2d Qd]
MrOrange: folds
Hattori: folds
MrBlue: raises 125 to 225
Pluribus: folds
Budd: folds
MrWhite: calls 125
*** FLOP *** [7h Kc Jc]
MrWhite: checks
MrBlue: bets 250
MrWhite: calls 250
*** TURN *** [7h Kc Jc] [4h]
MrWhite: checks
MrBlue: bets 875
MrWhite: folds
Uncalled bet (875) returned to MrBlue
MrBlue collected 1000.0 from pot
*** SUMMARY ***
Total pot 1000 | Rake 0
Board [7h Kc Jc 4h]


PokerStars Hand #77091: Hold'em No Limit (50/100) - 2019/07/11 21:24:51 ET
Table 'Pluribus Session 77' 6-max (Play Money) Seat #6 is the button
Seat 1: MrWhite (10000 in chips)
Seat 2: MrOrange (10000 in chips)
Seat 3: Hattori (10000 in chips)
Seat 4: MrBlue (10000 in chips)
Seat 5: Pluribus (10000 in chips)
Seat 6: Budd (10000 in chips)
MrWhite: posts small blind 50
MrOrange: posts big blind 100
*** HOLE CARDS ***
Dealt to MrWhite [6d 8c]
Dealt to MrOrange [2h 2c]
Dealt to Hattori [Tc Th]
Dealt to MrBlue [6c 7c]
Dealt to Pluribus [9s 3h]
Dealt to Budd [Jd 9c]
Hattori: raises 100 to 200
MrBlue: calls 200
Pluribus: folds
Budd: folds
MrWhite: folds
MrOrange: calls 100
*** FLOP *** [Kh 3s 8d]
MrOrange: checks
Hattori: checks
MrBlue: checks
*** TURN *** [Kh 3s 8d] [Jc]
MrOrange: checks
Hattori: checks
MrBlue: checks
*** RIVER *** [Kh 3s 8d] [Jc] [7h]
MrOrange: checks
Hattori: checks
MrBlue: checks
*** SHOWDOWN ***
Hattori: shows [Tc Th]
Hattori collected 650.0 from pot
*** SUMMARY ***
Total pot 650 | Rake 0
Board [Kh 3s 8d Jc 7h]
Seat 2: MrOrange showed [2h 2c] and lost
Seat 3: Hattori showed [Tc Th] and won (650.0)
Seat 4: MrBlue showed [6c 7c] and lost


PokerStars Hand #77092: Hold'em No Limit (50/100) - 2019/07/11 21:24:52 ET
Table 'Pluribus Session 77' 6-max (Play Money) Seat #6 is the button
Seat 1: MrOrange (10000 in chips)
Seat 2: Hattori (10000 in chips)
Seat 3: MrBlue (10000 in chips)
Seat 4: Pluribus (10000 in chips)
Seat 5: Budd (10000 in chips)
Seat 6: MrWhite (10000 in chips)
MrOrange: posts small blind 50
Hattori: posts big blind 100
*** HOLE CARDS ***
Dealt to MrOrange [Jd 7d]
Dealt to Hattori [3c 2c]
Dealt to MrBlue [5d 5h]
Dealt to Pluribus [Td 2d]
Dealt to Budd [Ks 8s]
Dealt to MrWhite [Qh 9d]
MrBlue: raises 125 to 225
Pluribus: folds
Budd: folds
MrWhite: folds
MrOrange: folds
Hattori: calls 125
*** FLOP *** [4c 7h Ad]
Hattori: checks
MrBlue: bets 250
Hattori: calls 250
*** TURN *** [4c 7h Ad] [6s]
Hattori: checks
MrBlue: checks
*** RIVER *** [4c 7h Ad] [6s] [4d]
Hattori: bets 3000
MrBlue: folds
Uncalled bet (3000) returned to Hattori
Hattori collected 1000.0 from pot
*** SUMMARY ***
Total pot 1000 | Rake 0
Board [4c 7h Ad 6s 4d]


PokerStars Hand #77093: Hold'em No Limit (50/100) - 2019/07/11 21:24:53 ET
Table 'Pluribus Session 77' 6-max (Play Money) Seat #6 is the button
Seat 1: Hattori (10000 in chips)
Seat 2: MrBlue (10000 in chips)
Seat 3: Pluribus (10000 in chips)
Seat 4: Budd (10000 in chips)
Seat 5: MrWhite (10000 in chips)
Seat 6: MrOrange (10000 in chips)
Hattori: posts small blind 50
MrBlue: posts big blind 100
*** HOLE CARDS ***
Dealt to Hattori [8d 4d]
Dealt to MrBlue [9c 8s]
Dealt to Pluribus [Td Qh]
Dealt to Budd [9h Th]
Dealt to MrWhite [As Ah]
Dealt to MrOrange [3c 2s]
Pluribus: folds
Budd: raises 125 to 225
MrWhite: raises 300 to 525
MrOrange: folds
Hattori: folds
MrBlue: folds
Budd: calls 300
*** FLOP *** [6c Qc Ts]
Budd: checks
MrWhite: bets 900
Budd: calls 900
*** TURN *** [6c Qc Ts] [Js]
Budd: checks
MrWhite: checks
*** RIVER *** [6c Qc Ts] [Js] [Jd]
Budd: checks
MrWhite: checks
*** SHOWDOWN ***
MrWhite: shows [As Ah]
MrWhite collected 3000.0 from pot
*** SUMMARY ***
Total pot 3000 | Rake 0
Board [6c Qc Ts Js Jd]
Seat 4: Budd showed [9h Th] and lost
Seat 5: MrWhite showed [As Ah] and won (3000.0)


PokerStars Hand #77094: Hold'em No Limit (50/100) - 2019/07/11 21:24:54 ET
Table 'Pluribus Session 77' 6-max (Play Money) Seat #6 is the button
Seat 1: MrBlue (10000 in chips)
Seat 2: Pluribus (10000 in chips)
Seat 3: Budd (10000 in chips)
Seat 4: MrWhite (10000 in chips)
Seat 5: MrOrange (10000 in chips)
Seat 6: Hattori (10000 in chips)
MrBlue: posts small blind 50
Pluribus: posts big blind 100
*** HOLE CARDS ***
Dealt to MrBlue [9s 4h]
Dealt to Pluribus [Kh Th]
Dealt to Budd [7h 8c]
Dealt to MrWhite [3h 6h]
Dealt to MrOrange [Jd 8s]
Dealt to Hattori [7d 7s]
Budd: calls 100
MrWhite: folds
MrOrange: folds
Hattori: raises 250 to 350
MrBlue: folds
Pluribus: folds
Budd: folds
Uncalled bet (250) returned to Hattori
Hattori collected 350.0 from pot
*** SUMMARY ***
Total pot 350 | Rake 0


PokerStars Hand #77095: Hold'em No Limit (50/100) - 2019/07/11 21:24:55 ET
Table 'Pluribus Session 77' 6-max (Play Money) Seat #6 is the button
Seat 1: Pluribus (10000 in chips)
Seat 2: Budd (10000 in chips)
Seat 3: MrWhite (10000 in chips)
Seat 4: MrOrange (10000 in chips)
Seat 5: Hattori (10000 in chips)
Seat 6: MrBlue (10000 in chips)
Pluribus: posts small blind 50
Budd: posts big blind 100
*** HOLE CARDS ***
Dealt to Pluribus [5s Ad]
Dealt to Budd [7d 8c]
Dealt to MrWhite [4s 3s]
Dealt to MrOrange [Kc Qd]
Dealt to Hattori [8d 2s]
Dealt to MrBlue [9d 7c]
MrWhite: raises 125 to 225
MrOrange: folds
Hattori: folds
MrBlue: folds
Pluribus: folds
Budd: calls 125
*** FLOP *** [6d 2h 6h]
Budd: checks
MrWhite: bets 250
Budd: folds
Uncalled bet (250) returned to MrWhite
MrWhite collected 500.0 from pot
*** SUMMARY ***
Total pot 500 | Rake 0
Board [6d 2h 6h]


PokerStars Hand #77096: Hold'em No Limit (50/100) - 2019/07/11 21:24:56 ET
Table 'Pluribus Session 77' 6-max (Play Money) Seat #6 is the button
Seat 1: Budd (10000 in chips)
Seat 2: MrWhite (10000 in chips)
Seat 3: MrOrange (10000 in chips)
Seat 4: Hattori (10000 in chips)
Seat 5: MrBlue (10000 in chips)
Seat 6: Pluribus (10000 in chips)
Budd: posts small blind 50
MrWhite: posts big blind 100
*** HOLE CARDS ***
Dealt to Budd [7s Qd]
Dealt to MrWhite [Jc 9h]
Dealt to MrOrange [6d Jd]
Dealt to Hattori [2s 5h]
Dealt to MrBlue [Jh Qc]
Dealt to Pluribus [7d 8s]
MrOrange: folds
Hattori: folds
MrBlue: raises 125 to 225
Pluribus: folds
Budd: folds
MrWhite: calls 125
*** FLOP *** [Th 5d 8d]
MrWhite: checks
MrBlue: checks
*** TURN *** [Th 5d 8d] [3s]
MrWhite: bets 375
MrBlue: calls 375
*** RIVER *** [Th 5d 8d] [3s] [3c]
MrWhite: bets 937
MrBlue: folds
Uncalled bet (937) returned to MrWhite
MrWhite collected 1250.0 from pot
*** SUMMARY ***
Total pot 1250 | Rake 0
Board [Th 5d 8d 3s 3c]


PokerStars Hand #77097: Hold'em No Limit (50/100) - 2019/07/11 21:24:57 ET
Table 'Pluribus Session 77' 6-max (Play Money) Seat #6 is the button
Seat 1: MrWhite (10000 in chips)
Seat 2: MrOrange (10000 in chips)
Seat 3: Hattori (10000 in chips)
Seat 4: MrBlue (10000 in chips)
Seat 5: Pluribus (10000 in chips)
Seat 6: Budd (10000 in chips)
MrWhite: posts small blind 50
MrOrange: posts big blind 100
*** HOLE CARDS ***
Dealt to MrWhite [Ah Ad]
Dealt to MrOrange [7s 4s]
Dealt to Hattori [4c 5s]
Dealt to MrBlue [Jc 6s]
Dealt to Pluribus [3c 3d]
Dealt to Budd [Th 6h]
Hattori: folds
MrBlue: folds
Pluribus: raises 100 to 200
Budd: folds
MrWhite: raises 599 to 799
MrOrange: folds
Pluribus: calls 599
*** FLOP *** [Qd Jh Qh]
MrWhite: checks
Pluribus: bets 1698
MrWhite: calls 1698
*** TURN *** [Qd Jh Qh] [4h]
MrWhite: checks
Pluribus: checks
*** RIVER *** [Qd Jh Qh] [4h] [5d]
MrWhite: checks
Pluribus: checks
*** SHOWDOWN ***
MrWhite: shows [Ah Ad]
MrWhite collected 5094.0 from pot
*** SUMMARY ***
Total pot 5094 | Rake 0
Board [Qd Jh Qh 4h 5d]
Seat 1: MrWhite showed [Ah Ad] and won (5094.0)
Seat 5: Pluribus showed [3c 3d] and lost


PokerStars Hand #77098: Hold'em No Limit (50/100) - 2019/07/11 21:24:58 ET
Table 'Pluribus Session 77' 6-max (Play Money) Seat #6 is the button
Seat 1: MrOrange (10000 in chips)
Seat 2: Hattori (10000 in chips)
Seat 3: MrBlue (10000 in chips)
Seat 4: Pluribus (10000 in chips)
Seat 5: Budd (10000 in chips)
Seat 6: MrWhite (10000 in chips)
MrOrange: posts small blind 50
Hattori: posts big blind 100
*** HOLE CARDS ***
Dealt to MrOrange [6h Ad]
Dealt to Hattori [9s 2s]
Dealt to MrBlue [9d 2c]
Dealt to Pluribus [4s 5s]
Dealt to Budd [Td 6c]
Dealt to MrWhite [Qh Qs]
MrBlue: folds
Pluribus: folds
Budd: folds
MrWhite: raises 125 to 225
MrOrange: folds
Hattori: calls 125
*** FLOP *** [As Th 5d]
Hattori: checks
MrWhite: checks
*** TURN *** [As Th 5d] [8c]
Hattori: checks
MrWhite: checks
*** RIVER *** [As Th 5d] [8c] [Kd]
Hattori: checks
MrWhite: checks
*** SHOWDOWN ***
MrWhite: shows [Qh Qs]
MrWhite collected 500.0 from pot
*** SUMMARY ***
Total pot 500 | Rake 0
Board [As Th 5d 8c Kd]
Seat 2: Hattori showed [9s 2s] and lost
Seat 6: MrWhite showed [Qh Qs] and won (500.0)


PokerStars Hand #77099: Hold'em No Limit (50/100) - 2019/07/11 21:24:59 ET
Table 'Pluribus Session 77' 6-max (Play Money) Seat #6 is the button
Seat 1: Hattori (10000 in chips)
Seat 2: MrBlue (10000 in chips)
Seat 3: Pluribus (10000 in chips)
Seat 4: Budd (10000 in chips)
Seat 5: MrWhite (10000 in chips)
Seat 6: MrOrange (10000 in chips)
Hattori: posts small blind 50
MrBlue: posts big blind 100
*** HOLE CARDS ***
Dealt to Hattori [Qc Ks]
Dealt to MrBlue [7s 3s]
Dealt to Pluribus [Jc 4c]
Dealt to Budd [3c 4s]
Dealt to MrWhite [9s Jh]
Dealt to MrOrange [4h 7d]
Pluribus: folds
Budd: folds
MrWhite: folds
MrOrange: folds
Hattori: raises 135 to 235
MrBlue: calls 135
*** FLOP *** [6s 8s 7h]
Hattori: checks
MrBlue: checks
*** TURN *** [6s 8s 7h] [5c]
Hattori: checks
MrBlue: checks
*** RIVER *** [6s 8s 7h] [5c] [Td]
Hattori: checks
MrBlue: checks
*** SHOWDOWN ***
MrBlue: shows [7s 3s]
MrBlue collected 470.0 from pot
*** SUMMARY ***
Total pot 470 | Rake 0
Board [6s 8s 7h 5c Td]
Seat 1: Hattori showed [Qc Ks] and lost
Seat 2: MrBlue showed [7s 3s] and won (470.0)


PokerStars Hand #77100: Hold'em No Limit (50/100) - 2019/07/11 21:25:00 ET
Table 'Pluribus Session 77' 6-max (Play Money) Seat #6 is the button
Seat 1: MrBlue (10000 in chips)
Seat 2: Pluribus (10000 in chips)
Seat 3: Budd (10000 in chips)
Seat 4: MrWhite (10000 in chips)
Seat 5: MrOrange (10000 in chips)
Seat 6: Hattori (10000 in chips)
MrBlue: posts small blind 50
Pluribus: posts big blind 100
*** HOLE CARDS ***
Dealt to MrBlue [3c 2c]
Dealt to Pluribus [4c Ac]
Dealt to Budd [3d Jh]
Dealt to MrWhite [6h Jd]
Dealt to MrOrange [8c 8h]
Dealt to Hattori [Kh 8d]
Budd: folds
MrWhite: folds
MrOrange: raises 115 to 215
Hattori: folds
MrBlue: folds
Pluribus: calls 115
*** FLOP *** [5d As 6d]
Pluribus: checks
MrOrange: bets 150
Pluribus: calls 150
*** TURN *** [5d As 6d] [Ts]
Pluribus: checks
MrOrange: checks
*** RIVER *** [5d As 6d] [Ts] [5h]
Pluribus: bets 780
MrOrange: folds
Uncalled bet (780) returned to Pluribus
Pluribus collected 780.0 from pot
*** SUMMARY ***
Total pot 780 | Rake 0
Board [5d As 6d Ts 5h]


PokerStars Hand #77101: Hold'em No Limit (50/100) - 2019/07/11 21:25:01 ET
Table 'Pluribus Session 77' 6-max (Play Money) Seat #6 is the button
Seat 1: Pluribus (10000 in chips)
Seat 2: Budd (10000 in chips)
Seat 3: MrWhite (10000 in chips)
Seat 4: MrOrange (10000 in chips)
Seat 5: Hattori (10000 in chips)
Seat 6: MrBlue (10000 in chips)
Pluribus: posts small blind 50
Budd: posts big blind 100
*** HOLE CARDS ***
Dealt to Pluribus [2h Ad]
Dealt to Budd [3c 7c]
Dealt to MrWhite [6h Ks]
Dealt to MrOrange [Qh 9h]
Dealt to Hattori [9s 2s]
Dealt to MrBlue [4s Jc]
MrWhite: folds
MrOrange: raises 110 to 210
Hattori: folds
MrBlue: folds
Pluribus: folds
Budd: folds
Uncalled bet (110) returned to MrOrange
MrOrange collected 250.0 from pot
*** SUMMARY ***
Total pot 250 | Rake 0


PokerStars Hand #77102: Hold'em No Limit (50/100) - 2019/07/11 21:25:02 ET
Table 'Pluribus Session 77' 6-max (Play Money) Seat #6 is the button
Seat 1: Budd (10000 in chips)
Seat 2: MrWhite (10000 in chips)
Seat 3: MrOrange (10000 in chips)
Seat 4: Hattori (10000 in chips)
Seat 5: MrBlue (10000 in chips)
Seat 6: Pluribus (10000 in chips)
Budd: posts small blind 50
MrWhite: posts big blind 100
*** HOLE CARDS ***
Dealt to Budd [As 5c]
Dealt to MrWhite [Ah 7c]
Dealt to MrOrange [3s 9h]
Dealt to Hattori [Qc 6s]
Dealt to MrBlue [2s Jc]
Dealt to Pluribus [2h Js]
MrOrange: folds
Hattori: folds
MrBlue: folds
Pluribus: folds
Budd: raises 200 to 300
MrWhite: calls 200
*** FLOP *** [5s 7d Jh]
Budd: checks
MrWhite: checks
*** TURN *** [5s 7d Jh] [7h]
Budd: checks
MrWhite: bets 450
Budd: calls 450
*** RIVER *** [5s 7d Jh] [7h] [Th]
Budd: checks
MrWhite: bets 1125
Budd: folds
Uncalled bet (1125) returned to MrWhite
MrWhite collected 1500.0 from pot
*** SUMMARY ***
Total pot 1500 | Rake 0
Board [5s 7d Jh 7h Th]


PokerStars Hand #77103: Hold'em No Limit (50/100) - 2019/07/11 21:25:03 ET
Table 'Pluribus Session 77' 6-max (Play Money) Seat #6 is the button
Seat 1: MrWhite (10000 in chips)
Seat 2: MrOrange (10000 in chips)
Seat 3: Hattori (10000 in chips)
Seat 4: MrBlue (10000 in chips)
Seat 5: Pluribus (10000 in chips)
Seat 6: Budd (10000 in chips)
MrWhite: posts small blind 50
MrOrange: posts big blind 100
*** HOLE CARDS ***
Dealt to MrWhite [4s 5d]
Dealt to MrOrange [8c 7d]
Dealt to Hattori [Ad 3h]
Dealt to MrBlue [Qc 6c]
Dealt to Pluribus [Qs 6d]
Dealt to Budd [8d 8s]
Hattori: folds
MrBlue: folds
Pluribus: folds
Budd: raises 150 to 250
MrWhite: folds
MrOrange: folds
Uncalled bet (150) returned to Budd
Budd collected 250.0 from pot
*** SUMMARY ***
Total pot 250 | Rake 0


PokerStars Hand #77104: Hold'em No Limit (50/100) - 2019/07/11 21:25:04 ET
Table 'Pluribus Session 77' 6-max (Play Money) Seat #6 is the button
Seat 1: MrOrange (10000 in chips)
Seat 2: Hattori (10000 in chips)
Seat 3: MrBlue (10000 in chips)
Seat 4: Pluribus (10000 in chips)
Seat 5: Budd (10000 in chips)
Seat 6: MrWhite (10000 in chips)
MrOrange: posts small blind 50
Hattori: posts big blind 100
*** HOLE CARDS ***
Dealt to MrOrange [7s 3h]
Dealt to Hattori [3c Kc]
Dealt to MrBlue [2d 8s]
Dealt to Pluribus [Ts Jd]
Dealt to Budd [9c 2s]
Dealt to MrWhite [Qc 8d]
MrBlue: folds
Pluribus: raises 125 to 225
Budd: folds
MrWhite: folds
MrOrange: folds
Hattori: calls 125
*** FLOP *** [5d 2c 7d]
Hattori: checks
Pluribus: checks
*** TURN *** [5d 2c 7d] [4h]
Hattori: bets 1000
Pluribus: folds
Uncalled bet (1000) returned to Hattori
Hattori collected 500.0 from pot
*** SUMMARY ***
Total pot 500 | Rake 0
Board [5d 2c 7d 4h]


PokerStars Hand #77105: Hold'em No Limit (50/100) - 2019/07/11 21:25:05 ET
Table 'Pluribus Session 77' 6-max (Play Money) Seat #6 is the button
Seat 1: Hattori (10000 in chips)
Seat 2: MrBlue (10000 in chips)
Seat 3: Pluribus (10000 in chips)
Seat 4: Budd (10000 in chips)
Seat 5: MrWhite (10000 in chips)
Seat 6: MrOrange (10000 in chips)
Hattori: posts small blind 50
MrBlue: posts big blind 100
*** HOLE CARDS ***
Dealt to Hattori [2c 8s]
Dealt to MrBlue [6h 5s]
Dealt to Pluribus [4d Jh]
Dealt to Budd [5d 4h]
Dealt to MrWhite [5c 7d]
Dealt to MrOrange [8h Ac]
Pluribus: folds
Budd: folds
MrWhite: folds
MrOrange: raises 124 to 224
Hattori: folds
MrBlue: calls 124
*** FLOP *** [4c 8c Ks]
MrBlue: checks
MrOrange: checks
*** TURN *** [4c 8c Ks] [3s]
MrBlue: bets 760
MrOrange: calls 760
*** RIVER *** [4c 8c Ks] [3s] [9d]
MrBlue: bets 3675
MrOrange: folds
Uncalled bet (3675) returned to MrBlue
MrBlue collected 2018.0 from pot
*** SUMMARY ***
Total pot 2018 | Rake 0
Board [4c 8c Ks 3s 9d]


PokerStars Hand #77106: Hold'em No Limit (50/100) - 2019/07/11 21:25:06 ET
Table 'Pluribus Session 77' 6-max (Play Money) Seat #6 is the button
Seat 1: MrBlue (10000 in chips)
Seat 2: Pluribus (10000 in chips)
Seat 3: Budd (10000 in chips)
Seat 4: MrWhite (10000 in chips)
Seat 5: MrOrange (10000 in chips)
Seat 6: Hattori (10000 in chips)
MrBlue: posts small blind 50
Pluribus: posts big blind 100
*** HOLE CARDS ***
Dealt to MrBlue [5c 8d]
Dealt to Pluribus [4d Jc]
Dealt to Budd [2c 7c]
Dealt to MrWhite [7d Jd]
Dealt to MrOrange [Ts Qc]
Dealt to Hattori [Th 6c]
Budd: folds
MrWhite: folds
MrOrange: folds
Hattori: folds
MrBlue: folds
Uncalled bet (50) returned to Pluribus
Pluribus collected 100.0 from pot
*** SUMMARY ***
Total pot 100 | Rake 0


PokerStars Hand #77107: Hold'em No Limit (50/100) - 2019/07/11 21:25:07 ET
Table 'Pluribus Session 77' 6-max (Play Money) Seat #6 is the button
Seat 1: Pluribus (10000 in chips)
Seat 2: Budd (10000 in chips)
Seat 3: MrWhite (10000 in chips)
Seat 4: MrOrange (10000 in chips)
Seat 5: Hattori (10000 in chips)
Seat 6: MrBlue (10000 in chips)
Pluribus: posts small blind 50
Budd: posts big blind 100
*** HOLE CARDS ***
Dealt to Pluribus [5s Kd]
Dealt to Budd [2d Tc]
Dealt to MrWhite [4s 4d]
Dealt to MrOrange [Ah Td]
Dealt to Hattori [7d 7h]
Dealt to MrBlue [3s 9d]
MrWhite: raises 125 to 225
MrOrange: folds
Hattori: calls 225
MrBlue: folds
Pluribus: folds
Budd: folds
*** FLOP *** [6c 4h Qc]
MrWhite: bets 450
Hattori: calls 450
*** TURN *** [6c 4h Qc] [3h]
MrWhite: bets 2400
Hattori: folds
Uncalled bet (2400) returned to MrWhite
MrWhite collected 1500.0 from pot
*** SUMMARY ***
Total pot 1500 | Rake 0
Board [6c 4h Qc 3h]


PokerStars Hand #77108: Hold'em No Limit (50/100) - 2019/07/11 21:25:08 ET
Table 'Pluribus Session 77' 6-max (Play Money) Seat #6 is the button
Seat 1: Budd (10000 in chips)
Seat 2: MrWhite (10000 in chips)
Seat 3: MrOrange (10000 in chips)
Seat 4: Hattori (10000 in chips)
Seat 5: MrBlue (10000 in chips)
Seat 6: Pluribus (10000 in chips)
Budd: posts small blind 50
MrWhite: posts big blind 100
*** HOLE CARDS ***
Dealt to Budd [Th Qd]
Dealt to MrWhite [Ac Ad]
Dealt to MrOrange [2s 3d]
Dealt to Hattori [Kc Jc]
Dealt to MrBlue [3s 7d]
Dealt to Pluribus [Kh Kd]
MrOrange: folds
Hattori: raises 100 to 200
MrBlue: folds
Pluribus: raises 550 to 750
Budd: folds
MrWhite: raises 1499 to 2249
Hattori: folds
Pluribus: raises 7250 to 9499
MrWhite: raises 501 to 10000 and is all-in
Pluribus: calls 501 and is all-in
*** FLOP *** [6d 8c 4s]
*** TURN *** [6d 8c 4s] [5s]
*** RIVER *** [6d 8c 4s] [5s] [4c]
*** SHOWDOWN ***
MrWhite: shows [Ac Ad]
MrWhite collected 20250.0 from pot
*** SUMMARY ***
Total pot 20250 | Rake 0
Board [6d 8c 4s 5s 4c]
Seat 2: MrWhite showed [Ac Ad] and won (20250.0)
Seat 6: Pluribus showed [Kh Kd] and lost


PokerStars Hand #77109: Hold'em No Limit (50/100) - 2019/07/11 21:25:09 ET
Table 'Pluribus Session 77' 6-max (Play Money) Seat #6 is the button
Seat 1: MrWhite (10000 in chips)
Seat 2: MrOrange (10000 in chips)
Seat 3: Hattori (10000 in chips)
Seat 4: MrBlue (10000 in chips)
Seat 5: Pluribus (10000 in chips)
Seat 6: Budd (10000 in chips)
MrWhite: posts small blind 50
MrOrange: posts big blind 100
*** HOLE CARDS ***
Dealt to MrWhite [9s 6s]
Dealt to MrOrange [3h 4h]
Dealt to Hattori [2h 6h]
Dealt to MrBlue [7d 9h]
Dealt to Pluribus [9d Jh]
Dealt to Budd [Jd Tc]
Hattori: folds
MrBlue: folds
Pluribus: folds
Budd: raises 150 to 250
MrWhite: folds
MrOrange: folds
Uncalled bet (150) returned to Budd
Budd collected 250.0 from pot
*** SUMMARY ***
Total pot 250 | Rake 0


PokerStars Hand #77110: Hold'em No Limit (50/100) - 2019/07/11 21:25:10 ET
Table 'Pluribus Session 77' 6-max (Play Money) Seat #6 is the button
Seat 1: MrOrange (10000 in chips)
Seat 2: Hattori (10000 in chips)
Seat 3: MrBlue (10000 in chips)
Seat 4: Pluribus (10000 in chips)
Seat 5: Budd (10000 in chips)
Seat 6: MrWhite (10000 in chips)
MrOrange: posts small blind 50
Hattori: posts big blind 100
*** HOLE CARDS ***
Dealt to MrOrange [8d 4c]
Dealt to Hattori [5c Jd]
Dealt to MrBlue [Qd 7d]
Dealt to Pluribus [4h Js]
Dealt to Budd [6d 6c]
Dealt to MrWhite [Ks Kc]
MrBlue: folds
Pluribus: folds
Budd: raises 125 to 225
MrWhite: raises 450 to 675
MrOrange: folds
Hattori: folds
Budd: calls 450
*** FLOP *** [Ad 2d Jc]
Budd: checks
MrWhite: checks
*** TURN *** [Ad 2d Jc] [Kh]
Budd: checks
MrWhite: bets 750
Budd: folds
Uncalled bet (750) returned to MrWhite
MrWhite collected 1500.0 from pot
*** SUMMARY ***
Total pot 1500 | Rake 0
Board [Ad 2d Jc Kh]


PokerStars Hand #77111: Hold'em No Limit (50/100) - 2019/07/11 21:25:11 ET
Table 'Pluribus Session 77' 6-max (Play Money) Seat #6 is the button
Seat 1: Hattori (10000 in chips)
Seat 2: MrBlue (10000 in chips)
Seat 3: Pluribus (10000 in chips)
Seat 4: Budd (10000 in chips)
Seat 5: MrWhite (10000 in chips)
Seat 6: MrOrange (10000 in chips)
Hattori: posts small blind 50
MrBlue: posts big blind 100
*** HOLE CARDS ***
Dealt to Hattori [Qh Jh]
Dealt to MrBlue [3d 8d]
Dealt to Pluribus [7c 6d]
Dealt to Budd [Ac 9s]
Dealt to MrWhite [Ah Jc]
Dealt to MrOrange [6s 5h]
Pluribus: folds
Budd: folds
MrWhite: raises 125 to 225
MrOrange: folds
Hattori: raises 925 to 1150
MrBlue: folds
MrWhite: folds
Uncalled bet (925) returned to Hattori
Hattori collected 550.0 from pot
*** SUMMARY ***
Total pot 550 | Rake 0


PokerStars Hand #77112: Hold'em No Limit (50/100) - 2019/07/11 21:25:12 ET
Table 'Pluribus Session 77' 6-max (Play Money) Seat #6 is the button
Seat 1: MrBlue (10000 in chips)
Seat 2: Pluribus (10000 in chips)
Seat 3: Budd (10000 in chips)
Seat 4: MrWhite (10000 in chips)
Seat 5: MrOrange (10000 in chips)
Seat 6: Hattori (10000 in chips)
MrBlue: posts small blind 50
Pluribus: posts big blind 100
*** HOLE CARDS ***
Dealt to MrBlue [As 3h]
Dealt to Pluribus [5s 2c]
Dealt to Budd [2d 7c]
Dealt to MrWhite [Jd 3s]
Dealt to MrOrange [Ac 4s]
Dealt to Hattori [9c Qd]
Budd: folds
MrWhite: folds
MrOrange: folds
Hattori: raises 125 to 225
MrBlue: folds
Pluribus: folds
Uncalled bet (125) returned to Hattori
Hattori collected 250.0 from pot
*** SUMMARY ***
Total pot 250 | Rake 0


PokerStars Hand #77113: Hold'em No Limit (50/100) - 2019/07/11 21:25:13 ET
Table 'Pluribus Session 77' 6-max (Play Money) Seat #6 is the button
Seat 1: Pluribus (10000 in chips)
Seat 2: Budd (10000 in chips)
Seat 3: MrWhite (10000 in chips)
Seat 4: MrOrange (10000 in chips)
Seat 5: Hattori (10000 in chips)
Seat 6: MrBlue (10000 in chips)
Pluribus: posts small blind 50
Budd: posts big blind 100
*** HOLE CARDS ***
Dealt to Pluribus [7s Ah]
Dealt to Budd [8d 2s]
Dealt to MrWhite [Qh Th]
Dealt to MrOrange [Qd Jh]
Dealt to Hattori [8h 9s]
Dealt to MrBlue [Tc As]
MrWhite: raises 125 to 225
MrOrange: folds
Hattori: folds
MrBlue: folds
Pluribus: folds
Budd: folds
Uncalled bet (125) returned to MrWhite
MrWhite collected 250.0 from pot
*** SUMMARY ***
Total pot 250 | Rake 0


PokerStars Hand #77114: Hold'em No Limit (50/100) - 2019/07/11 21:25:14 ET
Table 'Pluribus Session 77' 6-max (Play Money) Seat #6 is the button
Seat 1: Budd (10000 in chips)
Seat 2: MrWhite (10000 in chips)
Seat 3: MrOrange (10000 in chips)
Seat 4: Hattori (10000 in chips)
Seat 5: MrBlue (10000 in chips)
Seat 6: Pluribus (10000 in chips)
Budd: posts small blind 50
MrWhite: posts big blind 100
*** HOLE CARDS ***
Dealt to Budd [2c 6h]
Dealt to MrWhite [5c 3s]
Dealt to MrOrange [9c 3h]
Dealt to Hattori [3c As]
Dealt to MrBlue [Jd Kh]
Dealt to Pluribus [Qs 9h]
MrOrange: folds
Hattori: folds
MrBlue: raises 125 to 225
Pluribus: folds
Budd: folds
MrWhite: folds
Uncalled bet (125) returned to MrBlue
MrBlue collected 250.0 from pot
*** SUMMARY ***
Total pot 250 | Rake 0


PokerStars Hand #77115: Hold'em No Limit (50/100) - 2019/07/11 21:25:15 ET
Table 'Pluribus Session 77' 6-max (Play Money) Seat #6 is the button
Seat 1: MrWhite (10000 in chips)
Seat 2: MrOrange (10000 in chips)
Seat 3: Hattori (10000 in chips)
Seat 4: MrBlue (10000 in chips)
Seat 5: Pluribus (10000 in chips)
Seat 6: Budd (10000 in chips)
MrWhite: posts small blind 50
MrOrange: posts big blind 100
*** HOLE CARDS ***
Dealt to MrWhite [Js 6s]
Dealt to MrOrange [5s Ts]
Dealt to Hattori [7h 4d]
Dealt to MrBlue [3d 7c]
Dealt to Pluribus [8c 8s]
Dealt to Budd [4s 6c]
Hattori: folds
MrBlue: folds
Pluribus: raises 100 to 200
Budd: folds
MrWhite: folds
MrOrange: folds
Uncalled bet (100) returned to Pluribus
Pluribus collected 250.0 from pot
*** SUMMARY ***
Total pot 250 | Rake 0


PokerStars Hand #77116: Hold'em No Limit (50/100) - 2019/07/11 21:25:16 ET
Table 'Pluribus Session 77' 6-max (Play Money) Seat #6 is the button
Seat 1: MrOrange (10000 in chips)
Seat 2: Hattori (10000 in chips)
Seat 3: MrBlue (10000 in chips)
Seat 4: Pluribus (10000 in chips)
Seat 5: Budd (10000 in chips)
Seat 6: MrWhite (10000 in chips)
MrOrange: posts small blind 50
Hattori: posts big blind 100
*** HOLE CARDS ***
Dealt to MrOrange [4c 8d]
Dealt to Hattori [As 6d]
Dealt to MrBlue [Qc Td]
Dealt to Pluribus [Ad 5c]
Dealt to Budd [Qs Kc]
Dealt to MrWhite [2s Qh]
MrBlue: folds
Pluribus: folds
Budd: raises 125 to 225
MrWhite: folds
MrOrange: folds
Hattori: calls 125
*** FLOP *** [5d 7s 3h]
Hattori: checks
Budd: checks
*** TURN *** [5d 7s 3h] [Jd]
Hattori: bets 800
Budd: folds
Uncalled bet (800) returned to Hattori
Hattori collected 500.0 from pot
*** SUMMARY ***
Total pot 500 | Rake 0
Board [5d 7s 3h Jd]


PokerStars Hand #77117: Hold'em No Limit (50/100) - 2019/07/11 21:25:17 ET
Table 'Pluribus Session 77' 6-max (Play Money) Seat #6 is the button
Seat 1: Hattori (10000 in chips)
Seat 2: MrBlue (10000 in chips)
Seat 3: Pluribus (10000 in chips)
Seat 4: Budd (10000 in chips)
Seat 5: MrWhite (10000 in chips)
Seat 6: MrOrange (10000 in chips)
Hattori: posts small blind 50
MrBlue: posts big blind 100
*** HOLE CARDS ***
Dealt to Hattori [Ac Qc]
Dealt to MrBlue [Ah Th]
Dealt to Pluribus [9h 8d]
Dealt to Budd [3s 4d]
Dealt to MrWhite [Qd Tc]
Dealt to MrOrange [7c 8s]
Pluribus: folds
Budd: folds
MrWhite: folds
MrOrange: folds
Hattori: raises 135 to 235
MrBlue: raises 534 to 769
Hattori: calls 534
*** FLOP *** [6s Qs 3h]
Hattori: checks
MrBlue: checks
*** TURN *** [6s Qs 3h] [Ts]
Hattori: bets 1100
MrBlue: calls 1100
*** RIVER *** [6s Qs 3h] [Ts] [Ks]
Hattori: checks
MrBlue: bets 5925
Hattori: folds
Uncalled bet (5925) returned to MrBlue
MrBlue collected 3738.0 from pot
*** SUMMARY ***
Total pot 3738 | Rake 0
Board [6s Qs 3h Ts Ks]


PokerStars Hand #77118: Hold'em No Limit (50/100) - 2019/07/11 21:25:18 ET
Table 'Pluribus Session 77' 6-max (Play Money) Seat #6 is the button
Seat 1: MrBlue (10000 in chips)
Seat 2: Pluribus (10000 in chips)
Seat 3: Budd (10000 in chips)
Seat 4: MrWhite (10000 in chips)
Seat 5: MrOrange (10000 in chips)
Seat 6: Hattori (10000 in chips)
MrBlue: posts small blind 50
Pluribus: posts big blind 100
*** HOLE CARDS ***
Dealt to MrBlue [7h Qc]
Dealt to Pluribus [6c As]
Dealt to Budd [9s 5d]
Dealt to MrWhite [6d 4s]
Dealt to MrOrange [8c Td]
Dealt to Hattori [Js 7s]
Budd: folds
MrWhite: folds
MrOrange: folds
Hattori: raises 125 to 225
MrBlue: folds
Pluribus: calls 125
*** FLOP *** [3c Kh Kc]
Pluribus: checks
Hattori: bets 125
Pluribus: calls 125
*** TURN *** [3c Kh Kc] [Qs]
Pluribus: checks
Hattori: bets 750
Pluribus: folds
Uncalled bet (750) returned to Hattori
Hattori collected 750.0 from pot
*** SUMMARY ***
Total pot 750 | Rake 0
Board [3c Kh Kc Qs]


PokerStars Hand #77119: Hold'em No Limit (50/100) - 2019/07/11 21:25:19 ET
Table 'Pluribus Session 77' 6-max (Play Money) Seat #6 is the button
Seat 1: Pluribus (10000 in chips)
Seat 2: Budd (10000 in chips)
Seat 3: MrWhite (10000 in chips)
Seat 4: MrOrange (10000 in chips)
Seat 5: Hattori (10000 in chips)
Seat 6: MrBlue (10000 in chips)
Pluribus: posts small blind 50
Budd: posts big blind 100
*** HOLE CARDS ***
Dealt to Pluribus [Ts 3d]
Dealt to Budd [8h 4d]
Dealt to MrWhite [Js 7d]
Dealt to MrOrange [8c 9d]
Dealt to Hattori [7s 2c]
Dealt to MrBlue [Ad 4c]
MrWhite: folds
MrOrange: folds
Hattori: folds
MrBlue: raises 125 to 225
Pluribus: folds
Budd: folds
Uncalled bet (125) returned to MrBlue
MrBlue collected 250.0 from pot
*** SUMMARY ***
Total pot 250 | Rake 0


PokerStars Hand #77120: Hold'em No Limit (50/100) - 2019/07/11 21:25:20 ET
Table 'Pluribus Session 77' 6-max (Play Money) Seat #6 is the button
Seat 1: Budd (10000 in chips)
Seat 2: MrWhite (10000 in chips)
Seat 3: MrOrange (10000 in chips)
Seat 4: Hattori (10000 in chips)
Seat 5: MrBlue (10000 in chips)
Seat 6: Pluribus (10000 in chips)
Budd: posts small blind 50
MrWhite: posts big blind 100
*** HOLE CARDS ***
Dealt to Budd [9d 2c]
Dealt to MrWhite [As 8d]
Dealt to MrOrange [Jh 2h]
Dealt to Hattori [Kc Td]
Dealt to MrBlue [Qh 4h]
Dealt to Pluribus [6h Th]
MrOrange: folds
Hattori: raises 100 to 200
MrBlue: folds
Pluribus: folds
Budd: folds
MrWhite: calls 100
*** FLOP *** [Jd 7d Qs]
MrWhite: checks
Hattori: bets 110
MrWhite: folds
Uncalled bet (110) returned to Hattori
Hattori collected 450.0 from pot
*** SUMMARY ***
Total pot 450 | Rake 0
Board [Jd 7d Qs]


PokerStars Hand #77121: Hold'em No Limit (50/100) - 2019/07/11 21:25:21 ET
Table 'Pluribus Session 77' 6-max (Play Money) Seat #6 is the button
Seat 1: MrWhite (10000 in chips)
Seat 2: MrOrange (10000 in chips)
Seat 3: Hattori (10000 in chips)
Seat 4: MrBlue (10000 in chips)
Seat 5: Pluribus (10000 in chips)
Seat 6: Budd (10000 in chips)
MrWhite: posts small blind 50
MrOrange: posts big blind 100
*** HOLE CARDS ***
Dealt to MrWhite [4s Kd]
Dealt to MrOrange [Th 8s]
Dealt to Hattori [Qh 3d]
Dealt to MrBlue [Ad 4h]
Dealt to Pluribus [Tc 6c]
Dealt to Budd [9c Qc]
Hattori: folds
MrBlue: folds
Pluribus: folds
Budd: raises 150 to 250
MrWhite: folds
MrOrange: folds
Uncalled bet (150) returned to Budd
Budd collected 250.0 from pot
*** SUMMARY ***
Total pot 250 | Rake 0


PokerStars Hand #77122: Hold'em No Limit (50/100) - 2019/07/11 21:25:22 ET
Table 'Pluribus Session 77' 6-max (Play Money) Seat #6 is the button
Seat 1: MrOrange (10000 in chips)
Seat 2: Hattori (10000 in chips)
Seat 3: MrBlue (10000 in chips)
Seat 4: Pluribus (10000 in chips)
Seat 5: Budd (10000 in chips)
Seat 6: MrWhite (10000 in chips)
MrOrange: posts small blind 50
Hattori: posts big blind 100
*** HOLE CARDS ***
Dealt to MrOrange [8h Jh]
Dealt to Hattori [3h 7s]
Dealt to MrBlue [Js Qd]
Dealt to Pluribus [4h 7h]
Dealt to Budd [6s 5d]
Dealt to MrWhite [Ad 3s]
MrBlue: folds
Pluribus: folds
Budd: folds
MrWhite: raises 125 to 225
MrOrange: folds
Hattori: folds
Uncalled bet (125) returned to MrWhite
MrWhite collected 250.0 from pot
*** SUMMARY ***
Total pot 250 | Rake 0


PokerStars Hand #77123: Hold'em No Limit (50/100) - 2019/07/11 21:25:23 ET
Table 'Pluribus Session 77' 6-max (Play Money) Seat #6 is the button
Seat 1: Hattori (10000 in chips)
Seat 2: MrBlue (10000 in chips)
Seat 3: Pluribus (10000 in chips)
Seat 4: Budd (10000 in chips)
Seat 5: MrWhite (10000 in chips)
Seat 6: MrOrange (10000 in chips)
Hattori: posts small blind 50
MrBlue: posts big blind 100
*** HOLE CARDS ***
Dealt to Hattori [7d 4c]
Dealt to MrBlue [Js Qh]
Dealt to Pluribus [9d Ac]
Dealt to Budd [Jd 8s]
Dealt to MrWhite [9s 5d]
Dealt to MrOrange [3h 7h]
Pluribus: folds
Budd: folds
MrWhite: folds
MrOrange: folds
Hattori: folds
Uncalled bet (50) returned to MrBlue
MrBlue collected 100.0 from pot
*** SUMMARY ***
Total pot 100 | Rake 0


PokerStars Hand #77124: Hold'em No Limit (50/100) - 2019/07/11 21:25:24 ET
Table 'Pluribus Session 77' 6-max (Play Money) Seat #6 is the button
Seat 1: MrBlue (10000 in chips)
Seat 2: Pluribus (10000 in chips)
Seat 3: Budd (10000 in chips)
Seat 4: MrWhite (10000 in chips)
Seat 5: MrOrange (10000 in chips)
Seat 6: Hattori (10000 in chips)
MrBlue: posts small blind 50
Pluribus: posts big blind 100
*** HOLE CARDS ***
Dealt to MrBlue [5s 9s]
Dealt to Pluribus [8s Td]
Dealt to Budd [4h Ad]
Dealt to MrWhite [3d 4d]
Dealt to MrOrange [Jc 2h]
Dealt to Hattori [Jh 6c]
Budd: folds
MrWhite: folds
MrOrange: folds
Hattori: folds
MrBlue: calls 50
Pluribus: raises 200 to 300
MrBlue: calls 200
*** FLOP *** [3c Qh Tc]
MrBlue: checks
Pluribus: checks
*** TURN *** [3c Qh Tc] [4s]
MrBlue: checks
Pluribus: bets 300
MrBlue: folds
Uncalled bet (300) returned to Pluribus
Pluribus collected 600.0 from pot
*** SUMMARY ***
Total pot 600 | Rake 0
Board [3c Qh Tc 4s]


PokerStars Hand #77125: Hold'em No Limit (50/100) - 2019/07/11 21:25:25 ET
Table 'Pluribus Session 77' 6-max (Play Money) Seat #6 is the button
Seat 1: Pluribus (10000 in chips)
Seat 2: Budd (10000 in chips)
Seat 3: MrWhite (10000 in chips)
Seat 4: MrOrange (10000 in chips)
Seat 5: Hattori (10000 in chips)
Seat 6: MrBlue (10000 in chips)
Pluribus: posts small blind 50
Budd: posts big blind 100
*** HOLE CARDS ***
Dealt to Pluribus [Ks Th]
Dealt to Budd [6s 4d]
Dealt to MrWhite [6h 4h]
Dealt to MrOrange [Jd 8d]
Dealt to Hattori [Qd Js]
Dealt to MrBlue [Qs 4s]
MrWhite: folds
MrOrange: folds
Hattori: raises 111 to 211
MrBlue: folds
Pluribus: folds
Budd: folds
Uncalled bet (111) returned to Hattori
Hattori collected 250.0 from pot
*** SUMMARY ***
Total pot 250 | Rake 0


PokerStars Hand #77126: Hold'em No Limit (50/100) - 2019/07/11 21:25:26 ET
Table 'Pluribus Session 77' 6-max (Play Money) Seat #6 is the button
Seat 1: Budd (10000 in chips)
Seat 2: MrWhite (10000 in chips)
Seat 3: MrOrange (10000 in chips)
Seat 4: Hattori (10000 in chips)
Seat 5: MrBlue (10000 in chips)
Seat 6: Pluribus (10000 in chips)
Budd: posts small blind 50
MrWhite: posts big blind 100
*** HOLE CARDS ***
Dealt to Budd [As 4s]
Dealt to MrWhite [6c Kc]
Dealt to MrOrange [Qd 4c]
Dealt to Hattori [5h 7c]
Dealt to MrBlue [9h 5d]
Dealt to Pluribus [Jd 8c]
MrOrange: folds
Hattori: folds
MrBlue: folds
Pluribus: folds
Budd: raises 200 to 300
MrWhite: calls 200
*** FLOP *** [3h Ad Ac]
Budd: bets 150
MrWhite: calls 150
*** TURN *** [3h Ad Ac] [4d]
Budd: checks
MrWhite: checks
*** RIVER *** [3h Ad Ac] [4d] [6s]
Budd: bets 300
MrWhite: calls 300
*** SHOWDOWN ***
Budd: shows [As 4s]
Budd collected 1500.0 from pot
*** SUMMARY ***
Total pot 1500 | Rake 0
Board [3h Ad Ac 4d 6s]
Seat 1: Budd showed [As 4s] and won (1500.0)
Seat 2: MrWhite showed [6c Kc] and lost


PokerStars Hand #77127: Hold'em No Limit (50/100) - 2019/07/11 21:25:27 ET
Table 'Pluribus Session 77' 6-max (Play Money) Seat #6 is the button
Seat 1: MrWhite (10000 in chips)
Seat 2: MrOrange (10000 in chips)
Seat 3: Hattori (10000 in chips)
Seat 4: MrBlue (10000 in chips)
Seat 5: Pluribus (10000 in chips)
Seat 6: Budd (10000 in chips)
MrWhite: posts small blind 50
MrOrange: posts big blind 100
*** HOLE CARDS ***
Dealt to MrWhite [3s 2s]
Dealt to MrOrange [Kh 9s]
Dealt to Hattori [9h 7h]
Dealt to MrBlue [Kc 8s]
Dealt to Pluribus [Ks 4s]
Dealt to Budd [6h 8d]
Hattori: raises 100 to 200
MrBlue: folds
Pluribus: folds
Budd: folds
MrWhite: folds
MrOrange: folds
Uncalled bet (100) returned to Hattori
Hattori collected 250.0 from pot
*** SUMMARY ***
Total pot 250 | Rake 0


PokerStars Hand #77128: Hold'em No Limit (50/100) - 2019/07/11 21:25:28 ET
Table 'Pluribus Session 77' 6-max (Play Money) Seat #6 is the button
Seat 1: MrOrange (10000 in chips)
Seat 2: Hattori (10000 in chips)
Seat 3: MrBlue (10000 in chips)
Seat 4: Pluribus (10000 in chips)
Seat 5: Budd (10000 in chips)
Seat 6: MrWhite (10000 in chips)
MrOrange: posts small blind 50
Hattori: posts big blind 100
*** HOLE CARDS ***
Dealt to MrOrange [Kd 8s]
Dealt to Hattori [Ac 2h]
Dealt to MrBlue [6c 9d]
Dealt to Pluribus [2d Js]
Dealt to Budd [7s 2c]
Dealt to MrWhite [7h 6h]
MrBlue: folds
Pluribus: folds
Budd: folds
MrWhite: raises 125 to 225
MrOrange: folds
Hattori: calls 125
*** FLOP *** [9c 3s 3h]
Hattori: checks
MrWhite: bets 250
Hattori: folds
Uncalled bet (250) returned to MrWhite
MrWhite collected 500.0 from pot
*** SUMMARY ***
Total pot 500 | Rake 0
Board [9c 3s 3h]


PokerStars Hand #77129: Hold'em No Limit (50/100) - 2019/07/11 21:25:29 ET
Table 'Pluribus Session 77' 6-max (Play Money) Seat #6 is the button
Seat 1: Hattori (10000 in chips)
Seat 2: MrBlue (10000 in chips)
Seat 3: Pluribus (10000 in chips)
Seat 4: Budd (10000 in chips)
Seat 5: MrWhite (10000 in chips)
Seat 6: MrOrange (10000 in chips)
Hattori: posts small blind 50
MrBlue: posts big blind 100
*** HOLE CARDS ***
Dealt to Hattori [8h Td]
Dealt to MrBlue [4s 8d]
Dealt to Pluribus [Js As]
Dealt to Budd [2d Qh]
Dealt to MrWhite [6s Ts]
Dealt to MrOrange [6d 2c]
Pluribus: raises 100 to 200
Budd: folds
MrWhite: folds
MrOrange: folds
Hattori: folds
MrBlue: folds
Uncalled bet (100) returned to Pluribus
Pluribus collected 250.0 from pot
*** SUMMARY ***
Total pot 250 | Rake 0


PokerStars Hand #77130: Hold'em No Limit (50/100) - 2019/07/11 21:25:30 ET
Table 'Pluribus Session 77' 6-max (Play Money) Seat #6 is the button
Seat 1: MrBlue (10000 in chips)
Seat 2: Pluribus (10000 in chips)
Seat 3: Budd (10000 in chips)
Seat 4: MrWhite (10000 in chips)
Seat 5: MrOrange (10000 in chips)
Seat 6: Hattori (10000 in chips)
MrBlue: posts small blind 50
Pluribus: posts big blind 100
*** HOLE CARDS ***
Dealt to MrBlue [5c Qh]
Dealt to Pluribus [5d 7s]
Dealt to Budd [6d Jd]
Dealt to MrWhite [Js Jc]
Dealt to MrOrange [6h 3h]
Dealt to Hattori [Qd Qc]
Budd: folds
MrWhite: raises 125 to 225
MrOrange: folds
Hattori: calls 225
MrBlue: folds
Pluribus: folds
*** FLOP *** [Qs Ks 5s]
MrWhite: checks
Hattori: checks
*** TURN *** [Qs Ks 5s] [As]
MrWhite: checks
Hattori: checks
*** RIVER *** [Qs Ks 5s] [As] [4h]
MrWhite: bets 450
Hattori: calls 450
*** SHOWDOWN ***
MrWhite: shows [Js Jc]
MrWhite collected 1500.0 from pot
*** SUMMARY ***
Total pot 1500 | Rake 0
Board [Qs Ks 5s As 4h]
Seat 4: MrWhite showed [Js Jc] and won (1500.0)
Seat 6: Hattori showed [Qd Qc] and lost


PokerStars Hand #77131: Hold'em No Limit (50/100) - 2019/07/11 21:25:31 ET
Table 'Pluribus Session 77' 6-max (Play Money) Seat #6 is the button
Seat 1: Pluribus (10000 in chips)
Seat 2: Budd (10000 in chips)
Seat 3: MrWhite (10000 in chips)
Seat 4: MrOrange (10000 in chips)
Seat 5: Hattori (10000 in chips)
Seat 6: MrBlue (10000 in chips)
Pluribus: posts small blind 50
Budd: posts big blind 100
*** HOLE CARDS ***
Dealt to Pluribus [2s As]
Dealt to Budd [Qd 7s]
Dealt to MrWhite [5h Ah]
Dealt to MrOrange [4d Ac]
Dealt to Hattori [5d 9h]
Dealt to MrBlue [6c 2c]
MrWhite: raises 125 to 225
MrOrange: folds
Hattori: folds
MrBlue: folds
Pluribus: folds
Budd: folds
Uncalled bet (125) returned to MrWhite
MrWhite collected 250.0 from pot
*** SUMMARY ***
Total pot 250 | Rake 0


PokerStars Hand #77132: Hold'em No Limit (50/100) - 2019/07/11 21:25:32 ET
Table 'Pluribus Session 77' 6-max (Play Money) Seat #6 is the button
Seat 1: Budd (10000 in chips)
Seat 2: MrWhite (10000 in chips)
Seat 3: MrOrange (10000 in chips)
Seat 4: Hattori (10000 in chips)
Seat 5: MrBlue (10000 in chips)
Seat 6: Pluribus (10000 in chips)
Budd: posts small blind 50
MrWhite: posts big blind 100
*** HOLE CARDS ***
Dealt to Budd [4c Ad]
Dealt to MrWhite [7s Jd]
Dealt to MrOrange [6s 3c]
Dealt to Hattori [6h Kd]
Dealt to MrBlue [7c 4s]
Dealt to Pluribus [8h 5h]
MrOrange: folds
Hattori: folds
MrBlue: folds
Pluribus: raises 125 to 225
Budd: folds
MrWhite: folds
Uncalled bet (125) returned to Pluribus
Pluribus collected 250.0 from pot
*** SUMMARY ***
Total pot 250 | Rake 0


PokerStars Hand #77133: Hold'em No Limit (50/100) - 2019/07/11 21:25:33 ET
Table 'Pluribus Session 77' 6-max (Play Money) Seat #6 is the button
Seat 1: MrWhite (10000 in chips)
Seat 2: MrOrange (10000 in chips)
Seat 3: Hattori (10000 in chips)
Seat 4: MrBlue (10000 in chips)
Seat 5: Pluribus (10000 in chips)
Seat 6: Budd (10000 in chips)
MrWhite: posts small blind 50
MrOrange: posts big blind 100
*** HOLE CARDS ***
Dealt to MrWhite [5s Kd]
Dealt to MrOrange [Jd 8s]
Dealt to Hattori [5d Ah]
Dealt to MrBlue [Qs 9h]
Dealt to Pluribus [6h Kc]
Dealt to Budd [Jc 4d]
Hattori: folds
MrBlue: folds
Pluribus: folds
Budd: folds
MrWhite: folds
Uncalled bet (50) returned to MrOrange
MrOrange collected 100.0 from pot
*** SUMMARY ***
Total pot 100 | Rake 0


PokerStars Hand #77134: Hold'em No Limit (50/100) - 2019/07/11 21:25:34 ET
Table 'Pluribus Session 77' 6-max (Play Money) Seat #6 is the button
Seat 1: MrOrange (10000 in chips)
Seat 2: Hattori (10000 in chips)
Seat 3: MrBlue (10000 in chips)
Seat 4: Pluribus (10000 in chips)
Seat 5: Budd (10000 in chips)
Seat 6: MrWhite (10000 in chips)
MrOrange: posts small blind 50
Hattori: posts big blind 100
*** HOLE CARDS ***
Dealt to MrOrange [2c Ah]
Dealt to Hattori [8h Js]
Dealt to MrBlue [4c Qs]
Dealt to Pluribus [9s Ts]
Dealt to Budd [Th 8s]
Dealt to MrWhite [3s 8d]
MrBlue: folds
Pluribus: raises 100 to 200
Budd: folds
MrWhite: folds
MrOrange: folds
Hattori: calls 100
*** FLOP *** [Qd Jd Ac]
Hattori: checks
Pluribus: bets 225
Hattori: calls 225
*** TURN *** [Qd Jd Ac] [4h]
Hattori: checks
Pluribus: bets 900
Hattori: folds
Uncalled bet (900) returned to Pluribus
Pluribus collected 900.0 from pot
*** SUMMARY ***
Total pot 900 | Rake 0
Board [Qd Jd Ac 4h]


PokerStars Hand #77135: Hold'em No Limit (50/100) - 2019/07/11 21:25:35 ET
Table 'Pluribus Session 77' 6-max (Play Money) Seat #6 is the button
Seat 1: Hattori (10000 in chips)
Seat 2: MrBlue (10000 in chips)
Seat 3: Pluribus (10000 in chips)
Seat 4: Budd (10000 in chips)
Seat 5: MrWhite (10000 in chips)
Seat 6: MrOrange (10000 in chips)
Hattori: posts small blind 50
MrBlue: posts big blind 100
*** HOLE CARDS ***
Dealt to Hattori [5s Ad]
Dealt to MrBlue [9h As]
Dealt to Pluribus [7c Ah]
Dealt to Budd [4d 3h]
Dealt to MrWhite [8h 5c]
Dealt to MrOrange [9c 8c]
Pluribus: folds
Budd: folds
MrWhite: folds
MrOrange: raises 124 to 224
Hattori: folds
MrBlue: calls 124
*** FLOP *** [Jd 6s Qc]
MrBlue: checks
MrOrange: bets 275
MrBlue: folds
Uncalled bet (275) returned to MrOrange
MrOrange collected 498.0 from pot
*** SUMMARY ***
Total pot 498 | Rake 0
Board [Jd 6s Qc]


PokerStars Hand #77136: Hold'em No Limit (50/100) - 2019/07/11 21:25:36 ET
Table 'Pluribus Session 77' 6-max (Play Money) Seat #6 is the button
Seat 1: MrBlue (10000 in chips)
Seat 2: Pluribus (10000 in chips)
Seat 3: Budd (10000 in chips)
Seat 4: MrWhite (10000 in chips)
Seat 5: MrOrange (10000 in chips)
Seat 6: Hattori (10000 in chips)
MrBlue: posts small blind 50
Pluribus: posts big blind 100
*** HOLE CARDS ***
Dealt to MrBlue [8c 7h]
Dealt to Pluribus [8d 9d]
Dealt to Budd [5d 4s]
Dealt to MrWhite [2d Qs]
Dealt to MrOrange [6s Ah]
Dealt to Hattori [7c 5c]
Budd: folds
MrWhite: folds
MrOrange: folds
Hattori: raises 125 to 225
MrBlue: folds
Pluribus: calls 125
*** FLOP *** [4d 4h Ks]
Pluribus: checks
Hattori: checks
*** TURN *** [4d 4h Ks] [3h]
Pluribus: checks
Hattori: bets 200
Pluribus: folds
Uncalled bet (200) returned to Hattori
Hattori collected 500.0 from pot
*** SUMMARY ***
Total pot 500 | Rake 0
Board [4d 4h Ks 3h]


PokerStars Hand #77137: Hold'em No Limit (50/100) - 2019/07/11 21:25:37 ET
Table 'Pluribus Session 77' 6-max (Play Money) Seat #6 is the button
Seat 1: Pluribus (10000 in chips)
Seat 2: Budd (10000 in chips)
Seat 3: MrWhite (10000 in chips)
Seat 4: MrOrange (10000 in chips)
Seat 5: Hattori (10000 in chips)
Seat 6: MrBlue (10000 in chips)
Pluribus: posts small blind 50
Budd: posts big blind 100
*** HOLE CARDS ***
Dealt to Pluribus [Js 2d]
Dealt to Budd [As 2h]
Dealt to MrWhite [Qc 5h]
Dealt to MrOrange [6h Tc]
Dealt to Hattori [Ah 4d]
Dealt to MrBlue [2c Th]
MrWhite: folds
MrOrange: folds
Hattori: folds
MrBlue: folds
Pluribus: folds
Uncalled bet (50) returned to Budd
Budd collected 100.0 from pot
*** SUMMARY ***
Total pot 100 | Rake 0


PokerStars Hand #77138: Hold'em No Limit (50/100) - 2019/07/11 21:25:38 ET
Table 'Pluribus Session 77' 6-max (Play Money) Seat #6 is the button
Seat 1: Budd (10000 in chips)
Seat 2: MrWhite (10000 in chips)
Seat 3: MrOrange (10000 in chips)
Seat 4: Hattori (10000 in chips)
Seat 5: MrBlue (10000 in chips)
Seat 6: Pluribus (10000 in chips)
Budd: posts small blind 50
MrWhite: posts big blind 100
*** HOLE CARDS ***
Dealt to Budd [Qs 2h]
Dealt to MrWhite [3h 8d]
Dealt to MrOrange [9d Kd]
Dealt to Hattori [2s 3s]
Dealt to MrBlue [Ad 4c]
Dealt to Pluribus [Kc 9h]
MrOrange: folds
Hattori: folds
MrBlue: raises 125 to 225
Pluribus: folds
Budd: folds
MrWhite: folds
Uncalled bet (125) returned to MrBlue
MrBlue collected 250.0 from pot
*** SUMMARY ***
Total pot 250 | Rake 0


PokerStars Hand #77139: Hold'em No Limit (50/100) - 2019/07/11 21:25:39 ET
Table 'Pluribus Session 77' 6-max (Play Money) Seat #6 is the button
Seat 1: MrWhite (10000 in chips)
Seat 2: MrOrange (10000 in chips)
Seat 3: Hattori (10000 in chips)
Seat 4: MrBlue (10000 in chips)
Seat 5: Pluribus (10000 in chips)
Seat 6: Budd (10000 in chips)
MrWhite: posts small blind 50
MrOrange: posts big blind 100
*** HOLE CARDS ***
Dealt to MrWhite [Td 8d]
Dealt to MrOrange [4d Jc]
Dealt to Hattori [3c 3h]
Dealt to MrBlue [Qc Kh]
Dealt to Pluribus [6c Js]
Dealt to Budd [Kc 5c]
Hattori: folds
MrBlue: raises 125 to 225
Pluribus: folds
Budd: folds
MrWhite: folds
MrOrange: folds
Uncalled bet (125) returned to MrBlue
MrBlue collected 250.0 from pot
*** SUMMARY ***
Total pot 250 | Rake 0


PokerStars Hand #77140: Hold'em No Limit (50/100) - 2019/07/11 21:25:40 ET
Table 'Pluribus Session 77' 6-max (Play Money) Seat #6 is the button
Seat 1: MrOrange (10000 in chips)
Seat 2: Hattori (10000 in chips)
Seat 3: MrBlue (10000 in chips)
Seat 4: Pluribus (10000 in chips)
Seat 5: Budd (10000 in chips)
Seat 6: MrWhite (10000 in chips)
MrOrange: posts small blind 50
Hattori: posts big blind 100
*** HOLE CARDS ***
Dealt to MrOrange [9s 8h]
Dealt to Hattori [Qd Td]
Dealt to MrBlue [4s Ad]
Dealt to Pluribus [5h 3h]
Dealt to Budd [3c Ah]
Dealt to MrWhite [6c Qs]
MrBlue: folds
Pluribus: folds
Budd: folds
MrWhite: folds
MrOrange: folds
Uncalled bet (50) returned to Hattori
Hattori collected 100.0 from pot
*** SUMMARY ***
Total pot 100 | Rake 0


PokerStars Hand #77141: Hold'em No Limit (50/100) - 2019/07/11 21:25:41 ET
Table 'Pluribus Session 77' 6-max (Play Money) Seat #6 is the button
Seat 1: Hattori (10000 in chips)
Seat 2: MrBlue (10000 in chips)
Seat 3: Pluribus (10000 in chips)
Seat 4: Budd (10000 in chips)
Seat 5: MrWhite (10000 in chips)
Seat 6: MrOrange (10000 in chips)
Hattori: posts small blind 50
MrBlue: posts big blind 100
*** HOLE CARDS ***
Dealt to Hattori [2d 6s]
Dealt to MrBlue [Kc Ac]
Dealt to Pluribus [Qd 6d]
Dealt to Budd [Ad 9d]
Dealt to MrWhite [3d 9c]
Dealt to MrOrange [As 8h]
Pluribus: folds
Budd: raises 125 to 225
MrWhite: folds
MrOrange: folds
Hattori: folds
MrBlue: raises 850 to 1075
Budd: folds
Uncalled bet (850) returned to MrBlue
MrBlue collected 500.0 from pot
*** SUMMARY ***
Total pot 500 | Rake 0


PokerStars Hand #77142: Hold'em No Limit (50/100) - 2019/07/11 21:25:42 ET
Table 'Pluribus Session 77' 6-max (Play Money) Seat #6 is the button
Seat 1: MrBlue (10000 in chips)
Seat 2: Pluribus (10000 in chips)
Seat 3: Budd (10000 in chips)
Seat 4: MrWhite (10000 in chips)
Seat 5: MrOrange (10000 in chips)
Seat 6: Hattori (10000 in chips)
MrBlue: posts small blind 50
Pluribus: posts big blind 100
*** HOLE CARDS ***
Dealt to MrBlue [Kd 7c]
Dealt to Pluribus [8d 4h]
Dealt to Budd [8h Jh]
Dealt to MrWhite [Ad Js]
Dealt to MrOrange [Kc 5d]
Dealt to Hattori [8c Qs]
Budd: folds
MrWhite: raises 125 to 225
MrOrange: folds
Hattori: folds
MrBlue: folds
Pluribus: folds
Uncalled bet (125) returned to MrWhite
MrWhite collected 250.0 from pot
*** SUMMARY ***
Total pot 250 | Rake 0


PokerStars Hand #77143: Hold'em No Limit (50/100) - 2019/07/11 21:25:43 ET
Table 'Pluribus Session 77' 6-max (Play Money) Seat #6 is the button
Seat 1: Pluribus (10000 in chips)
Seat 2: Budd (10000 in chips)
Seat 3: MrWhite (10000 in chips)
Seat 4: MrOrange (10000 in chips)
Seat 5: Hattori (10000 in chips)
Seat 6: MrBlue (10000 in chips)
Pluribus: posts small blind 50
Budd: posts big blind 100
*** HOLE CARDS ***
Dealt to Pluribus [5d Jc]
Dealt to Budd [7c 4s]
Dealt to MrWhite [As Qc]
Dealt to MrOrange [5h 9s]
Dealt to Hattori [5c 2d]
Dealt to MrBlue [3d 6h]
MrWhite: raises 125 to 225
MrOrange: folds
Hattori: folds
MrBlue: folds
Pluribus: folds
Budd: folds
Uncalled bet (125) returned to MrWhite
MrWhite collected 250.0 from pot
*** SUMMARY ***
Total pot 250 | Rake 0


PokerStars Hand #77144: Hold'em No Limit (50/100) - 2019/07/11 21:25:44 ET
Table 'Pluribus Session 77' 6-max (Play Money) Seat #6 is the button
Seat 1: Budd (10000 in chips)
Seat 2: MrWhite (10000 in chips)
Seat 3: MrOrange (10000 in chips)
Seat 4: Hattori (10000 in chips)
Seat 5: MrBlue (10000 in chips)
Seat 6: Pluribus (10000 in chips)
Budd: posts small blind 50
MrWhite: posts big blind 100
*** HOLE CARDS ***
Dealt to Budd [Ah Qd]
Dealt to MrWhite [Ac Jh]
Dealt to MrOrange [Kc 3d]
Dealt to Hattori [5d Kd]
Dealt to MrBlue [Tc 2h]
Dealt to Pluribus [9c Jc]
MrOrange: folds
Hattori: folds
MrBlue: folds
Pluribus: raises 125 to 225
Budd: raises 675 to 900
MrWhite: folds
Pluribus: calls 675
*** FLOP *** [9s Qs Qh]
Budd: checks
Pluribus: checks
*** TURN *** [9s Qs Qh] [8s]
Budd: checks
Pluribus: checks
*** RIVER *** [9s Qs Qh] [8s] [4c]
Budd: bets 1900
Pluribus: calls 1900
*** SHOWDOWN ***
Budd: shows [Ah Qd]
Budd collected 5700.0 from pot
*** SUMMARY ***
Total pot 5700 | Rake 0
Board [9s Qs Qh 8s 4c]
Seat 1: Budd showed [Ah Qd] and won (5700.0)
Seat 6: Pluribus showed [9c Jc] and lost


PokerStars Hand #77145: Hold'em No Limit (50/100) - 2019/07/11 21:25:45 ET
Table 'Pluribus Session 77' 6-max (Play Money) Seat #6 is the button
Seat 1: MrWhite (10000 in chips)
Seat 2: MrOrange (10000 in chips)
Seat 3: Hattori (10000 in chips)
Seat 4: MrBlue (10000 in chips)
Seat 5: Pluribus (10000 in chips)
Seat 6: Budd (10000 in chips)
MrWhite: posts small blind 50
MrOrange: posts big blind 100
*** HOLE CARDS ***
Dealt to MrWhite [Qs Ks]
Dealt to MrOrange [Js 7c]
Dealt to Hattori [Kc 9d]
Dealt to MrBlue [3d 8d]
Dealt to Pluribus [Kh Th]
Dealt to Budd [8s 5c]
Hattori: folds
MrBlue: folds
Pluribus: raises 150 to 250
Budd: folds
MrWhite: raises 600 to 850
MrOrange: folds
Pluribus: calls 600
*** FLOP *** [Tc As 9s]
MrWhite: checks
Pluribus: checks
*** TURN *** [Tc As 9s] [6s]
MrWhite: bets 1350
Pluribus: folds
Uncalled bet (1350) returned to MrWhite
MrWhite collected 1800.0 from pot
*** SUMMARY ***
Total pot 1800 | Rake 0
Board [Tc As 9s 6s]


PokerStars Hand #77146: Hold'em No Limit (50/100) - 2019/07/11 21:25:46 ET
Table 'Pluribus Session 77' 6-max (Play Money) Seat #6 is the button
Seat 1: MrOrange (10000 in chips)
Seat 2: Hattori (10000 in chips)
Seat 3: MrBlue (10000 in chips)
Seat 4: Pluribus (10000 in chips)
Seat 5: Budd (10000 in chips)
Seat 6: MrWhite (10000 in chips)
MrOrange: posts small blind 50
Hattori: posts big blind 100
*** HOLE CARDS ***
Dealt to MrOrange [7d 8d]
Dealt to Hattori [6h Qh]
Dealt to MrBlue [4h 7s]
Dealt to Pluribus [8h 3d]
Dealt to Budd [Td 4c]
Dealt to MrWhite [Jh Ad]
MrBlue: folds
Pluribus: folds
Budd: folds
MrWhite: raises 125 to 225
MrOrange: folds
Hattori: calls 125
*** FLOP *** [4d 3h Ac]
Hattori: checks
MrWhite: bets 250
Hattori: raises 650 to 900
MrWhite: calls 650
*** TURN *** [4d 3h Ac] [Ah]
Hattori: checks
MrWhite: bets 800
Hattori: calls 800
*** RIVER *** [4d 3h Ac] [Ah] [6c]
Hattori: checks
MrWhite: bets 1500
Hattori: folds
Uncalled bet (1500) returned to MrWhite
MrWhite collected 3900.0 from pot
*** SUMMARY ***
Total pot 3900 | Rake 0
Board [4d 3h Ac Ah 6c]


PokerStars Hand #77147: Hold'em No Limit (50/100) - 2019/07/11 21:25:47 ET
Table 'Pluribus Session 77' 6-max (Play Money) Seat #6 is the button
Seat 1: Hattori (10000 in chips)
Seat 2: MrBlue (10000 in chips)
Seat 3: Pluribus (10000 in chips)
Seat 4: Budd (10000 in chips)
Seat 5: MrWhite (10000 in chips)
Seat 6: MrOrange (10000 in chips)
Hattori: posts small blind 50
MrBlue: posts big blind 100
*** HOLE CARDS ***
Dealt to Hattori [7d Ah]
Dealt to MrBlue [Td 3d]
Dealt to Pluribus [6c 9d]
Dealt to Budd [Ac Jh]
Dealt to MrWhite [5h Th]
Dealt to MrOrange [3c 7c]
Pluribus: folds
Budd: raises 125 to 225
MrWhite: folds
MrOrange: folds
Hattori: folds
MrBlue: calls 125
*** FLOP *** [Ad Tc Js]
MrBlue: checks
Budd: bets 175
MrBlue: calls 175
*** TURN *** [Ad Tc Js] [7h]
MrBlue: checks
Budd: bets 637
MrBlue: folds
Uncalled bet (637) returned to Budd
Budd collected 850.0 from pot
*** SUMMARY ***
Total pot 850 | Rake 0
Board [Ad Tc Js 7h]


PokerStars Hand #77148: Hold'em No Limit (50/100) - 2019/07/11 21:25:48 ET
Table 'Pluribus Session 77' 6-max (Play Money) Seat #6 is the button
Seat 1: MrBlue (10000 in chips)
Seat 2: Pluribus (10000 in chips)
Seat 3: Budd (10000 in chips)
Seat 4: MrWhite (10000 in chips)
Seat 5: MrOrange (10000 in chips)
Seat 6: Hattori (10000 in chips)
MrBlue: posts small blind 50
Pluribus: posts big blind 100
*** HOLE CARDS ***
Dealt to MrBlue [4h 2d]
Dealt to Pluribus [As Th]
Dealt to Budd [5c 7d]
Dealt to MrWhite [7c Jc]
Dealt to MrOrange [3s 5d]
Dealt to Hattori [3d Ks]
Budd: folds
MrWhite: folds
MrOrange: folds
Hattori: folds
MrBlue: folds
Uncalled bet (50) returned to Pluribus
Pluribus collected 100.0 from pot
*** SUMMARY ***
Total pot 100 | Rake 0


PokerStars Hand #77149: Hold'em No Limit (50/100) - 2019/07/11 21:25:49 ET
Table 'Pluribus Session 77' 6-max (Play Money) Seat #6 is the button
Seat 1: Pluribus (10000 in chips)
Seat 2: Budd (10000 in chips)
Seat 3: MrWhite (10000 in chips)
Seat 4: MrOrange (10000 in chips)
Seat 5: Hattori (10000 in chips)
Seat 6: MrBlue (10000 in chips)
Pluribus: posts small blind 50
Budd: posts big blind 100
*** HOLE CARDS ***
Dealt to Pluribus [2s Ad]
Dealt to Budd [5d 2d]
Dealt to MrWhite [9d 2h]
Dealt to MrOrange [Qc Tc]
Dealt to Hattori [9s Kc]
Dealt to MrBlue [Jd 8c]
MrWhite: folds
MrOrange: raises 110 to 210
Hattori: folds
MrBlue: folds
Pluribus: folds
Budd: calls 110
*** FLOP *** [5s Qs As]
Budd: checks
MrOrange: checks
*** TURN *** [5s Qs As] [6s]
Budd: checks
MrOrange: checks
*** RIVER *** [5s Qs As] [6s] [3d]
Budd: checks
MrOrange: checks
*** SHOWDOWN ***
MrOrange: shows [Qc Tc]
MrOrange collected 470.0 from pot
*** SUMMARY ***
Total pot 470 | Rake 0
Board [5s Qs As 6s 3d]
Seat 2: Budd showed [5d 2d] and lost
Seat 4: MrOrange showed [Qc Tc] and won (470.0)


PokerStars Hand #77150: Hold'em No Limit (50/100) - 2019/07/11 21:25:50 ET
Table 'Pluribus Session 77' 6-max (Play Money) Seat #6 is the button
Seat 1: Budd (10000 in chips)
Seat 2: MrWhite (10000 in chips)
Seat 3: MrOrange (10000 in chips)
Seat 4: Hattori (10000 in chips)
Seat 5: MrBlue (10000 in chips)
Seat 6: Pluribus (10000 in chips)
Budd: posts small blind 50
MrWhite: posts big blind 100
*** HOLE CARDS ***
Dealt to Budd [Qs 9d]
Dealt to MrWhite [Td 6s]
Dealt to MrOrange [8h 4s]
Dealt to Hattori [3d Jd]
Dealt to MrBlue [4h 9c]
Dealt to Pluribus [Kh Ts]
MrOrange: folds
Hattori: folds
MrBlue: folds
Pluribus: raises 150 to 250
Budd: folds
MrWhite: folds
Uncalled bet (150) returned to Pluribus
Pluribus collected 250.0 from pot
*** SUMMARY ***
Total pot 250 | Rake 0


PokerStars Hand #77151: Hold'em No Limit (50/100) - 2019/07/11 21:25:51 ET
Table 'Pluribus Session 77' 6-max (Play Money) Seat #6 is the button
Seat 1: MrWhite (10000 in chips)
Seat 2: MrOrange (10000 in chips)
Seat 3: Hattori (10000 in chips)
Seat 4: MrBlue (10000 in chips)
Seat 5: Pluribus (10000 in chips)
Seat 6: Budd (10000 in chips)
MrWhite: posts small blind 50
MrOrange: posts big blind 100
*** HOLE CARDS ***
Dealt to MrWhite [Jc 8d]
Dealt to MrOrange [4h 8c]
Dealt to Hattori [3d As]
Dealt to MrBlue [Kc 5h]
Dealt to Pluribus [9s Tc]
Dealt to Budd [Jd 4s]
Hattori: folds
MrBlue: folds
Pluribus: folds
Budd: folds
MrWhite: folds
Uncalled bet (50) returned to MrOrange
MrOrange collected 100.0 from pot
*** SUMMARY ***
Total pot 100 | Rake 0


PokerStars Hand #77152: Hold'em No Limit (50/100) - 2019/07/11 21:25:52 ET
Table 'Pluribus Session 77' 6-max (Play Money) Seat #6 is the button
Seat 1: MrOrange (10000 in chips)
Seat 2: Hattori (10000 in chips)
Seat 3: MrBlue (10000 in chips)
Seat 4: Pluribus (10000 in chips)
Seat 5: Budd (10000 in chips)
Seat 6: MrWhite (10000 in chips)
MrOrange: posts small blind 50
Hattori: posts big blind 100
*** HOLE CARDS ***
Dealt to MrOrange [7c 6h]
Dealt to Hattori [4s Jh]
Dealt to MrBlue [Kc 6d]
Dealt to Pluribus [4h 6c]
Dealt to Budd [2s 9c]
Dealt to MrWhite [5h Js]
MrBlue: folds
Pluribus: folds
Budd: folds
MrWhite: folds
MrOrange: folds
Uncalled bet (50) returned to Hattori
Hattori collected 100.0 from pot
*** SUMMARY ***
Total pot 100 | Rake 0


PokerStars Hand #77153: Hold'em No Limit (50/100) - 2019/07/11 21:25:53 ET
Table 'Pluribus Session 77' 6-max (Play Money) Seat #6 is the button
Seat 1: Hattori (10000 in chips)
Seat 2: MrBlue (10000 in chips)
Seat 3: Pluribus (10000 in chips)
Seat 4: Budd (10000 in chips)
Seat 5: MrWhite (10000 in chips)
Seat 6: MrOrange (10000 in chips)
Hattori: posts small blind 50
MrBlue: posts big blind 100
*** HOLE CARDS ***
Dealt to Hattori [5d 3d]
Dealt to MrBlue [5c 6h]
Dealt to Pluribus [3s 6s]
Dealt to Budd [As Ah]
Dealt to MrWhite [3h 2h]
Dealt to MrOrange [Jc 9h]
Pluribus: folds
Budd: raises 125 to 225
MrWhite: folds
MrOrange: folds
Hattori: folds
MrBlue: calls 125
*** FLOP *** [Td Ad 8c]
MrBlue: checks
Budd: bets 375
MrBlue: folds
Uncalled bet (375) returned to Budd
Budd collected 500.0 from pot
*** SUMMARY ***
Total pot 500 | Rake 0
Board [Td Ad 8c]


PokerStars Hand #77154: Hold'em No Limit (50/100) - 2019/07/11 21:25:54 ET
Table 'Pluribus Session 77' 6-max (Play Money) Seat #6 is the button
Seat 1: MrBlue (10000 in chips)
Seat 2: Pluribus (10000 in chips)
Seat 3: Budd (10000 in chips)
Seat 4: MrWhite (10000 in chips)
Seat 5: MrOrange (10000 in chips)
Seat 6: Hattori (10000 in chips)
MrBlue: posts small blind 50
Pluribus: posts big blind 100
*** HOLE CARDS ***
Dealt to MrBlue [7h 7d]
Dealt to Pluribus [5d Ac]
Dealt to Budd [Tc 2h]
Dealt to MrWhite [9d 7c]
Dealt to MrOrange [3c Kd]
Dealt to Hattori [5c Jh]
Budd: folds
MrWhite: folds
MrOrange: folds
Hattori: folds
MrBlue: raises 200 to 300
Pluribus: calls 200
*** FLOP *** [Js Ah 8c]
MrBlue: bets 250
Pluribus: calls 250
*** TURN *** [Js Ah 8c] [8d]
MrBlue: checks
Pluribus: checks
*** RIVER *** [Js Ah 8c] [8d] [2d]
MrBlue: checks
Pluribus: bets 550
MrBlue: folds
Uncalled bet (550) returned to Pluribus
Pluribus collected 1100.0 from pot
*** SUMMARY ***
Total pot 1100 | Rake 0
Board [Js Ah 8c 8d 2d]


PokerStars Hand #77155: Hold'em No Limit (50/100) - 2019/07/11 21:25:55 ET
Table 'Pluribus Session 77' 6-max (Play Money) Seat #6 is the button
Seat 1: Pluribus (10000 in chips)
Seat 2: Budd (10000 in chips)
Seat 3: MrWhite (10000 in chips)
Seat 4: MrOrange (10000 in chips)
Seat 5: Hattori (10000 in chips)
Seat 6: MrBlue (10000 in chips)
Pluribus: posts small blind 50
Budd: posts big blind 100
*** HOLE CARDS ***
Dealt to Pluribus [Th 5s]
Dealt to Budd [2c 2s]
Dealt to MrWhite [7d As]
Dealt to MrOrange [Ad Qs]
Dealt to Hattori [Kh 9h]
Dealt to MrBlue [3h 7c]
MrWhite: folds
MrOrange: raises 120 to 220
Hattori: raises 510 to 730
MrBlue: folds
Pluribus: folds
Budd: folds
MrOrange: folds
Uncalled bet (510) returned to Hattori
Hattori collected 590.0 from pot
*** SUMMARY ***
Total pot 590 | Rake 0


PokerStars Hand #77156: Hold'em No Limit (50/100) - 2019/07/11 21:25:56 ET
Table 'Pluribus Session 77' 6-max (Play Money) Seat #6 is the button
Seat 1: Budd (10000 in chips)
Seat 2: MrWhite (10000 in chips)
Seat 3: MrOrange (10000 in chips)
Seat 4: Hattori (10000 in chips)
Seat 5: MrBlue (10000 in chips)
Seat 6: Pluribus (10000 in chips)
Budd: posts small blind 50
MrWhite: posts big blind 100
*** HOLE CARDS ***
Dealt to Budd [Qc 3s]
Dealt to MrWhite [8h 7s]
Dealt to MrOrange [Ts 9h]
Dealt to Hattori [3c 9c]
Dealt to MrBlue [Js 5c]
Dealt to Pluribus [Jc Kd]
MrOrange: folds
Hattori: folds
MrBlue: folds
Pluribus: raises 150 to 250
Budd: folds
MrWhite: calls 150
*** FLOP *** [3h 2d Ks]
MrWhite: checks
Pluribus: bets 275
MrWhite: folds
Uncalled bet (275) returned to Pluribus
Pluribus collected 550.0 from pot
*** SUMMARY ***
Total pot 550 | Rake 0
Board [3h 2d Ks]


PokerStars Hand #77157: Hold'em No Limit (50/100) - 2019/07/11 21:25:57 ET
Table 'Pluribus Session 77' 6-max (Play Money) Seat #6 is the button
Seat 1: MrWhite (10000 in chips)
Seat 2: MrOrange (10000 in chips)
Seat 3: Hattori (10000 in chips)
Seat 4: MrBlue (10000 in chips)
Seat 5: Pluribus (10000 in chips)
Seat 6: Budd (10000 in chips)
MrWhite: posts small blind 50
MrOrange: posts big blind 100
*** HOLE CARDS ***
Dealt to MrWhite [4s 6d]
Dealt to MrOrange [Ac Jh]
Dealt to Hattori [3d 7s]
Dealt to MrBlue [Jc 7h]
Dealt to Pluribus [5h Ah]
Dealt to Budd [3h 2h]
Hattori: folds
MrBlue: folds
Pluribus: raises 125 to 225
Budd: folds
MrWhite: folds
MrOrange: calls 125
*** FLOP *** [6c 7c 9d]
MrOrange: checks
Pluribus: bets 250
MrOrange: folds
Uncalled bet (250) returned to Pluribus
Pluribus collected 500.0 from pot
*** SUMMARY ***
Total pot 500 | Rake 0
Board [6c 7c 9d]


PokerStars Hand #77158: Hold'em No Limit (50/100) - 2019/07/11 21:25:58 ET
Table 'Pluribus Session 77' 6-max (Play Money) Seat #6 is the button
Seat 1: MrOrange (10000 in chips)
Seat 2: Hattori (10000 in chips)
Seat 3: MrBlue (10000 in chips)
Seat 4: Pluribus (10000 in chips)
Seat 5: Budd (10000 in chips)
Seat 6: MrWhite (10000 in chips)
MrOrange: posts small blind 50
Hattori: posts big blind 100
*** HOLE CARDS ***
Dealt to MrOrange [Ts 6d]
Dealt to Hattori [Tc As]
Dealt to MrBlue [Jc 7d]
Dealt to Pluribus [Kd 5s]
Dealt to Budd [4c 2s]
Dealt to MrWhite [3s 2h]
MrBlue: folds
Pluribus: folds
Budd: folds
MrWhite: folds
MrOrange: folds
Uncalled bet (50) returned to Hattori
Hattori collected 100.0 from pot
*** SUMMARY ***
Total pot 100 | Rake 0


PokerStars Hand #77159: Hold'em No Limit (50/100) - 2019/07/11 21:25:59 ET
Table 'Pluribus Session 77' 6-max (Play Money) Seat #6 is the button
Seat 1: Hattori (10000 in chips)
Seat 2: MrBlue (10000 in chips)
Seat 3: Pluribus (10000 in chips)
Seat 4: Budd (10000 in chips)
Seat 5: MrWhite (10000 in chips)
Seat 6: MrOrange (10000 in chips)
Hattori: posts small blind 50
MrBlue: posts big blind 100
*** HOLE CARDS ***
Dealt to Hattori [Ac 8s]
Dealt to MrBlue [7s Ks]
Dealt to Pluribus [3h Ts]
Dealt to Budd [Ad 6s]
Dealt to MrWhite [Jc As]
Dealt to MrOrange [7c Tc]
Pluribus: folds
Budd: folds
MrWhite: raises 125 to 225
MrOrange: folds
Hattori: folds
MrBlue: calls 125
*** FLOP *** [4d 2s 7d]
MrBlue: checks
MrWhite: checks
*** TURN *** [4d 2s 7d] [5s]
MrBlue: bets 375
MrWhite: folds
Uncalled bet (375) returned to MrBlue
MrBlue collected 500.0 from pot
*** SUMMARY ***
Total pot 500 | Rake 0
Board [4d 2s 7d 5s]


PokerStars Hand #77160: Hold'em No Limit (50/100) - 2019/07/11 21:26:00 ET
Table 'Pluribus Session 77' 6-max (Play Money) Seat #6 is the button
Seat 1: MrBlue (10000 in chips)
Seat 2: Pluribus (10000 in chips)
Seat 3: Budd (10000 in chips)
Seat 4: MrWhite (10000 in chips)
Seat 5: MrOrange (10000 in chips)
Seat 6: Hattori (10000 in chips)
MrBlue: posts small blind 50
Pluribus: posts big blind 100
*** HOLE CARDS ***
Dealt to MrBlue [6c 4c]
Dealt to Pluribus [8c 9s]
Dealt to Budd [Kh Ac]
Dealt to MrWhite [Qh 3h]
Dealt to MrOrange [9c 6s]
Dealt to Hattori [6h As]
Budd: raises 125 to 225
MrWhite: folds
MrOrange: folds
Hattori: folds
MrBlue: calls 175
Pluribus: folds
*** FLOP *** [2d Jd Qd]
MrBlue: checks
Budd: checks
*** TURN *** [2d Jd Qd] [2c]
MrBlue: checks
Budd: checks
*** RIVER *** [2d Jd Qd] [2c] [Ah]
MrBlue: checks
Budd: bets 275
MrBlue: folds
Uncalled bet (275) returned to Budd
Budd collected 550.0 from pot
*** SUMMARY ***
Total pot 550 | Rake 0
Board [2d Jd Qd 2c Ah]


PokerStars Hand #77161: Hold'em No Limit (50/100) - 2019/07/11 21:26:01 ET
Table 'Pluribus Session 77' 6-max (Play Money) Seat #6 is the button
Seat 1: Pluribus (10000 in chips)
Seat 2: Budd (10000 in chips)
Seat 3: MrWhite (10000 in chips)
Seat 4: MrOrange (10000 in chips)
Seat 5: Hattori (10000 in chips)
Seat 6: MrBlue (10000 in chips)
Pluribus: posts small blind 50
Budd: posts big blind 100
*** HOLE CARDS ***
Dealt to Pluribus [8s Th]
Dealt to Budd [7d 9c]
Dealt to MrWhite [Kh 7h]
Dealt to MrOrange [Qh 3h]
Dealt to Hattori [9d 6h]
Dealt to MrBlue [6d Js]
MrWhite: folds
MrOrange: folds
Hattori: folds
MrBlue: folds
Pluribus: raises 150 to 250
Budd: calls 150
*** FLOP *** [Qd 4s 8h]
Pluribus: checks
Budd: checks
*** TURN *** [Qd 4s 8h] [6s]
Pluribus: checks
Budd: bets 250
Pluribus: calls 250
*** RIVER *** [Qd 4s 8h] [6s] [Ac]
Pluribus: checks
Budd: checks
*** SHOWDOWN ***
Pluribus: shows [8s Th]
Pluribus collected 1000.0 from pot
*** SUMMARY ***
Total pot 1000 | Rake 0
Board [Qd 4s 8h 6s Ac]
Seat 1: Pluribus showed [8s Th] and won (1000.0)
Seat 2: Budd showed [7d 9c] and lost


PokerStars Hand #77162: Hold'em No Limit (50/100) - 2019/07/11 21:26:02 ET
Table 'Pluribus Session 77' 6-max (Play Money) Seat #6 is the button
Seat 1: Budd (10000 in chips)
Seat 2: MrWhite (10000 in chips)
Seat 3: MrOrange (10000 in chips)
Seat 4: Hattori (10000 in chips)
Seat 5: MrBlue (10000 in chips)
Seat 6: Pluribus (10000 in chips)
Budd: posts small blind 50
MrWhite: posts big blind 100
*** HOLE CARDS ***
Dealt to Budd [Ah Kc]
Dealt to MrWhite [7c 3s]
Dealt to MrOrange [2h Qc]
Dealt to Hattori [Qs Jd]
Dealt to MrBlue [7d 3h]
Dealt to Pluribus [Ac Td]
MrOrange: folds
Hattori: raises 100 to 200
MrBlue: folds
Pluribus: raises 481 to 681
Budd: raises 1442 to 2123
MrWhite: folds
Hattori: folds
Pluribus: folds
Uncalled bet (1442) returned to Budd
Budd collected 1662.0 from pot
*** SUMMARY ***
Total pot 1662 | Rake 0


PokerStars Hand #77163: Hold'em No Limit (50/100) - 2019/07/11 21:26:03 ET
Table 'Pluribus Session 77' 6-max (Play Money) Seat #6 is the button
Seat 1: MrWhite (10000 in chips)
Seat 2: MrOrange (10000 in chips)
Seat 3: Hattori (10000 in chips)
Seat 4: MrBlue (10000 in chips)
Seat 5: Pluribus (10000 in chips)
Seat 6: Budd (10000 in chips)
MrWhite: posts small blind 50
MrOrange: posts big blind 100
*** HOLE CARDS ***
Dealt to MrWhite [7d 2d]
Dealt to MrOrange [6c Td]
Dealt to Hattori [Ks 6h]
Dealt to MrBlue [8c 8s]
Dealt to Pluribus [7c Kc]
Dealt to Budd [Th 3c]
Hattori: folds
MrBlue: raises 125 to 225
Pluribus: folds
Budd: folds
MrWhite: folds
MrOrange: folds
Uncalled bet (125) returned to MrBlue
MrBlue collected 250.0 from pot
*** SUMMARY ***
Total pot 250 | Rake 0


PokerStars Hand #77164: Hold'em No Limit (50/100) - 2019/07/11 21:26:04 ET
Table 'Pluribus Session 77' 6-max (Play Money) Seat #6 is the button
Seat 1: MrOrange (10000 in chips)
Seat 2: Hattori (10000 in chips)
Seat 3: MrBlue (10000 in chips)
Seat 4: Pluribus (10000 in chips)
Seat 5: Budd (10000 in chips)
Seat 6: MrWhite (10000 in chips)
MrOrange: posts small blind 50
Hattori: posts big blind 100
*** HOLE CARDS ***
Dealt to MrOrange [8d 8c]
Dealt to Hattori [Kc 7c]
Dealt to MrBlue [Ad 9h]
Dealt to Pluribus [Ts As]
Dealt to Budd [4c 8h]
Dealt to MrWhite [Tc 7s]
MrBlue: folds
Pluribus: raises 125 to 225
Budd: folds
MrWhite: folds
MrOrange: raises 775 to 1000
Hattori: folds
Pluribus: calls 775
*** FLOP *** [6h Jh 2d]
MrOrange: bets 700
Pluribus: folds
Uncalled bet (700) returned to MrOrange
MrOrange collected 2100.0 from pot
*** SUMMARY ***
Total pot 2100 | Rake 0
Board [6h Jh 2d]


PokerStars Hand #77165: Hold'em No Limit (50/100) - 2019/07/11 21:26:05 ET
Table 'Pluribus Session 77' 6-max (Play Money) Seat #6 is the button
Seat 1: Hattori (10000 in chips)
Seat 2: MrBlue (10000 in chips)
Seat 3: Pluribus (10000 in chips)
Seat 4: Budd (10000 in chips)
Seat 5: MrWhite (10000 in chips)
Seat 6: MrOrange (10000 in chips)
Hattori: posts small blind 50
MrBlue: posts big blind 100
*** HOLE CARDS ***
Dealt to Hattori [Ks 2s]
Dealt to MrBlue [7d Qc]
Dealt to Pluribus [5d 4c]
Dealt to Budd [5h 6s]
Dealt to MrWhite [9c 5s]
Dealt to MrOrange [Kd 4h]
Pluribus: folds
Budd: folds
MrWhite: folds
MrOrange: folds
Hattori: calls 50
MrBlue: checks
*** FLOP *** [9h 4s 3h]
Hattori: checks
MrBlue: checks
*** TURN *** [9h 4s 3h] [6c]
Hattori: checks
MrBlue: bets 150
Hattori: folds
Uncalled bet (150) returned to MrBlue
MrBlue collected 200.0 from pot
*** SUMMARY ***
Total pot 200 | Rake 0
Board [9h 4s 3h 6c]


PokerStars Hand #77166: Hold'em No Limit (50/100) - 2019/07/11 21:26:06 ET
Table 'Pluribus Session 77' 6-max (Play Money) Seat #6 is the button
Seat 1: MrBlue (10000 in chips)
Seat 2: Pluribus (10000 in chips)
Seat 3: Budd (10000 in chips)
Seat 4: MrWhite (10000 in chips)
Seat 5: MrOrange (10000 in chips)
Seat 6: Hattori (10000 in chips)
MrBlue: posts small blind 50
Pluribus: posts big blind 100
*** HOLE CARDS ***
Dealt to MrBlue [2s 7s]
Dealt to Pluribus [Th 7h]
Dealt to Budd [5h 4c]
Dealt to MrWhite [Qh Ks]
Dealt to MrOrange [9d Ad]
Dealt to Hattori [7d 3d]
Budd: folds
MrWhite: raises 125 to 225
MrOrange: raises 475 to 700
Hattori: folds
MrBlue: folds
Pluribus: folds
MrWhite: folds
Uncalled bet (475) returned to MrOrange
MrOrange collected 600.0 from pot
*** SUMMARY ***
Total pot 600 | Rake 0


PokerStars Hand #77167: Hold'em No Limit (50/100) - 2019/07/11 21:26:07 ET
Table 'Pluribus Session 77' 6-max (Play Money) Seat #6 is the button
Seat 1: Pluribus (10000 in chips)
Seat 2: Budd (10000 in chips)
Seat 3: MrWhite (10000 in chips)
Seat 4: MrOrange (10000 in chips)
Seat 5: Hattori (10000 in chips)
Seat 6: MrBlue (10000 in chips)
Pluribus: posts small blind 50
Budd: posts big blind 100
*** HOLE CARDS ***
Dealt to Pluribus [Ac Tc]
Dealt to Budd [3d 4h]
Dealt to MrWhite [7c As]
Dealt to MrOrange [Qh Jd]
Dealt to Hattori [6d 2c]
Dealt to MrBlue [Ad 7h]
MrWhite: folds
MrOrange: folds
Hattori: folds
MrBlue: raises 125 to 225
Pluribus: calls 175
Budd: folds
*** FLOP *** [6c Ks Jh]
Pluribus: checks
MrBlue: checks
*** TURN *** [6c Ks Jh] [Kc]
Pluribus: checks
MrBlue: checks
*** RIVER *** [6c Ks Jh] [Kc] [Th]
Pluribus: bets 275
MrBlue: raises 1100 to 1375
Pluribus: folds
Uncalled bet (1100) returned to MrBlue
MrBlue collected 1100.0 from pot
*** SUMMARY ***
Total pot 1100 | Rake 0
Board [6c Ks Jh Kc Th]


PokerStars Hand #77168: Hold'em No Limit (50/100) - 2019/07/11 21:26:08 ET
Table 'Pluribus Session 77' 6-max (Play Money) Seat #6 is the button
Seat 1: Budd (10000 in chips)
Seat 2: MrWhite (10000 in chips)
Seat 3: MrOrange (10000 in chips)
Seat 4: Hattori (10000 in chips)
Seat 5: MrBlue (10000 in chips)
Seat 6: Pluribus (10000 in chips)
Budd: posts small blind 50
MrWhite: posts big blind 100
*** HOLE CARDS ***
Dealt to Budd [4c 4s]
Dealt to MrWhite [Tc Kh]
Dealt to MrOrange [Ad 7h]
Dealt to Hattori [Ks 8c]
Dealt to MrBlue [Jd Qc]
Dealt to Pluribus [Kc Ts]
MrOrange: folds
Hattori: folds
MrBlue: raises 125 to 225
Pluribus: folds
Budd: folds
MrWhite: calls 125
*** FLOP *** [Td 7s Qd]
MrWhite: checks
MrBlue: checks
*** TURN *** [Td 7s Qd] [As]
MrWhite: checks
MrBlue: checks
*** RIVER *** [Td 7s Qd] [As] [2h]
MrWhite: checks
MrBlue: bets 200
MrWhite: raises 1350 to 1550
MrBlue: folds
Uncalled bet (1350) returned to MrWhite
MrWhite collected 900.0 from pot
*** SUMMARY ***
Total pot 900 | Rake 0
Board [Td 7s Qd As 2h]


PokerStars Hand #77169: Hold'em No Limit (50/100) - 2019/07/11 21:26:09 ET
Table 'Pluribus Session 77' 6-max (Play Money) Seat #6 is the button
Seat 1: MrWhite (10000 in chips)
Seat 2: MrOrange (10000 in chips)
Seat 3: Hattori (10000 in chips)
Seat 4: MrBlue (10000 in chips)
Seat 5: Pluribus (10000 in chips)
Seat 6: Budd (10000 in chips)
MrWhite: posts small blind 50
MrOrange: posts big blind 100
*** HOLE CARDS ***
Dealt to MrWhite [Ad 7c]
Dealt to MrOrange [Jh Kd]
Dealt to Hattori [Td 5c]
Dealt to MrBlue [Qh Qd]
Dealt to Pluribus [Jd 8d]
Dealt to Budd [9c 3c]
Hattori: folds
MrBlue: raises 125 to 225
Pluribus: folds
Budd: folds
MrWhite: folds
MrOrange: calls 125
*** FLOP *** [7s Tc 6d]
MrOrange: checks
MrBlue: checks
*** TURN *** [7s Tc 6d] [Ts]
MrOrange: checks
MrBlue: bets 300
MrOrange: folds
Uncalled bet (300) returned to MrBlue
MrBlue collected 500.0 from pot
*** SUMMARY ***
Total pot 500 | Rake 0
Board [7s Tc 6d Ts]


PokerStars Hand #77170: Hold'em No Limit (50/100) - 2019/07/11 21:26:10 ET
Table 'Pluribus Session 77' 6-max (Play Money) Seat #6 is the button
Seat 1: MrOrange (10000 in chips)
Seat 2: Hattori (10000 in chips)
Seat 3: MrBlue (10000 in chips)
Seat 4: Pluribus (10000 in chips)
Seat 5: Budd (10000 in chips)
Seat 6: MrWhite (10000 in chips)
MrOrange: posts small blind 50
Hattori: posts big blind 100
*** HOLE CARDS ***
Dealt to MrOrange [Qh Qs]
Dealt to Hattori [5s Kc]
Dealt to MrBlue [Jh 5h]
Dealt to Pluribus [8s 3s]
Dealt to Budd [Jc 2h]
Dealt to MrWhite [7d 6d]
MrBlue: folds
Pluribus: folds
Budd: folds
MrWhite: raises 125 to 225
MrOrange: raises 875 to 1100
Hattori: folds
MrWhite: calls 875
*** FLOP *** [Jd Th Kh]
MrOrange: checks
MrWhite: checks
*** TURN *** [Jd Th Kh] [2d]
MrOrange: checks
MrWhite: bets 1725
MrOrange: calls 1725
*** RIVER *** [Jd Th Kh] [2d] [Ks]
MrOrange: checks
MrWhite: checks
*** SHOWDOWN ***
MrOrange: shows [Qh Qs]
MrOrange collected 5750.0 from pot
*** SUMMARY ***
Total pot 5750 | Rake 0
Board [Jd Th Kh 2d Ks]
Seat 1: MrOrange showed [Qh Qs] and won (5750.0)
Seat 6: MrWhite showed [7d 6d] and lost


PokerStars Hand #77171: Hold'em No Limit (50/100) - 2019/07/11 21:26:11 ET
Table 'Pluribus Session 77' 6-max (Play Money) Seat #6 is the button
Seat 1: Hattori (10000 in chips)
Seat 2: MrBlue (10000 in chips)
Seat 3: Pluribus (10000 in chips)
Seat 4: Budd (10000 in chips)
Seat 5: MrWhite (10000 in chips)
Seat 6: MrOrange (10000 in chips)
Hattori: posts small blind 50
MrBlue: posts big blind 100
*** HOLE CARDS ***
Dealt to Hattori [8c 4s]
Dealt to MrBlue [5d 4h]
Dealt to Pluribus [8d 9d]
Dealt to Budd [Kd 3h]
Dealt to MrWhite [7h 4c]
Dealt to MrOrange [Kc 6d]
Pluribus: folds
Budd: folds
MrWhite: folds
MrOrange: folds
Hattori: folds
Uncalled bet (50) returned to MrBlue
MrBlue collected 100.0 from pot
*** SUMMARY ***
Total pot 100 | Rake 0


PokerStars Hand #77172: Hold'em No Limit (50/100) - 2019/07/11 21:26:12 ET
Table 'Pluribus Session 77' 6-max (Play Money) Seat #6 is the button
Seat 1: MrBlue (10000 in chips)
Seat 2: Pluribus (10000 in chips)
Seat 3: Budd (10000 in chips)
Seat 4: MrWhite (10000 in chips)
Seat 5: MrOrange (10000 in chips)
Seat 6: Hattori (10000 in chips)
MrBlue: posts small blind 50
Pluribus: posts big blind 100
*** HOLE CARDS ***
Dealt to MrBlue [2h 9d]
Dealt to Pluribus [Kh Qs]
Dealt to Budd [Qd 7h]
Dealt to MrWhite [7s Ts]
Dealt to MrOrange [8d 3c]
Dealt to Hattori [Th Jc]
Budd: folds
MrWhite: folds
MrOrange: folds
Hattori: raises 125 to 225
MrBlue: folds
Pluribus: calls 125
*** FLOP *** [4c 2c 6s]
Pluribus: checks
Hattori: checks
*** TURN *** [4c 2c 6s] [9h]
Pluribus: checks
Hattori: bets 450
Pluribus: folds
Uncalled bet (450) returned to Hattori
Hattori collected 500.0 from pot
*** SUMMARY ***
Total pot 500 | Rake 0
Board [4c 2c 6s 9h]


PokerStars Hand #77173: Hold'em No Limit (50/100) - 2019/07/11 21:26:13 ET
Table 'Pluribus Session 77' 6-max (Play Money) Seat #6 is the button
Seat 1: Pluribus (10000 in chips)
Seat 2: Budd (10000 in chips)
Seat 3: MrWhite (10000 in chips)
Seat 4: MrOrange (10000 in chips)
Seat 5: Hattori (10000 in chips)
Seat 6: MrBlue (10000 in chips)
Pluribus: posts small blind 50
Budd: posts big blind 100
*** HOLE CARDS ***
Dealt to Pluribus [Js Jh]
Dealt to Budd [8d Jd]
Dealt to MrWhite [Ad 6h]
Dealt to MrOrange [8c Ks]
Dealt to Hattori [6c 9s]
Dealt to MrBlue [As 4s]
MrWhite: folds
MrOrange: folds
Hattori: folds
MrBlue: raises 125 to 225
Pluribus: raises 1100 to 1325
Budd: folds
MrBlue: folds
Uncalled bet (1100) returned to Pluribus
Pluribus collected 550.0 from pot
*** SUMMARY ***
Total pot 550 | Rake 0
