PokerStars Hand #73000: Hold'em No Limit (50/100) - 2019/07/11 20:16:40 ET
Table 'Pluribus Session 73' 6-max (Play Money) Seat #6 is the button
Seat 1: Budd (10000 in chips)
Seat 2: Eddie (10000 in chips)
Seat 3: MrOrange (10000 in chips)
Seat 4: Bill (10000 in chips)
Seat 5: MrBlue (10000 in chips)
Seat 6: Pluribus (10000 in chips)
Budd: posts small blind 50
Eddie: posts big blind 100
*** HOLE CARDS ***
Dealt to Budd [Qc 6c]
Dealt to Eddie [4h Tc]
Dealt to MrOrange [5d Js]
Dealt to Bill [Kh 7d]
Dealt to MrBlue [Ah 7s]
Dealt to Pluribus [Td 8s]
MrOrange: folds
Bill: folds
MrBlue: raises 125 to 225
Pluribus: folds
Budd: folds
Eddie: folds
Uncalled bet (125) returned to MrBlue
MrBlue collected 250.0 from pot
*** SUMMARY ***
Total pot 250 | Rake 0


PokerStars Hand #73001: Hold'em No Limit (50/100) - 2019/07/11 20:16:41 ET
Table 'Pluribus Session 73' 6-max (Play Money) Seat #6 is the button
Seat 1: Eddie (10000 in chips)
Seat 2: MrOrange (10000 in chips)
Seat 3: Bill (10000 in chips)
Seat 4: MrBlue (10000 in chips)
Seat 5: Pluribus (10000 in chips)
Seat 6: Budd (10000 in chips)
Eddie: posts small blind 50
MrOrange: posts big blind 100
*** HOLE CARDS ***
Dealt to Eddie [Ac 5h]
Dealt to MrOrange [Jh 4h]
Dealt to Bill [3d Ad]
Dealt to MrBlue [5d Qs]
Dealt to Pluribus [6c Ah]
Dealt to Budd [9s 7d]
Bill: raises 125 to 225
MrBlue: folds
Pluribus: folds
Budd: folds
Eddie: folds
MrOrange: folds
Uncalled bet (125) returned to Bill
Bill collected 250.0 from pot
*** SUMMARY ***
Total pot 250 | Rake 0


PokerStars Hand #73002: Hold'em No Limit (50/100) - 2019/07/11 20:16:42 ET
Table 'Pluribus Session 73' 6-max (Play Money) Seat #6 is the button
Seat 1: MrOrange (10000 in chips)
Seat 2: Bill (10000 in chips)
Seat 3: MrBlue (10000 in chips)
Seat 4: Pluribus (10000 in chips)
Seat 5: Budd (10000 in chips)
Seat 6: Eddie (10000 in chips)
MrOrange: posts small blind 50
Bill: posts big blind 100
*** HOLE CARDS ***
Dealt to MrOrange [4d Kc]
Dealt to Bill [2s Th]
Dealt to MrBlue [Ac Qc]
Dealt to Pluribus [3h 8c]
Dealt to Budd [Td Ks]
Dealt to Eddie [Jd Jh]
MrBlue: raises 125 to 225
Pluribus: folds
Budd: folds
Eddie: raises 525 to 750
MrOrange: folds
Bill: folds
MrBlue: calls 525
*** FLOP *** [8d Tc 2d]
MrBlue: checks
Eddie: bets 700
MrBlue: folds
Uncalled bet (700) returned to Eddie
Eddie collected 1650.0 from pot
*** SUMMARY ***
Total pot 1650 | Rake 0
Board [8d Tc 2d]


PokerStars Hand #73003: Hold'em No Limit (50/100) - 2019/07/11 20:16:43 ET
Table 'Pluribus Session 73' 6-max (Play Money) Seat #6 is the button
Seat 1: Bill (10000 in chips)
Seat 2: MrBlue (10000 in chips)
Seat 3: Pluribus (10000 in chips)
Seat 4: Budd (10000 in chips)
Seat 5: Eddie (10000 in chips)
Seat 6: MrOrange (10000 in chips)
Bill: posts small blind 50
MrBlue: posts big blind 100
*** HOLE CARDS ***
Dealt to Bill [4s Qc]
Dealt to MrBlue [Qh 8d]
Dealt to Pluribus [Ts 7d]
Dealt to Budd [2d Js]
Dealt to Eddie [2h Ks]
Dealt to MrOrange [Qd 8h]
Pluribus: folds
Budd: folds
Eddie: folds
MrOrange: folds
Bill: folds
Uncalled bet (50) returned to MrBlue
MrBlue collected 100.0 from pot
*** SUMMARY ***
Total pot 100 | Rake 0


PokerStars Hand #73004: Hold'em No Limit (50/100) - 2019/07/11 20:16:44 ET
Table 'Pluribus Session 73' 6-max (Play Money) Seat #6 is the button
Seat 1: MrBlue (10000 in chips)
Seat 2: Pluribus (10000 in chips)
Seat 3: Budd (10000 in chips)
Seat 4: Eddie (10000 in chips)
Seat 5: MrOrange (10000 in chips)
Seat 6: Bill (10000 in chips)
MrBlue: posts small blind 50
Pluribus: posts big blind 100
*** HOLE CARDS ***
Dealt to MrBlue [Tc 2c]
Dealt to Pluribus [Jc 6d]
Dealt to Budd [Ks Qs]
Dealt to Eddie [2d 3c]
Dealt to MrOrange [4c 5h]
Dealt to Bill [4h 2s]
Budd: raises 125 to 225
Eddie: folds
MrOrange: folds
Bill: folds
MrBlue: folds
Pluribus: folds
Uncalled bet (125) returned to Budd
Budd collected 250.0 from pot
*** SUMMARY ***
Total pot 250 | Rake 0


PokerStars Hand #73005: Hold'em No Limit (50/100) - 2019/07/11 20:16:45 ET
Table 'Pluribus Session 73' 6-max (Play Money) Seat #6 is the button
Seat 1: Pluribus (10000 in chips)
Seat 2: Budd (10000 in chips)
Seat 3: Eddie (10000 in chips)
Seat 4: MrOrange (10000 in chips)
Seat 5: Bill (10000 in chips)
Seat 6: MrBlue (10000 in chips)
Pluribus: posts small blind 50
Budd: posts big blind 100
*** HOLE CARDS ***
Dealt to Pluribus [Th 4c]
Dealt to Budd [Qh Ah]
Dealt to Eddie [3d 9s]
Dealt to MrOrange [Qs 9d]
Dealt to Bill [7c 3c]
Dealt to MrBlue [Jc Ac]
Eddie: folds
MrOrange: folds
Bill: folds
MrBlue: raises 125 to 225
Pluribus: folds
Budd: raises 875 to 1100
MrBlue: calls 875
*** FLOP *** [Jh 3h 9h]
Budd: bets 750
MrBlue: calls 750
*** TURN *** [Jh 3h 9h] [5s]
Budd: bets 2100
MrBlue: folds
Uncalled bet (2100) returned to Budd
Budd collected 3750.0 from pot
*** SUMMARY ***
Total pot 3750 | Rake 0
Board [Jh 3h 9h 5s]


PokerStars Hand #73006: Hold'em No Limit (50/100) - 2019/07/11 20:16:46 ET
Table 'Pluribus Session 73' 6-max (Play Money) Seat #6 is the button
Seat 1: Budd (10000 in chips)
Seat 2: Eddie (10000 in chips)
Seat 3: MrOrange (10000 in chips)
Seat 4: Bill (10000 in chips)
Seat 5: MrBlue (10000 in chips)
Seat 6: Pluribus (10000 in chips)
Budd: posts small blind 50
Eddie: posts big blind 100
*** HOLE CARDS ***
Dealt to Budd [Kc Qh]
Dealt to Eddie [6c Td]
Dealt to MrOrange [6d 4s]
Dealt to Bill [3s 7d]
Dealt to MrBlue [6s 4d]
Dealt to Pluribus [5c 5d]
MrOrange: folds
Bill: folds
MrBlue: folds
Pluribus: raises 100 to 200
Budd: calls 150
Eddie: folds
*** FLOP *** [Jh 5s 8h]
Budd: checks
Pluribus: bets 500
Budd: folds
Uncalled bet (500) returned to Pluribus
Pluribus collected 500.0 from pot
*** SUMMARY ***
Total pot 500 | Rake 0
Board [Jh 5s 8h]


PokerStars Hand #73007: Hold'em No Limit (50/100) - 2019/07/11 20:16:47 ET
Table 'Pluribus Session 73' 6-max (Play Money) Seat #6 is the button
Seat 1: Eddie (10000 in chips)
Seat 2: MrOrange (10000 in chips)
Seat 3: Bill (10000 in chips)
Seat 4: MrBlue (10000 in chips)
Seat 5: Pluribus (10000 in chips)
Seat 6: Budd (10000 in chips)
Eddie: posts small blind 50
MrOrange: posts big blind 100
*** HOLE CARDS ***
Dealt to Eddie [4d 9d]
Dealt to MrOrange [4s 3s]
Dealt to Bill [Qc Ad]
Dealt to MrBlue [7s 6c]
Dealt to Pluribus [8s Js]
Dealt to Budd [Tc 6h]
Bill: raises 125 to 225
MrBlue: folds
Pluribus: folds
Budd: folds
Eddie: folds
MrOrange: calls 125
*** FLOP *** [2h Ac 3c]
MrOrange: checks
Bill: checks
*** TURN *** [2h Ac 3c] [7h]
MrOrange: checks
Bill: bets 250
MrOrange: raises 1305 to 1555
Bill: calls 1305
*** RIVER *** [2h Ac 3c] [7h] [6d]
MrOrange: bets 5050
Bill: folds
Uncalled bet (5050) returned to MrOrange
MrOrange collected 3610.0 from pot
*** SUMMARY ***
Total pot 3610 | Rake 0
Board [2h Ac 3c 7h 6d]


PokerStars Hand #73008: Hold'em No Limit (50/100) - 2019/07/11 20:16:48 ET
Table 'Pluribus Session 73' 6-max (Play Money) Seat #6 is the button
Seat 1: MrOrange (10000 in chips)
Seat 2: Bill (10000 in chips)
Seat 3: MrBlue (10000 in chips)
Seat 4: Pluribus (10000 in chips)
Seat 5: Budd (10000 in chips)
Seat 6: Eddie (10000 in chips)
MrOrange: posts small blind 50
Bill: posts big blind 100
*** HOLE CARDS ***
Dealt to MrOrange [6d Kc]
Dealt to Bill [6c 3d]
Dealt to MrBlue [7d 4h]
Dealt to Pluribus [Qd 3c]
Dealt to Budd [2h Jc]
Dealt to Eddie [8c 4c]
MrBlue: folds
Pluribus: folds
Budd: folds
Eddie: folds
MrOrange: folds
Uncalled bet (50) returned to Bill
Bill collected 100.0 from pot
*** SUMMARY ***
Total pot 100 | Rake 0


PokerStars Hand #73009: Hold'em No Limit (50/100) - 2019/07/11 20:16:49 ET
Table 'Pluribus Session 73' 6-max (Play Money) Seat #6 is the button
Seat 1: Bill (10000 in chips)
Seat 2: MrBlue (10000 in chips)
Seat 3: Pluribus (10000 in chips)
Seat 4: Budd (10000 in chips)
Seat 5: Eddie (10000 in chips)
Seat 6: MrOrange (10000 in chips)
Bill: posts small blind 50
MrBlue: posts big blind 100
*** HOLE CARDS ***
Dealt to Bill [Js 5d]
Dealt to MrBlue [Th Ad]
Dealt to Pluribus [2h 9d]
Dealt to Budd [7c Ac]
Dealt to Eddie [Qd 5s]
Dealt to MrOrange [9h 3h]
Pluribus: folds
Budd: raises 125 to 225
Eddie: folds
MrOrange: folds
Bill: folds
MrBlue: calls 125
*** FLOP *** [7s 6h 8d]
MrBlue: checks
Budd: checks
*** TURN *** [7s 6h 8d] [Qc]
MrBlue: checks
Budd: checks
*** RIVER *** [7s 6h 8d] [Qc] [Tc]
MrBlue: checks
Budd: checks
*** SHOWDOWN ***
MrBlue: shows [Th Ad]
MrBlue collected 500.0 from pot
*** SUMMARY ***
Total pot 500 | Rake 0
Board [7s 6h 8d Qc Tc]
Seat 2: MrBlue showed [Th Ad] and won (500.0)
Seat 4: Budd showed [7c Ac] and lost


PokerStars Hand #73010: Hold'em No Limit (50/100) - 2019/07/11 20:16:50 ET
Table 'Pluribus Session 73' 6-max (Play Money) Seat #6 is the button
Seat 1: MrBlue (10000 in chips)
Seat 2: Pluribus (10000 in chips)
Seat 3: Budd (10000 in chips)
Seat 4: Eddie (10000 in chips)
Seat 5: MrOrange (10000 in chips)
Seat 6: Bill (10000 in chips)
MrBlue: posts small blind 50
Pluribus: posts big blind 100
*** HOLE CARDS ***
Dealt to MrBlue [3s 9d]
Dealt to Pluribus [2h 3d]
Dealt to Budd [6h Ah]
Dealt to Eddie [Js 6d]
Dealt to MrOrange [4h Qs]
Dealt to Bill [Kc 9h]
Budd: raises 125 to 225
Eddie: folds
MrOrange: folds
Bill: folds
MrBlue: folds
Pluribus: folds
Uncalled bet (125) returned to Budd
Budd collected 250.0 from pot
*** SUMMARY ***
Total pot 250 | Rake 0


PokerStars Hand #73011: Hold'em No Limit (50/100) - 2019/07/11 20:16:51 ET
Table 'Pluribus Session 73' 6-max (Play Money) Seat #6 is the button
Seat 1: Pluribus (10000 in chips)
Seat 2: Budd (10000 in chips)
Seat 3: Eddie (10000 in chips)
Seat 4: MrOrange (10000 in chips)
Seat 5: Bill (10000 in chips)
Seat 6: MrBlue (10000 in chips)
Pluribus: posts small blind 50
Budd: posts big blind 100
*** HOLE CARDS ***
Dealt to Pluribus [3c 5h]
Dealt to Budd [4h Qs]
Dealt to Eddie [2h Ad]
Dealt to MrOrange [8c Qc]
Dealt to Bill [6c 3h]
Dealt to MrBlue [4c Tc]
Eddie: folds
MrOrange: folds
Bill: folds
MrBlue: raises 125 to 225
Pluribus: folds
Budd: folds
Uncalled bet (125) returned to MrBlue
MrBlue collected 250.0 from pot
*** SUMMARY ***
Total pot 250 | Rake 0


PokerStars Hand #73012: Hold'em No Limit (50/100) - 2019/07/11 20:16:52 ET
Table 'Pluribus Session 73' 6-max (Play Money) Seat #6 is the button
Seat 1: Budd (10000 in chips)
Seat 2: Eddie (10000 in chips)
Seat 3: MrOrange (10000 in chips)
Seat 4: Bill (10000 in chips)
Seat 5: MrBlue (10000 in chips)
Seat 6: Pluribus (10000 in chips)
Budd: posts small blind 50
Eddie: posts big blind 100
*** HOLE CARDS ***
Dealt to Budd [9d Kc]
Dealt to Eddie [3h Qh]
Dealt to MrOrange [Qd 2c]
Dealt to Bill [5d Ks]
Dealt to MrBlue [4h Js]
Dealt to Pluribus [7d 8h]
MrOrange: folds
Bill: folds
MrBlue: folds
Pluribus: folds
Budd: raises 200 to 300
Eddie: calls 200
*** FLOP *** [Jd 2h 6s]
Budd: bets 200
Eddie: raises 450 to 650
Budd: folds
Uncalled bet (450) returned to Eddie
Eddie collected 1000.0 from pot
*** SUMMARY ***
Total pot 1000 | Rake 0
Board [Jd 2h 6s]


PokerStars Hand #73013: Hold'em No Limit (50/100) - 2019/07/11 20:16:53 ET
Table 'Pluribus Session 73' 6-max (Play Money) Seat #6 is the button
Seat 1: Eddie (10000 in chips)
Seat 2: MrOrange (10000 in chips)
Seat 3: Bill (10000 in chips)
Seat 4: MrBlue (10000 in chips)
Seat 5: Pluribus (10000 in chips)
Seat 6: Budd (10000 in chips)
Eddie: posts small blind 50
MrOrange: posts big blind 100
*** HOLE CARDS ***
Dealt to Eddie [3s 4d]
Dealt to MrOrange [4c Kd]
Dealt to Bill [As Qc]
Dealt to MrBlue [5d 8h]
Dealt to Pluribus [8d 8c]
Dealt to Budd [Ac 4s]
Bill: raises 125 to 225
MrBlue: folds
Pluribus: calls 225
Budd: folds
Eddie: folds
MrOrange: folds
*** FLOP *** [5s 6d Th]
Bill: checks
Pluribus: checks
*** TURN *** [5s 6d Th] [Kc]
Bill: checks
Pluribus: checks
*** RIVER *** [5s 6d Th] [Kc] [7h]
Bill: checks
Pluribus: checks
*** SHOWDOWN ***
Pluribus: shows [8d 8c]
Pluribus collected 600.0 from pot
*** SUMMARY ***
Total pot 600 | Rake 0
Board [5s 6d Th Kc 7h]
Seat 3: Bill showed [As Qc] and lost
Seat 5: Pluribus showed [8d 8c] and won (600.0)


PokerStars Hand #73014: Hold'em No Limit (50/100) - 2019/07/11 20:16:54 ET
Table 'Pluribus Session 73' 6-max (Play Money) Seat #6 is the button
Seat 1: MrOrange (10000 in chips)
Seat 2: Bill (10000 in chips)
Seat 3: MrBlue (10000 in chips)
Seat 4: Pluribus (10000 in chips)
Seat 5: Budd (10000 in chips)
Seat 6: Eddie (10000 in chips)
MrOrange: posts small blind 50
Bill: posts big blind 100
*** HOLE CARDS ***
Dealt to MrOrange [As 4h]
Dealt to Bill [8c Qh]
Dealt to MrBlue [Jh 9h]
Dealt to Pluribus [8s 9s]
Dealt to Budd [Jc Ah]
Dealt to Eddie [Ac 7s]
MrBlue: raises 125 to 225
Pluribus: folds
Budd: folds
Eddie: folds
MrOrange: folds
Bill: folds
Uncalled bet (125) returned to MrBlue
MrBlue collected 250.0 from pot
*** SUMMARY ***
Total pot 250 | Rake 0


PokerStars Hand #73015: Hold'em No Limit (50/100) - 2019/07/11 20:16:55 ET
Table 'Pluribus Session 73' 6-max (Play Money) Seat #6 is the button
Seat 1: Bill (10000 in chips)
Seat 2: MrBlue (10000 in chips)
Seat 3: Pluribus (10000 in chips)
Seat 4: Budd (10000 in chips)
Seat 5: Eddie (10000 in chips)
Seat 6: MrOrange (10000 in chips)
Bill: posts small blind 50
MrBlue: posts big blind 100
*** HOLE CARDS ***
Dealt to Bill [5s 9c]
Dealt to MrBlue [7d 5c]
Dealt to Pluribus [Jc Kd]
Dealt to Budd [4s Ac]
Dealt to Eddie [8s 5d]
Dealt to MrOrange [9s 8c]
Pluribus: folds
Budd: folds
Eddie: folds
MrOrange: folds
Bill: folds
Uncalled bet (50) returned to MrBlue
MrBlue collected 100.0 from pot
*** SUMMARY ***
Total pot 100 | Rake 0


PokerStars Hand #73016: Hold'em No Limit (50/100) - 2019/07/11 20:16:56 ET
Table 'Pluribus Session 73' 6-max (Play Money) Seat #6 is the button
Seat 1: MrBlue (10000 in chips)
Seat 2: Pluribus (10000 in chips)
Seat 3: Budd (10000 in chips)
Seat 4: Eddie (10000 in chips)
Seat 5: MrOrange (10000 in chips)
Seat 6: Bill (10000 in chips)
MrBlue: posts small blind 50
Pluribus: posts big blind 100
*** HOLE CARDS ***
Dealt to MrBlue [Kc 9c]
Dealt to Pluribus [Jh 2h]
Dealt to Budd [4d Ah]
Dealt to Eddie [Qh 7d]
Dealt to MrOrange [Jd Kd]
Dealt to Bill [4c 5d]
Budd: folds
Eddie: folds
MrOrange: raises 110 to 210
Bill: folds
MrBlue: calls 160
Pluribus: calls 110
*** FLOP *** [Ad 2s 9h]
MrBlue: checks
Pluribus: checks
MrOrange: checks
*** TURN *** [Ad 2s 9h] [Kh]
MrBlue: bets 250
Pluribus: raises 1130 to 1380
MrOrange: folds
MrBlue: calls 1130
*** RIVER *** [Ad 2s 9h] [Kh] [8h]
MrBlue: checks
Pluribus: bets 3390
MrBlue: calls 3390
*** SHOWDOWN ***
Pluribus: shows [Jh 2h]
Pluribus collected 10170.0 from pot
*** SUMMARY ***
Total pot 10170 | Rake 0
Board [Ad 2s 9h Kh 8h]
Seat 1: MrBlue showed [Kc 9c] and lost
Seat 2: Pluribus showed [Jh 2h] and won (10170.0)


PokerStars Hand #73017: Hold'em No Limit (50/100) - 2019/07/11 20:16:57 ET
Table 'Pluribus Session 73' 6-max (Play Money) Seat #6 is the button
Seat 1: Pluribus (10000 in chips)
Seat 2: Budd (10000 in chips)
Seat 3: Eddie (10000 in chips)
Seat 4: MrOrange (10000 in chips)
Seat 5: Bill (10000 in chips)
Seat 6: MrBlue (10000 in chips)
Pluribus: posts small blind 50
Budd: posts big blind 100
*** HOLE CARDS ***
Dealt to Pluribus [3d 6d]
Dealt to Budd [9h 3c]
Dealt to Eddie [2d 4c]
Dealt to MrOrange [Qc 7s]
Dealt to Bill [2c 6h]
Dealt to MrBlue [6c Ks]
Eddie: folds
MrOrange: folds
Bill: folds
MrBlue: folds
Pluribus: calls 50
Budd: checks
*** FLOP *** [Th 7h Ts]
Pluribus: checks
Budd: checks
*** TURN *** [Th 7h Ts] [Qh]
Pluribus: checks
Budd: checks
*** RIVER *** [Th 7h Ts] [Qh] [Jd]
Pluribus: bets 200
Budd: folds
Uncalled bet (200) returned to Pluribus
Pluribus collected 200.0 from pot
*** SUMMARY ***
Total pot 200 | Rake 0
Board [Th 7h Ts Qh Jd]


PokerStars Hand #73018: Hold'em No Limit (50/100) - 2019/07/11 20:16:58 ET
Table 'Pluribus Session 73' 6-max (Play Money) Seat #6 is the button
Seat 1: Budd (10000 in chips)
Seat 2: Eddie (10000 in chips)
Seat 3: MrOrange (10000 in chips)
Seat 4: Bill (10000 in chips)
Seat 5: MrBlue (10000 in chips)
Seat 6: Pluribus (10000 in chips)
Budd: posts small blind 50
Eddie: posts big blind 100
*** HOLE CARDS ***
Dealt to Budd [7c 6h]
Dealt to Eddie [Jc 4s]
Dealt to MrOrange [Qd 8d]
Dealt to Bill [Js 6s]
Dealt to MrBlue [Qc 3h]
Dealt to Pluribus [5h Jh]
MrOrange: folds
Bill: folds
MrBlue: folds
Pluribus: raises 150 to 250
Budd: folds
Eddie: folds
Uncalled bet (150) returned to Pluribus
Pluribus collected 250.0 from pot
*** SUMMARY ***
Total pot 250 | Rake 0


PokerStars Hand #73019: Hold'em No Limit (50/100) - 2019/07/11 20:16:59 ET
Table 'Pluribus Session 73' 6-max (Play Money) Seat #6 is the button
Seat 1: Eddie (10000 in chips)
Seat 2: MrOrange (10000 in chips)
Seat 3: Bill (10000 in chips)
Seat 4: MrBlue (10000 in chips)
Seat 5: Pluribus (10000 in chips)
Seat 6: Budd (10000 in chips)
Eddie: posts small blind 50
MrOrange: posts big blind 100
*** HOLE CARDS ***
Dealt to Eddie [3d Ad]
Dealt to MrOrange [8h 7s]
Dealt to Bill [3c 4s]
Dealt to MrBlue [6d 4c]
Dealt to Pluribus [9s Qh]
Dealt to Budd [5d 9c]
Bill: folds
MrBlue: folds
Pluribus: folds
Budd: folds
Eddie: raises 200 to 300
MrOrange: calls 200
*** FLOP *** [Qs 5s 2c]
Eddie: checks
MrOrange: checks
*** TURN *** [Qs 5s 2c] [Jd]
Eddie: checks
MrOrange: checks
*** RIVER *** [Qs 5s 2c] [Jd] [Th]
Eddie: checks
MrOrange: checks
*** SHOWDOWN ***
Eddie: shows [3d Ad]
Eddie collected 600.0 from pot
*** SUMMARY ***
Total pot 600 | Rake 0
Board [Qs 5s 2c Jd Th]
Seat 1: Eddie showed [3d Ad] and won (600.0)
Seat 2: MrOrange showed [8h 7s] and lost


PokerStars Hand #73020: Hold'em No Limit (50/100) - 2019/07/11 20:17:00 ET
Table 'Pluribus Session 73' 6-max (Play Money) Seat #6 is the button
Seat 1: MrOrange (10000 in chips)
Seat 2: Bill (10000 in chips)
Seat 3: MrBlue (10000 in chips)
Seat 4: Pluribus (10000 in chips)
Seat 5: Budd (10000 in chips)
Seat 6: Eddie (10000 in chips)
MrOrange: posts small blind 50
Bill: posts big blind 100
*** HOLE CARDS ***
Dealt to MrOrange [7s 8h]
Dealt to Bill [4h Ac]
Dealt to MrBlue [7d 5c]
Dealt to Pluribus [4d Ah]
Dealt to Budd [2h Kd]
Dealt to Eddie [Ad Ts]
MrBlue: folds
Pluribus: folds
Budd: folds
Eddie: raises 122 to 222
MrOrange: folds
Bill: calls 122
*** FLOP *** [7h Th 5h]
Bill: checks
Eddie: checks
*** TURN *** [7h Th 5h] [9s]
Bill: bets 247
Eddie: calls 247
*** RIVER *** [7h Th 5h] [9s] [Td]
Bill: bets 741
Eddie: calls 741
*** SHOWDOWN ***
Eddie: shows [Ad Ts]
Eddie collected 2470.0 from pot
*** SUMMARY ***
Total pot 2470 | Rake 0
Board [7h Th 5h 9s Td]
Seat 2: Bill showed [4h Ac] and lost
Seat 6: Eddie showed [Ad Ts] and won (2470.0)


PokerStars Hand #73021: Hold'em No Limit (50/100) - 2019/07/11 20:17:01 ET
Table 'Pluribus Session 73' 6-max (Play Money) Seat #6 is the button
Seat 1: Bill (10000 in chips)
Seat 2: MrBlue (10000 in chips)
Seat 3: Pluribus (10000 in chips)
Seat 4: Budd (10000 in chips)
Seat 5: Eddie (10000 in chips)
Seat 6: MrOrange (10000 in chips)
Bill: posts small blind 50
MrBlue: posts big blind 100
*** HOLE CARDS ***
Dealt to Bill [6c 9c]
Dealt to MrBlue [Td Kd]
Dealt to Pluribus [Ah 9s]
Dealt to Budd [Kc Kh]
Dealt to Eddie [6s 2s]
Dealt to MrOrange [Ts 8s]
Pluribus: folds
Budd: raises 125 to 225
Eddie: folds
MrOrange: folds
Bill: folds
MrBlue: calls 125
*** FLOP *** [2h 7s As]
MrBlue: checks
Budd: bets 175
MrBlue: folds
Uncalled bet (175) returned to Budd
Budd collected 500.0 from pot
*** SUMMARY ***
Total pot 500 | Rake 0
Board [2h 7s As]


PokerStars Hand #73022: Hold'em No Limit (50/100) - 2019/07/11 20:17:02 ET
Table 'Pluribus Session 73' 6-max (Play Money) Seat #6 is the button
Seat 1: MrBlue (10000 in chips)
Seat 2: Pluribus (10000 in chips)
Seat 3: Budd (10000 in chips)
Seat 4: Eddie (10000 in chips)
Seat 5: MrOrange (10000 in chips)
Seat 6: Bill (10000 in chips)
MrBlue: posts small blind 50
Pluribus: posts big blind 100
*** HOLE CARDS ***
Dealt to MrBlue [Ah 3d]
Dealt to Pluribus [Qh 9c]
Dealt to Budd [9d Js]
Dealt to Eddie [5s 6c]
Dealt to MrOrange [Qd Th]
Dealt to Bill [5d Ks]
Budd: folds
Eddie: folds
MrOrange: folds
Bill: folds
MrBlue: raises 200 to 300
Pluribus: calls 200
*** FLOP *** [Qs As 2c]
MrBlue: checks
Pluribus: checks
*** TURN *** [Qs As 2c] [Kd]
MrBlue: checks
Pluribus: checks
*** RIVER *** [Qs As 2c] [Kd] [Ts]
MrBlue: checks
Pluribus: checks
*** SHOWDOWN ***
MrBlue: shows [Ah 3d]
MrBlue collected 600.0 from pot
*** SUMMARY ***
Total pot 600 | Rake 0
Board [Qs As 2c Kd Ts]
Seat 1: MrBlue showed [Ah 3d] and won (600.0)
Seat 2: Pluribus showed [Qh 9c] and lost


PokerStars Hand #73023: Hold'em No Limit (50/100) - 2019/07/11 20:17:03 ET
Table 'Pluribus Session 73' 6-max (Play Money) Seat #6 is the button
Seat 1: Pluribus (10000 in chips)
Seat 2: Budd (10000 in chips)
Seat 3: Eddie (10000 in chips)
Seat 4: MrOrange (10000 in chips)
Seat 5: Bill (10000 in chips)
Seat 6: MrBlue (10000 in chips)
Pluribus: posts small blind 50
Budd: posts big blind 100
*** HOLE CARDS ***
Dealt to Pluribus [3h Kh]
Dealt to Budd [7s 4c]
Dealt to Eddie [5s 2h]
Dealt to MrOrange [Qd 3c]
Dealt to Bill [6h Qh]
Dealt to MrBlue [Qs 9s]
Eddie: calls 100
MrOrange: folds
Bill: folds
MrBlue: raises 200 to 300
Pluribus: folds
Budd: folds
Eddie: folds
Uncalled bet (200) returned to MrBlue
MrBlue collected 350.0 from pot
*** SUMMARY ***
Total pot 350 | Rake 0


PokerStars Hand #73024: Hold'em No Limit (50/100) - 2019/07/11 20:17:04 ET
Table 'Pluribus Session 73' 6-max (Play Money) Seat #6 is the button
Seat 1: Budd (10000 in chips)
Seat 2: Eddie (10000 in chips)
Seat 3: MrOrange (10000 in chips)
Seat 4: Bill (10000 in chips)
Seat 5: MrBlue (10000 in chips)
Seat 6: Pluribus (10000 in chips)
Budd: posts small blind 50
Eddie: posts big blind 100
*** HOLE CARDS ***
Dealt to Budd [Qh Qd]
Dealt to Eddie [Jd 4d]
Dealt to MrOrange [Tc 2c]
Dealt to Bill [9h 5d]
Dealt to MrBlue [4s Qc]
Dealt to Pluribus [2h 3c]
MrOrange: folds
Bill: folds
MrBlue: folds
Pluribus: folds
Budd: raises 200 to 300
Eddie: calls 200
*** FLOP *** [8d 5h Ac]
Budd: checks
Eddie: bets 150
Budd: calls 150
*** TURN *** [8d 5h Ac] [4h]
Budd: checks
Eddie: checks
*** RIVER *** [8d 5h Ac] [4h] [4c]
Budd: bets 300
Eddie: raises 1500 to 1800
Budd: folds
Uncalled bet (1500) returned to Eddie
Eddie collected 1500.0 from pot
*** SUMMARY ***
Total pot 1500 | Rake 0
Board [8d 5h Ac 4h 4c]


PokerStars Hand #73025: Hold'em No Limit (50/100) - 2019/07/11 20:17:05 ET
Table 'Pluribus Session 73' 6-max (Play Money) Seat #6 is the button
Seat 1: Eddie (10000 in chips)
Seat 2: MrOrange (10000 in chips)
Seat 3: Bill (10000 in chips)
Seat 4: MrBlue (10000 in chips)
Seat 5: Pluribus (10000 in chips)
Seat 6: Budd (10000 in chips)
Eddie: posts small blind 50
MrOrange: posts big blind 100
*** HOLE CARDS ***
Dealt to Eddie [Kd 8h]
Dealt to MrOrange [9d 4h]
Dealt to Bill [3c Ts]
Dealt to MrBlue [9c 2c]
Dealt to Pluribus [Ad 9h]
Dealt to Budd [5s Qd]
Bill: folds
MrBlue: folds
Pluribus: raises 125 to 225
Budd: folds
Eddie: folds
MrOrange: folds
Uncalled bet (125) returned to Pluribus
Pluribus collected 250.0 from pot
*** SUMMARY ***
Total pot 250 | Rake 0


PokerStars Hand #73026: Hold'em No Limit (50/100) - 2019/07/11 20:17:06 ET
Table 'Pluribus Session 73' 6-max (Play Money) Seat #6 is the button
Seat 1: MrOrange (10000 in chips)
Seat 2: Bill (10000 in chips)
Seat 3: MrBlue (10000 in chips)
Seat 4: Pluribus (10000 in chips)
Seat 5: Budd (10000 in chips)
Seat 6: Eddie (10000 in chips)
MrOrange: posts small blind 50
Bill: posts big blind 100
*** HOLE CARDS ***
Dealt to MrOrange [2s 7d]
Dealt to Bill [As Jc]
Dealt to MrBlue [8d 6s]
Dealt to Pluribus [2h 8s]
Dealt to Budd [6d Qd]
Dealt to Eddie [9s 5s]
MrBlue: folds
Pluribus: folds
Budd: raises 125 to 225
Eddie: folds
MrOrange: folds
Bill: calls 125
*** FLOP *** [7s 9h 3c]
Bill: checks
Budd: bets 400
Bill: folds
Uncalled bet (400) returned to Budd
Budd collected 500.0 from pot
*** SUMMARY ***
Total pot 500 | Rake 0
Board [7s 9h 3c]


PokerStars Hand #73027: Hold'em No Limit (50/100) - 2019/07/11 20:17:07 ET
Table 'Pluribus Session 73' 6-max (Play Money) Seat #6 is the button
Seat 1: Bill (10000 in chips)
Seat 2: MrBlue (10000 in chips)
Seat 3: Pluribus (10000 in chips)
Seat 4: Budd (10000 in chips)
Seat 5: Eddie (10000 in chips)
Seat 6: MrOrange (10000 in chips)
Bill: posts small blind 50
MrBlue: posts big blind 100
*** HOLE CARDS ***
Dealt to Bill [7c 9c]
Dealt to MrBlue [9s Jc]
Dealt to Pluribus [2s 7d]
Dealt to Budd [9d As]
Dealt to Eddie [4s 3c]
Dealt to MrOrange [Qc 5d]
Pluribus: folds
Budd: folds
Eddie: folds
MrOrange: folds
Bill: raises 200 to 300
MrBlue: calls 200
*** FLOP *** [3s 4c Kh]
Bill: bets 300
MrBlue: calls 300
*** TURN *** [3s 4c Kh] [Tc]
Bill: bets 900
MrBlue: folds
Uncalled bet (900) returned to Bill
Bill collected 1200.0 from pot
*** SUMMARY ***
Total pot 1200 | Rake 0
Board [3s 4c Kh Tc]


PokerStars Hand #73028: Hold'em No Limit (50/100) - 2019/07/11 20:17:08 ET
Table 'Pluribus Session 73' 6-max (Play Money) Seat #6 is the button
Seat 1: MrBlue (10000 in chips)
Seat 2: Pluribus (10000 in chips)
Seat 3: Budd (10000 in chips)
Seat 4: Eddie (10000 in chips)
Seat 5: MrOrange (10000 in chips)
Seat 6: Bill (10000 in chips)
MrBlue: posts small blind 50
Pluribus: posts big blind 100
*** HOLE CARDS ***
Dealt to MrBlue [Js 8s]
Dealt to Pluribus [3d Kd]
Dealt to Budd [Jc 2d]
Dealt to Eddie [7s 4c]
Dealt to MrOrange [Qs Tc]
Dealt to Bill [7d 3s]
Budd: folds
Eddie: folds
MrOrange: folds
Bill: folds
MrBlue: raises 200 to 300
Pluribus: calls 200
*** FLOP *** [9s 4h 6c]
MrBlue: bets 450
Pluribus: folds
Uncalled bet (450) returned to MrBlue
MrBlue collected 600.0 from pot
*** SUMMARY ***
Total pot 600 | Rake 0
Board [9s 4h 6c]


PokerStars Hand #73029: Hold'em No Limit (50/100) - 2019/07/11 20:17:09 ET
Table 'Pluribus Session 73' 6-max (Play Money) Seat #6 is the button
Seat 1: Pluribus (10000 in chips)
Seat 2: Budd (10000 in chips)
Seat 3: Eddie (10000 in chips)
Seat 4: MrOrange (10000 in chips)
Seat 5: Bill (10000 in chips)
Seat 6: MrBlue (10000 in chips)
Pluribus: posts small blind 50
Budd: posts big blind 100
*** HOLE CARDS ***
Dealt to Pluribus [Js 8s]
Dealt to Budd [2d 3d]
Dealt to Eddie [3s Ah]
Dealt to MrOrange [Th 8c]
Dealt to Bill [9d Jd]
Dealt to MrBlue [Kc 4d]
Eddie: folds
MrOrange: folds
Bill: raises 125 to 225
MrBlue: folds
Pluribus: folds
Budd: folds
Uncalled bet (125) returned to Bill
Bill collected 250.0 from pot
*** SUMMARY ***
Total pot 250 | Rake 0


PokerStars Hand #73030: Hold'em No Limit (50/100) - 2019/07/11 20:17:10 ET
Table 'Pluribus Session 73' 6-max (Play Money) Seat #6 is the button
Seat 1: Budd (10000 in chips)
Seat 2: Eddie (10000 in chips)
Seat 3: MrOrange (10000 in chips)
Seat 4: Bill (10000 in chips)
Seat 5: MrBlue (10000 in chips)
Seat 6: Pluribus (10000 in chips)
Budd: posts small blind 50
Eddie: posts big blind 100
*** HOLE CARDS ***
Dealt to Budd [2d 3d]
Dealt to Eddie [3h 8d]
Dealt to MrOrange [5s Th]
Dealt to Bill [6s 8s]
Dealt to MrBlue [3c 5h]
Dealt to Pluribus [Ah 4c]
MrOrange: folds
Bill: raises 125 to 225
MrBlue: folds
Pluribus: folds
Budd: folds
Eddie: folds
Uncalled bet (125) returned to Bill
Bill collected 250.0 from pot
*** SUMMARY ***
Total pot 250 | Rake 0


PokerStars Hand #73031: Hold'em No Limit (50/100) - 2019/07/11 20:17:11 ET
Table 'Pluribus Session 73' 6-max (Play Money) Seat #6 is the button
Seat 1: Eddie (10000 in chips)
Seat 2: MrOrange (10000 in chips)
Seat 3: Bill (10000 in chips)
Seat 4: MrBlue (10000 in chips)
Seat 5: Pluribus (10000 in chips)
Seat 6: Budd (10000 in chips)
Eddie: posts small blind 50
MrOrange: posts big blind 100
*** HOLE CARDS ***
Dealt to Eddie [Td 3c]
Dealt to MrOrange [3s 6d]
Dealt to Bill [Kd 8s]
Dealt to MrBlue [Jd Ts]
Dealt to Pluribus [5d Qc]
Dealt to Budd [2d 8d]
Bill: folds
MrBlue: folds
Pluribus: folds
Budd: folds
Eddie: folds
Uncalled bet (50) returned to MrOrange
MrOrange collected 100.0 from pot
*** SUMMARY ***
Total pot 100 | Rake 0


PokerStars Hand #73032: Hold'em No Limit (50/100) - 2019/07/11 20:17:12 ET
Table 'Pluribus Session 73' 6-max (Play Money) Seat #6 is the button
Seat 1: MrOrange (10000 in chips)
Seat 2: Bill (10000 in chips)
Seat 3: MrBlue (10000 in chips)
Seat 4: Pluribus (10000 in chips)
Seat 5: Budd (10000 in chips)
Seat 6: Eddie (10000 in chips)
MrOrange: posts small blind 50
Bill: posts big blind 100
*** HOLE CARDS ***
Dealt to MrOrange [4d 7h]
Dealt to Bill [Js 5c]
Dealt to MrBlue [4h 6s]
Dealt to Pluribus [Kd 8s]
Dealt to Budd [8h Ac]
Dealt to Eddie [9s 7s]
MrBlue: folds
Pluribus: folds
Budd: raises 125 to 225
Eddie: folds
MrOrange: folds
Bill: folds
Uncalled bet (125) returned to Budd
Budd collected 250.0 from pot
*** SUMMARY ***
Total pot 250 | Rake 0


PokerStars Hand #73033: Hold'em No Limit (50/100) - 2019/07/11 20:17:13 ET
Table 'Pluribus Session 73' 6-max (Play Money) Seat #6 is the button
Seat 1: Bill (10000 in chips)
Seat 2: MrBlue (10000 in chips)
Seat 3: Pluribus (10000 in chips)
Seat 4: Budd (10000 in chips)
Seat 5: Eddie (10000 in chips)
Seat 6: MrOrange (10000 in chips)
Bill: posts small blind 50
MrBlue: posts big blind 100
*** HOLE CARDS ***
Dealt to Bill [7c 2s]
Dealt to MrBlue [Ts Jh]
Dealt to Pluribus [7d Qh]
Dealt to Budd [6d Td]
Dealt to Eddie [5h Ac]
Dealt to MrOrange [4c 3d]
Pluribus: folds
Budd: folds
Eddie: folds
MrOrange: folds
Bill: folds
Uncalled bet (50) returned to MrBlue
MrBlue collected 100.0 from pot
*** SUMMARY ***
Total pot 100 | Rake 0


PokerStars Hand #73034: Hold'em No Limit (50/100) - 2019/07/11 20:17:14 ET
Table 'Pluribus Session 73' 6-max (Play Money) Seat #6 is the button
Seat 1: MrBlue (10000 in chips)
Seat 2: Pluribus (10000 in chips)
Seat 3: Budd (10000 in chips)
Seat 4: Eddie (10000 in chips)
Seat 5: MrOrange (10000 in chips)
Seat 6: Bill (10000 in chips)
MrBlue: posts small blind 50
Pluribus: posts big blind 100
*** HOLE CARDS ***
Dealt to MrBlue [As 9h]
Dealt to Pluribus [Ts 4d]
Dealt to Budd [4s 8d]
Dealt to Eddie [9d Jd]
Dealt to MrOrange [Jc 3c]
Dealt to Bill [5h Th]
Budd: folds
Eddie: raises 100 to 200
MrOrange: folds
Bill: folds
MrBlue: folds
Pluribus: folds
Uncalled bet (100) returned to Eddie
Eddie collected 250.0 from pot
*** SUMMARY ***
Total pot 250 | Rake 0


PokerStars Hand #73035: Hold'em No Limit (50/100) - 2019/07/11 20:17:15 ET
Table 'Pluribus Session 73' 6-max (Play Money) Seat #6 is the button
Seat 1: Pluribus (10000 in chips)
Seat 2: Budd (10000 in chips)
Seat 3: Eddie (10000 in chips)
Seat 4: MrOrange (10000 in chips)
Seat 5: Bill (10000 in chips)
Seat 6: MrBlue (10000 in chips)
Pluribus: posts small blind 50
Budd: posts big blind 100
*** HOLE CARDS ***
Dealt to Pluribus [4h 2c]
Dealt to Budd [Jd 2h]
Dealt to Eddie [Tc Ts]
Dealt to MrOrange [Ad 6h]
Dealt to Bill [8s 7s]
Dealt to MrBlue [2s Qh]
Eddie: raises 100 to 200
MrOrange: folds
Bill: folds
MrBlue: folds
Pluribus: folds
Budd: folds
Uncalled bet (100) returned to Eddie
Eddie collected 250.0 from pot
*** SUMMARY ***
Total pot 250 | Rake 0


PokerStars Hand #73036: Hold'em No Limit (50/100) - 2019/07/11 20:17:16 ET
Table 'Pluribus Session 73' 6-max (Play Money) Seat #6 is the button
Seat 1: Budd (10000 in chips)
Seat 2: Eddie (10000 in chips)
Seat 3: MrOrange (10000 in chips)
Seat 4: Bill (10000 in chips)
Seat 5: MrBlue (10000 in chips)
Seat 6: Pluribus (10000 in chips)
Budd: posts small blind 50
Eddie: posts big blind 100
*** HOLE CARDS ***
Dealt to Budd [3s 5c]
Dealt to Eddie [Qs 8d]
Dealt to MrOrange [Kd 4c]
Dealt to Bill [Ah Kc]
Dealt to MrBlue [Js 2h]
Dealt to Pluribus [Qh 9s]
MrOrange: folds
Bill: raises 125 to 225
MrBlue: folds
Pluribus: folds
Budd: folds
Eddie: folds
Uncalled bet (125) returned to Bill
Bill collected 250.0 from pot
*** SUMMARY ***
Total pot 250 | Rake 0


PokerStars Hand #73037: Hold'em No Limit (50/100) - 2019/07/11 20:17:17 ET
Table 'Pluribus Session 73' 6-max (Play Money) Seat #6 is the button
Seat 1: Eddie (10000 in chips)
Seat 2: MrOrange (10000 in chips)
Seat 3: Bill (10000 in chips)
Seat 4: MrBlue (10000 in chips)
Seat 5: Pluribus (10000 in chips)
Seat 6: Budd (10000 in chips)
Eddie: posts small blind 50
MrOrange: posts big blind 100
*** HOLE CARDS ***
Dealt to Eddie [Js 8h]
Dealt to MrOrange [Ad 6h]
Dealt to Bill [4h Ac]
Dealt to MrBlue [7h 6s]
Dealt to Pluribus [2h 7s]
Dealt to Budd [Kc 8s]
Bill: folds
MrBlue: folds
Pluribus: folds
Budd: raises 150 to 250
Eddie: folds
MrOrange: calls 150
*** FLOP *** [Ts 6c 5c]
MrOrange: checks
Budd: bets 400
MrOrange: calls 400
*** TURN *** [Ts 6c 5c] [7c]
MrOrange: checks
Budd: bets 1050
MrOrange: folds
Uncalled bet (1050) returned to Budd
Budd collected 1350.0 from pot
*** SUMMARY ***
Total pot 1350 | Rake 0
Board [Ts 6c 5c 7c]


PokerStars Hand #73038: Hold'em No Limit (50/100) - 2019/07/11 20:17:18 ET
Table 'Pluribus Session 73' 6-max (Play Money) Seat #6 is the button
Seat 1: MrOrange (10000 in chips)
Seat 2: Bill (10000 in chips)
Seat 3: MrBlue (10000 in chips)
Seat 4: Pluribus (10000 in chips)
Seat 5: Budd (10000 in chips)
Seat 6: Eddie (10000 in chips)
MrOrange: posts small blind 50
Bill: posts big blind 100
*** HOLE CARDS ***
Dealt to MrOrange [4d Jh]
Dealt to Bill [Ad Qd]
Dealt to MrBlue [9d 7d]
Dealt to Pluribus [7c 9s]
Dealt to Budd [3c 6h]
Dealt to Eddie [8d Js]
MrBlue: raises 125 to 225
Pluribus: folds
Budd: folds
Eddie: folds
MrOrange: folds
Bill: raises 775 to 1000
MrBlue: calls 775
*** FLOP *** [Jd 5c Qh]
Bill: bets 1025
MrBlue: folds
Uncalled bet (1025) returned to Bill
Bill collected 2050.0 from pot
*** SUMMARY ***
Total pot 2050 | Rake 0
Board [Jd 5c Qh]


PokerStars Hand #73039: Hold'em No Limit (50/100) - 2019/07/11 20:17:19 ET
Table 'Pluribus Session 73' 6-max (Play Money) Seat #6 is the button
Seat 1: Bill (10000 in chips)
Seat 2: MrBlue (10000 in chips)
Seat 3: Pluribus (10000 in chips)
Seat 4: Budd (10000 in chips)
Seat 5: Eddie (10000 in chips)
Seat 6: MrOrange (10000 in chips)
Bill: posts small blind 50
MrBlue: posts big blind 100
*** HOLE CARDS ***
Dealt to Bill [Jh 5d]
Dealt to MrBlue [2c 9d]
Dealt to Pluribus [Jc Th]
Dealt to Budd [Qd 9c]
Dealt to Eddie [9s Qc]
Dealt to MrOrange [2s 3d]
Pluribus: raises 100 to 200
Budd: folds
Eddie: folds
MrOrange: folds
Bill: folds
MrBlue: folds
Uncalled bet (100) returned to Pluribus
Pluribus collected 250.0 from pot
*** SUMMARY ***
Total pot 250 | Rake 0


PokerStars Hand #73040: Hold'em No Limit (50/100) - 2019/07/11 20:17:20 ET
Table 'Pluribus Session 73' 6-max (Play Money) Seat #6 is the button
Seat 1: MrBlue (10000 in chips)
Seat 2: Pluribus (10000 in chips)
Seat 3: Budd (10000 in chips)
Seat 4: Eddie (10000 in chips)
Seat 5: MrOrange (10000 in chips)
Seat 6: Bill (10000 in chips)
MrBlue: posts small blind 50
Pluribus: posts big blind 100
*** HOLE CARDS ***
Dealt to MrBlue [8s Jc]
Dealt to Pluribus [Kd Kc]
Dealt to Budd [8h 4c]
Dealt to Eddie [2c Th]
Dealt to MrOrange [4s 6d]
Dealt to Bill [3c 2h]
Budd: folds
Eddie: folds
MrOrange: folds
Bill: folds
MrBlue: raises 300 to 400
Pluribus: raises 600 to 1000
MrBlue: folds
Uncalled bet (600) returned to Pluribus
Pluribus collected 800.0 from pot
*** SUMMARY ***
Total pot 800 | Rake 0


PokerStars Hand #73041: Hold'em No Limit (50/100) - 2019/07/11 20:17:21 ET
Table 'Pluribus Session 73' 6-max (Play Money) Seat #6 is the button
Seat 1: Pluribus (10000 in chips)
Seat 2: Budd (10000 in chips)
Seat 3: Eddie (10000 in chips)
Seat 4: MrOrange (10000 in chips)
Seat 5: Bill (10000 in chips)
Seat 6: MrBlue (10000 in chips)
Pluribus: posts small blind 50
Budd: posts big blind 100
*** HOLE CARDS ***
Dealt to Pluribus [Ac Jc]
Dealt to Budd [6h 9s]
Dealt to Eddie [7h Jh]
Dealt to MrOrange [5h 6c]
Dealt to Bill [Kc 8h]
Dealt to MrBlue [3c 8s]
Eddie: folds
MrOrange: folds
Bill: folds
MrBlue: folds
Pluribus: raises 175 to 275
Budd: folds
Uncalled bet (175) returned to Pluribus
Pluribus collected 200.0 from pot
*** SUMMARY ***
Total pot 200 | Rake 0


PokerStars Hand #73042: Hold'em No Limit (50/100) - 2019/07/11 20:17:22 ET
Table 'Pluribus Session 73' 6-max (Play Money) Seat #6 is the button
Seat 1: Budd (10000 in chips)
Seat 2: Eddie (10000 in chips)
Seat 3: MrOrange (10000 in chips)
Seat 4: Bill (10000 in chips)
Seat 5: MrBlue (10000 in chips)
Seat 6: Pluribus (10000 in chips)
Budd: posts small blind 50
Eddie: posts big blind 100
*** HOLE CARDS ***
Dealt to Budd [Td Tc]
Dealt to Eddie [Kc Jh]
Dealt to MrOrange [Ah Ac]
Dealt to Bill [6d 5h]
Dealt to MrBlue [As Th]
Dealt to Pluribus [7s Ks]
MrOrange: raises 110 to 210
Bill: folds
MrBlue: folds
Pluribus: raises 815 to 1025
Budd: folds
Eddie: folds
MrOrange: raises 1225 to 2250
Pluribus: folds
Uncalled bet (1225) returned to MrOrange
MrOrange collected 2200.0 from pot
*** SUMMARY ***
Total pot 2200 | Rake 0


PokerStars Hand #73043: Hold'em No Limit (50/100) - 2019/07/11 20:17:23 ET
Table 'Pluribus Session 73' 6-max (Play Money) Seat #6 is the button
Seat 1: Eddie (10000 in chips)
Seat 2: MrOrange (10000 in chips)
Seat 3: Bill (10000 in chips)
Seat 4: MrBlue (10000 in chips)
Seat 5: Pluribus (10000 in chips)
Seat 6: Budd (10000 in chips)
Eddie: posts small blind 50
MrOrange: posts big blind 100
*** HOLE CARDS ***
Dealt to Eddie [2d 8h]
Dealt to MrOrange [8s 6s]
Dealt to Bill [6h 9s]
Dealt to MrBlue [9d Qs]
Dealt to Pluribus [Qh 3c]
Dealt to Budd [3d 7d]
Bill: folds
MrBlue: folds
Pluribus: folds
Budd: folds
Eddie: folds
Uncalled bet (50) returned to MrOrange
MrOrange collected 100.0 from pot
*** SUMMARY ***
Total pot 100 | Rake 0


PokerStars Hand #73044: Hold'em No Limit (50/100) - 2019/07/11 20:17:24 ET
Table 'Pluribus Session 73' 6-max (Play Money) Seat #6 is the button
Seat 1: MrOrange (10000 in chips)
Seat 2: Bill (10000 in chips)
Seat 3: MrBlue (10000 in chips)
Seat 4: Pluribus (10000 in chips)
Seat 5: Budd (10000 in chips)
Seat 6: Eddie (10000 in chips)
MrOrange: posts small blind 50
Bill: posts big blind 100
*** HOLE CARDS ***
Dealt to MrOrange [4s 5h]
Dealt to Bill [Jh 6s]
Dealt to MrBlue [Kd 9d]
Dealt to Pluribus [4c 7d]
Dealt to Budd [Ks 5s]
Dealt to Eddie [Jd Qs]
MrBlue: raises 125 to 225
Pluribus: folds
Budd: folds
Eddie: folds
MrOrange: folds
Bill: folds
Uncalled bet (125) returned to MrBlue
MrBlue collected 250.0 from pot
*** SUMMARY ***
Total pot 250 | Rake 0


PokerStars Hand #73045: Hold'em No Limit (50/100) - 2019/07/11 20:17:25 ET
Table 'Pluribus Session 73' 6-max (Play Money) Seat #6 is the button
Seat 1: Bill (10000 in chips)
Seat 2: MrBlue (10000 in chips)
Seat 3: Pluribus (10000 in chips)
Seat 4: Budd (10000 in chips)
Seat 5: Eddie (10000 in chips)
Seat 6: MrOrange (10000 in chips)
Bill: posts small blind 50
MrBlue: posts big blind 100
*** HOLE CARDS ***
Dealt to Bill [9d 4d]
Dealt to MrBlue [5h 5c]
Dealt to Pluribus [Jd 7s]
Dealt to Budd [Qs Jc]
Dealt to Eddie [8c 2d]
Dealt to MrOrange [6c 3d]
Pluribus: folds
Budd: raises 125 to 225
Eddie: folds
MrOrange: folds
Bill: folds
MrBlue: calls 125
*** FLOP *** [3c 4h Js]
MrBlue: checks
Budd: bets 175
MrBlue: calls 175
*** TURN *** [3c 4h Js] [7d]
MrBlue: checks
Budd: checks
*** RIVER *** [3c 4h Js] [7d] [6s]
MrBlue: bets 637
Budd: calls 637
*** SHOWDOWN ***
MrBlue: shows [5h 5c]
MrBlue collected 2124.0 from pot
*** SUMMARY ***
Total pot 2124 | Rake 0
Board [3c 4h Js 7d 6s]
Seat 2: MrBlue showed [5h 5c] and won (2124.0)
Seat 4: Budd showed [Qs Jc] and lost


PokerStars Hand #73046: Hold'em No Limit (50/100) - 2019/07/11 20:17:26 ET
Table 'Pluribus Session 73' 6-max (Play Money) Seat #6 is the button
Seat 1: MrBlue (10000 in chips)
Seat 2: Pluribus (10000 in chips)
Seat 3: Budd (10000 in chips)
Seat 4: Eddie (10000 in chips)
Seat 5: MrOrange (10000 in chips)
Seat 6: Bill (10000 in chips)
MrBlue: posts small blind 50
Pluribus: posts big blind 100
*** HOLE CARDS ***
Dealt to MrBlue [4d Jd]
Dealt to Pluribus [2c 4h]
Dealt to Budd [8d 7h]
Dealt to Eddie [As 9c]
Dealt to MrOrange [Ks 3d]
Dealt to Bill [7c Jc]
Budd: folds
Eddie: folds
MrOrange: folds
Bill: raises 150 to 250
MrBlue: folds
Pluribus: folds
Uncalled bet (150) returned to Bill
Bill collected 250.0 from pot
*** SUMMARY ***
Total pot 250 | Rake 0


PokerStars Hand #73047: Hold'em No Limit (50/100) - 2019/07/11 20:17:27 ET
Table 'Pluribus Session 73' 6-max (Play Money) Seat #6 is the button
Seat 1: Pluribus (10000 in chips)
Seat 2: Budd (10000 in chips)
Seat 3: Eddie (10000 in chips)
Seat 4: MrOrange (10000 in chips)
Seat 5: Bill (10000 in chips)
Seat 6: MrBlue (10000 in chips)
Pluribus: posts small blind 50
Budd: posts big blind 100
*** HOLE CARDS ***
Dealt to Pluribus [8c Jd]
Dealt to Budd [7s 9d]
Dealt to Eddie [2d 7d]
Dealt to MrOrange [5d Kh]
Dealt to Bill [4h Qc]
Dealt to MrBlue [8d 6d]
Eddie: folds
MrOrange: folds
Bill: folds
MrBlue: raises 125 to 225
Pluribus: folds
Budd: calls 125
*** FLOP *** [5c Th Tc]
Budd: checks
MrBlue: bets 200
Budd: folds
Uncalled bet (200) returned to MrBlue
MrBlue collected 500.0 from pot
*** SUMMARY ***
Total pot 500 | Rake 0
Board [5c Th Tc]


PokerStars Hand #73048: Hold'em No Limit (50/100) - 2019/07/11 20:17:28 ET
Table 'Pluribus Session 73' 6-max (Play Money) Seat #6 is the button
Seat 1: Budd (10000 in chips)
Seat 2: Eddie (10000 in chips)
Seat 3: MrOrange (10000 in chips)
Seat 4: Bill (10000 in chips)
Seat 5: MrBlue (10000 in chips)
Seat 6: Pluribus (10000 in chips)
Budd: posts small blind 50
Eddie: posts big blind 100
*** HOLE CARDS ***
Dealt to Budd [3h 9s]
Dealt to Eddie [Js 2c]
Dealt to MrOrange [Qc Kc]
Dealt to Bill [As 9c]
Dealt to MrBlue [4s 3s]
Dealt to Pluribus [3d 2s]
MrOrange: raises 110 to 210
Bill: folds
MrBlue: raises 520 to 730
Pluribus: folds
Budd: folds
Eddie: folds
MrOrange: calls 520
*** FLOP *** [Qs 4d Ad]
MrOrange: checks
MrBlue: checks
*** TURN *** [Qs 4d Ad] [8c]
MrOrange: checks
MrBlue: checks
*** RIVER *** [Qs 4d Ad] [8c] [2d]
MrOrange: bets 555
MrBlue: folds
Uncalled bet (555) returned to MrOrange
MrOrange collected 1610.0 from pot
*** SUMMARY ***
Total pot 1610 | Rake 0
Board [Qs 4d Ad 8c 2d]


PokerStars Hand #73049: Hold'em No Limit (50/100) - 2019/07/11 20:17:29 ET
Table 'Pluribus Session 73' 6-max (Play Money) Seat #6 is the button
Seat 1: Eddie (10000 in chips)
Seat 2: MrOrange (10000 in chips)
Seat 3: Bill (10000 in chips)
Seat 4: MrBlue (10000 in chips)
Seat 5: Pluribus (10000 in chips)
Seat 6: Budd (10000 in chips)
Eddie: posts small blind 50
MrOrange: posts big blind 100
*** HOLE CARDS ***
Dealt to Eddie [4c 8s]
Dealt to MrOrange [Qc Qd]
Dealt to Bill [8c 3d]
Dealt to MrBlue [Kc 7d]
Dealt to Pluribus [Qh 7h]
Dealt to Budd [Ks Kd]
Bill: folds
MrBlue: folds
Pluribus: raises 100 to 200
Budd: raises 520 to 720
Eddie: folds
MrOrange: raises 1255 to 1975
Pluribus: folds
Budd: raises 8025 to 10000 and is all-in
MrOrange: calls 8025 and is all-in
*** FLOP *** [5s 2s 4s]
*** TURN *** [5s 2s 4s] [Qs]
*** RIVER *** [5s 2s 4s] [Qs] [Ac]
*** SHOWDOWN ***
Budd: shows [Ks Kd]
Budd collected 20250.0 from pot
*** SUMMARY ***
Total pot 20250 | Rake 0
Board [5s 2s 4s Qs Ac]
Seat 2: MrOrange showed [Qc Qd] and lost
Seat 6: Budd showed [Ks Kd] and won (20250.0)


PokerStars Hand #73050: Hold'em No Limit (50/100) - 2019/07/11 20:17:30 ET
Table 'Pluribus Session 73' 6-max (Play Money) Seat #6 is the button
Seat 1: MrOrange (10000 in chips)
Seat 2: Bill (10000 in chips)
Seat 3: MrBlue (10000 in chips)
Seat 4: Pluribus (10000 in chips)
Seat 5: Budd (10000 in chips)
Seat 6: Eddie (10000 in chips)
MrOrange: posts small blind 50
Bill: posts big blind 100
*** HOLE CARDS ***
Dealt to MrOrange [Qs 6h]
Dealt to Bill [6c 5d]
Dealt to MrBlue [9s 7c]
Dealt to Pluribus [4h 7s]
Dealt to Budd [2c 3c]
Dealt to Eddie [Th Kd]
MrBlue: folds
Pluribus: folds
Budd: folds
Eddie: raises 122 to 222
MrOrange: folds
Bill: calls 122
*** FLOP *** [Jc Jd Tc]
Bill: checks
Eddie: bets 150
Bill: folds
Uncalled bet (150) returned to Eddie
Eddie collected 494.0 from pot
*** SUMMARY ***
Total pot 494 | Rake 0
Board [Jc Jd Tc]


PokerStars Hand #73051: Hold'em No Limit (50/100) - 2019/07/11 20:17:31 ET
Table 'Pluribus Session 73' 6-max (Play Money) Seat #6 is the button
Seat 1: Bill (10000 in chips)
Seat 2: MrBlue (10000 in chips)
Seat 3: Pluribus (10000 in chips)
Seat 4: Budd (10000 in chips)
Seat 5: Eddie (10000 in chips)
Seat 6: MrOrange (10000 in chips)
Bill: posts small blind 50
MrBlue: posts big blind 100
*** HOLE CARDS ***
Dealt to Bill [3h 5d]
Dealt to MrBlue [7c 5s]
Dealt to Pluribus [8s Td]
Dealt to Budd [Ad 3c]
Dealt to Eddie [Kc Kd]
Dealt to MrOrange [Kh 4s]
Pluribus: folds
Budd: folds
Eddie: raises 100 to 200
MrOrange: folds
Bill: folds
MrBlue: calls 100
*** FLOP *** [9h 2d 8h]
MrBlue: checks
Eddie: bets 405
MrBlue: folds
Uncalled bet (405) returned to Eddie
Eddie collected 450.0 from pot
*** SUMMARY ***
Total pot 450 | Rake 0
Board [9h 2d 8h]


PokerStars Hand #73052: Hold'em No Limit (50/100) - 2019/07/11 20:17:32 ET
Table 'Pluribus Session 73' 6-max (Play Money) Seat #6 is the button
Seat 1: MrBlue (10000 in chips)
Seat 2: Pluribus (10000 in chips)
Seat 3: Budd (10000 in chips)
Seat 4: Eddie (10000 in chips)
Seat 5: MrOrange (10000 in chips)
Seat 6: Bill (10000 in chips)
MrBlue: posts small blind 50
Pluribus: posts big blind 100
*** HOLE CARDS ***
Dealt to MrBlue [3d Qs]
Dealt to Pluribus [9h Ts]
Dealt to Budd [4d 7d]
Dealt to Eddie [2d 7c]
Dealt to MrOrange [6s 9d]
Dealt to Bill [Qh 4s]
Budd: folds
Eddie: folds
MrOrange: folds
Bill: folds
MrBlue: raises 300 to 400
Pluribus: raises 600 to 1000
MrBlue: folds
Uncalled bet (600) returned to Pluribus
Pluribus collected 800.0 from pot
*** SUMMARY ***
Total pot 800 | Rake 0


PokerStars Hand #73053: Hold'em No Limit (50/100) - 2019/07/11 20:17:33 ET
Table 'Pluribus Session 73' 6-max (Play Money) Seat #6 is the button
Seat 1: Pluribus (10000 in chips)
Seat 2: Budd (10000 in chips)
Seat 3: Eddie (10000 in chips)
Seat 4: MrOrange (10000 in chips)
Seat 5: Bill (10000 in chips)
Seat 6: MrBlue (10000 in chips)
Pluribus: posts small blind 50
Budd: posts big blind 100
*** HOLE CARDS ***
Dealt to Pluribus [Th As]
Dealt to Budd [Tc 4c]
Dealt to Eddie [Jc 3h]
Dealt to MrOrange [Jh 2d]
Dealt to Bill [6s Js]
Dealt to MrBlue [9d 5d]
Eddie: folds
MrOrange: folds
Bill: folds
MrBlue: raises 125 to 225
Pluribus: calls 175
Budd: calls 125
*** FLOP *** [6h Ks 8d]
Pluribus: checks
Budd: checks
MrBlue: bets 337
Pluribus: folds
Budd: folds
Uncalled bet (337) returned to MrBlue
MrBlue collected 675.0 from pot
*** SUMMARY ***
Total pot 675 | Rake 0
Board [6h Ks 8d]


PokerStars Hand #73054: Hold'em No Limit (50/100) - 2019/07/11 20:17:34 ET
Table 'Pluribus Session 73' 6-max (Play Money) Seat #6 is the button
Seat 1: Budd (10000 in chips)
Seat 2: Eddie (10000 in chips)
Seat 3: MrOrange (10000 in chips)
Seat 4: Bill (10000 in chips)
Seat 5: MrBlue (10000 in chips)
Seat 6: Pluribus (10000 in chips)
Budd: posts small blind 50
Eddie: posts big blind 100
*** HOLE CARDS ***
Dealt to Budd [3h 7d]
Dealt to Eddie [Js 7s]
Dealt to MrOrange [8h Ac]
Dealt to Bill [Ts Jc]
Dealt to MrBlue [2d Ad]
Dealt to Pluribus [5c 4h]
MrOrange: folds
Bill: folds
MrBlue: raises 125 to 225
Pluribus: folds
Budd: folds
Eddie: calls 125
*** FLOP *** [Qd 8d Ks]
Eddie: checks
MrBlue: bets 250
Eddie: folds
Uncalled bet (250) returned to MrBlue
MrBlue collected 500.0 from pot
*** SUMMARY ***
Total pot 500 | Rake 0
Board [Qd 8d Ks]


PokerStars Hand #73055: Hold'em No Limit (50/100) - 2019/07/11 20:17:35 ET
Table 'Pluribus Session 73' 6-max (Play Money) Seat #6 is the button
Seat 1: Eddie (10000 in chips)
Seat 2: MrOrange (10000 in chips)
Seat 3: Bill (10000 in chips)
Seat 4: MrBlue (10000 in chips)
Seat 5: Pluribus (10000 in chips)
Seat 6: Budd (10000 in chips)
Eddie: posts small blind 50
MrOrange: posts big blind 100
*** HOLE CARDS ***
Dealt to Eddie [Ad 6h]
Dealt to MrOrange [9d 4h]
Dealt to Bill [9c Jc]
Dealt to MrBlue [Js 8c]
Dealt to Pluribus [8h 3d]
Dealt to Budd [8s 2h]
Bill: raises 125 to 225
MrBlue: folds
Pluribus: folds
Budd: folds
Eddie: folds
MrOrange: folds
Uncalled bet (125) returned to Bill
Bill collected 250.0 from pot
*** SUMMARY ***
Total pot 250 | Rake 0


PokerStars Hand #73056: Hold'em No Limit (50/100) - 2019/07/11 20:17:36 ET
Table 'Pluribus Session 73' 6-max (Play Money) Seat #6 is the button
Seat 1: MrOrange (10000 in chips)
Seat 2: Bill (10000 in chips)
Seat 3: MrBlue (10000 in chips)
Seat 4: Pluribus (10000 in chips)
Seat 5: Budd (10000 in chips)
Seat 6: Eddie (10000 in chips)
MrOrange: posts small blind 50
Bill: posts big blind 100
*** HOLE CARDS ***
Dealt to MrOrange [Qs 5s]
Dealt to Bill [4c Ts]
Dealt to MrBlue [2h Kh]
Dealt to Pluribus [7d 5d]
Dealt to Budd [7h 9h]
Dealt to Eddie [3h 4s]
MrBlue: folds
Pluribus: folds
Budd: raises 125 to 225
Eddie: folds
MrOrange: folds
Bill: folds
Uncalled bet (125) returned to Budd
Budd collected 250.0 from pot
*** SUMMARY ***
Total pot 250 | Rake 0


PokerStars Hand #73057: Hold'em No Limit (50/100) - 2019/07/11 20:17:37 ET
Table 'Pluribus Session 73' 6-max (Play Money) Seat #6 is the button
Seat 1: Bill (10000 in chips)
Seat 2: MrBlue (10000 in chips)
Seat 3: Pluribus (10000 in chips)
Seat 4: Budd (10000 in chips)
Seat 5: Eddie (10000 in chips)
Seat 6: MrOrange (10000 in chips)
Bill: posts small blind 50
MrBlue: posts big blind 100
*** HOLE CARDS ***
Dealt to Bill [5d Ad]
Dealt to MrBlue [2s 3h]
Dealt to Pluribus [2c Kh]
Dealt to Budd [Kd 8h]
Dealt to Eddie [5c 6h]
Dealt to MrOrange [3c Kc]
Pluribus: folds
Budd: folds
Eddie: folds
MrOrange: folds
Bill: raises 200 to 300
MrBlue: raises 600 to 900
Bill: calls 600
*** FLOP *** [6s 7h 8c]
Bill: checks
MrBlue: checks
*** TURN *** [6s 7h 8c] [Ks]
Bill: checks
MrBlue: checks
*** RIVER *** [6s 7h 8c] [Ks] [9s]
Bill: bets 1200
MrBlue: folds
Uncalled bet (1200) returned to Bill
Bill collected 1800.0 from pot
*** SUMMARY ***
Total pot 1800 | Rake 0
Board [6s 7h 8c Ks 9s]


PokerStars Hand #73058: Hold'em No Limit (50/100) - 2019/07/11 20:17:38 ET
Table 'Pluribus Session 73' 6-max (Play Money) Seat #6 is the button
Seat 1: MrBlue (10000 in chips)
Seat 2: Pluribus (10000 in chips)
Seat 3: Budd (10000 in chips)
Seat 4: Eddie (10000 in chips)
Seat 5: MrOrange (10000 in chips)
Seat 6: Bill (10000 in chips)
MrBlue: posts small blind 50
Pluribus: posts big blind 100
*** HOLE CARDS ***
Dealt to MrBlue [Kc 3s]
Dealt to Pluribus [7d 6h]
Dealt to Budd [Ad Ac]
Dealt to Eddie [3d 5h]
Dealt to MrOrange [8s 8c]
Dealt to Bill [8h Qc]
Budd: raises 125 to 225
Eddie: folds
MrOrange: calls 225
Bill: folds
MrBlue: folds
Pluribus: calls 125
*** FLOP *** [9d 7h 6s]
Pluribus: checks
Budd: checks
MrOrange: checks
*** TURN *** [9d 7h 6s] [Ts]
Pluribus: checks
Budd: checks
MrOrange: bets 400
Pluribus: calls 400
Budd: calls 400
*** RIVER *** [9d 7h 6s] [Ts] [4s]
Pluribus: checks
Budd: checks
MrOrange: checks
*** SHOWDOWN ***
MrOrange: shows [8s 8c]
MrOrange collected 1925.0 from pot
*** SUMMARY ***
Total pot 1925 | Rake 0
Board [9d 7h 6s Ts 4s]
Seat 2: Pluribus showed [7d 6h] and lost
Seat 3: Budd showed [Ad Ac] and lost
Seat 5: MrOrange showed [8s 8c] and won (1925.0)


PokerStars Hand #73059: Hold'em No Limit (50/100) - 2019/07/11 20:17:39 ET
Table 'Pluribus Session 73' 6-max (Play Money) Seat #6 is the button
Seat 1: Pluribus (10000 in chips)
Seat 2: Budd (10000 in chips)
Seat 3: Eddie (10000 in chips)
Seat 4: MrOrange (10000 in chips)
Seat 5: Bill (10000 in chips)
Seat 6: MrBlue (10000 in chips)
Pluribus: posts small blind 50
Budd: posts big blind 100
*** HOLE CARDS ***
Dealt to Pluribus [Tc 8d]
Dealt to Budd [Jd 4d]
Dealt to Eddie [Ks 6d]
Dealt to MrOrange [6s Kd]
Dealt to Bill [3c 3d]
Dealt to MrBlue [Qh Ad]
Eddie: folds
MrOrange: folds
Bill: raises 125 to 225
MrBlue: raises 555 to 780
Pluribus: folds
Budd: folds
Bill: calls 555
*** FLOP *** [5h 6c Th]
Bill: checks
MrBlue: checks
*** TURN *** [5h 6c Th] [7h]
Bill: checks
MrBlue: bets 1156
Bill: folds
Uncalled bet (1156) returned to MrBlue
MrBlue collected 1710.0 from pot
*** SUMMARY ***
Total pot 1710 | Rake 0
Board [5h 6c Th 7h]


PokerStars Hand #73060: Hold'em No Limit (50/100) - 2019/07/11 20:17:40 ET
Table 'Pluribus Session 73' 6-max (Play Money) Seat #6 is the button
Seat 1: Budd (10000 in chips)
Seat 2: Eddie (10000 in chips)
Seat 3: MrOrange (10000 in chips)
Seat 4: Bill (10000 in chips)
Seat 5: MrBlue (10000 in chips)
Seat 6: Pluribus (10000 in chips)
Budd: posts small blind 50
Eddie: posts big blind 100
*** HOLE CARDS ***
Dealt to Budd [6d 4h]
Dealt to Eddie [Jh Qd]
Dealt to MrOrange [9d 6h]
Dealt to Bill [7s Ts]
Dealt to MrBlue [6s 8c]
Dealt to Pluribus [9s Ah]
MrOrange: folds
Bill: folds
MrBlue: folds
Pluribus: raises 150 to 250
Budd: folds
Eddie: calls 150
*** FLOP *** [3s 4s 5h]
Eddie: checks
Pluribus: checks
*** TURN *** [3s 4s 5h] [5d]
Eddie: bets 165
Pluribus: calls 165
*** RIVER *** [3s 4s 5h] [5d] [7d]
Eddie: bets 260
Pluribus: folds
Uncalled bet (260) returned to Eddie
Eddie collected 880.0 from pot
*** SUMMARY ***
Total pot 880 | Rake 0
Board [3s 4s 5h 5d 7d]


PokerStars Hand #73061: Hold'em No Limit (50/100) - 2019/07/11 20:17:41 ET
Table 'Pluribus Session 73' 6-max (Play Money) Seat #6 is the button
Seat 1: Eddie (10000 in chips)
Seat 2: MrOrange (10000 in chips)
Seat 3: Bill (10000 in chips)
Seat 4: MrBlue (10000 in chips)
Seat 5: Pluribus (10000 in chips)
Seat 6: Budd (10000 in chips)
Eddie: posts small blind 50
MrOrange: posts big blind 100
*** HOLE CARDS ***
Dealt to Eddie [5d 5c]
Dealt to MrOrange [8d Kh]
Dealt to Bill [3c 5h]
Dealt to MrBlue [4c 3d]
Dealt to Pluribus [Js 2d]
Dealt to Budd [3s Ks]
Bill: folds
MrBlue: folds
Pluribus: folds
Budd: raises 150 to 250
Eddie: calls 200
MrOrange: folds
*** FLOP *** [7d Qh Ts]
Eddie: checks
Budd: checks
*** TURN *** [7d Qh Ts] [4h]
Eddie: checks
Budd: bets 300
Eddie: folds
Uncalled bet (300) returned to Budd
Budd collected 600.0 from pot
*** SUMMARY ***
Total pot 600 | Rake 0
Board [7d Qh Ts 4h]


PokerStars Hand #73062: Hold'em No Limit (50/100) - 2019/07/11 20:17:42 ET
Table 'Pluribus Session 73' 6-max (Play Money) Seat #6 is the button
Seat 1: MrOrange (10000 in chips)
Seat 2: Bill (10000 in chips)
Seat 3: MrBlue (10000 in chips)
Seat 4: Pluribus (10000 in chips)
Seat 5: Budd (10000 in chips)
Seat 6: Eddie (10000 in chips)
MrOrange: posts small blind 50
Bill: posts big blind 100
*** HOLE CARDS ***
Dealt to MrOrange [8c 4h]
Dealt to Bill [5c 2h]
Dealt to MrBlue [Ks Ts]
Dealt to Pluribus [6d 4c]
Dealt to Budd [8d 6s]
Dealt to Eddie [Qd 7s]
MrBlue: raises 125 to 225
Pluribus: folds
Budd: folds
Eddie: folds
MrOrange: folds
Bill: folds
Uncalled bet (125) returned to MrBlue
MrBlue collected 250.0 from pot
*** SUMMARY ***
Total pot 250 | Rake 0


PokerStars Hand #73063: Hold'em No Limit (50/100) - 2019/07/11 20:17:43 ET
Table 'Pluribus Session 73' 6-max (Play Money) Seat #6 is the button
Seat 1: Bill (10000 in chips)
Seat 2: MrBlue (10000 in chips)
Seat 3: Pluribus (10000 in chips)
Seat 4: Budd (10000 in chips)
Seat 5: Eddie (10000 in chips)
Seat 6: MrOrange (10000 in chips)
Bill: posts small blind 50
MrBlue: posts big blind 100
*** HOLE CARDS ***
Dealt to Bill [Th 5c]
Dealt to MrBlue [Qd 9c]
Dealt to Pluribus [Jd 4h]
Dealt to Budd [3c Kc]
Dealt to Eddie [6h 7s]
Dealt to MrOrange [3h Jh]
Pluribus: folds
Budd: folds
Eddie: folds
MrOrange: folds
Bill: folds
Uncalled bet (50) returned to MrBlue
MrBlue collected 100.0 from pot
*** SUMMARY ***
Total pot 100 | Rake 0


PokerStars Hand #73064: Hold'em No Limit (50/100) - 2019/07/11 20:17:44 ET
Table 'Pluribus Session 73' 6-max (Play Money) Seat #6 is the button
Seat 1: MrBlue (10000 in chips)
Seat 2: Pluribus (10000 in chips)
Seat 3: Budd (10000 in chips)
Seat 4: Eddie (10000 in chips)
Seat 5: MrOrange (10000 in chips)
Seat 6: Bill (10000 in chips)
MrBlue: posts small blind 50
Pluribus: posts big blind 100
*** HOLE CARDS ***
Dealt to MrBlue [8s 4d]
Dealt to Pluribus [Kd 3h]
Dealt to Budd [7s Td]
Dealt to Eddie [Kh 6s]
Dealt to MrOrange [9c 6h]
Dealt to Bill [9s 3c]
Budd: folds
Eddie: folds
MrOrange: folds
Bill: folds
MrBlue: folds
Uncalled bet (50) returned to Pluribus
Pluribus collected 100.0 from pot
*** SUMMARY ***
Total pot 100 | Rake 0


PokerStars Hand #73065: Hold'em No Limit (50/100) - 2019/07/11 20:17:45 ET
Table 'Pluribus Session 73' 6-max (Play Money) Seat #6 is the button
Seat 1: Pluribus (10000 in chips)
Seat 2: Budd (10000 in chips)
Seat 3: Eddie (10000 in chips)
Seat 4: MrOrange (10000 in chips)
Seat 5: Bill (10000 in chips)
Seat 6: MrBlue (10000 in chips)
Pluribus: posts small blind 50
Budd: posts big blind 100
*** HOLE CARDS ***
Dealt to Pluribus [9s 9d]
Dealt to Budd [5h Ts]
Dealt to Eddie [2c Tc]
Dealt to MrOrange [2h Ac]
Dealt to Bill [4c Th]
Dealt to MrBlue [5s Ah]
Eddie: folds
MrOrange: folds
Bill: folds
MrBlue: raises 125 to 225
Pluribus: raises 687 to 912
Budd: folds
MrBlue: folds
Uncalled bet (687) returned to Pluribus
Pluribus collected 550.0 from pot
*** SUMMARY ***
Total pot 550 | Rake 0


PokerStars Hand #73066: Hold'em No Limit (50/100) - 2019/07/11 20:17:46 ET
Table 'Pluribus Session 73' 6-max (Play Money) Seat #6 is the button
Seat 1: Budd (10000 in chips)
Seat 2: Eddie (10000 in chips)
Seat 3: MrOrange (10000 in chips)
Seat 4: Bill (10000 in chips)
Seat 5: MrBlue (10000 in chips)
Seat 6: Pluribus (10000 in chips)
Budd: posts small blind 50
Eddie: posts big blind 100
*** HOLE CARDS ***
Dealt to Budd [8d 8c]
Dealt to Eddie [7h 5d]
Dealt to MrOrange [8h 6c]
Dealt to Bill [7d 8s]
Dealt to MrBlue [3d 4d]
Dealt to Pluribus [Td Ks]
MrOrange: folds
Bill: folds
MrBlue: raises 125 to 225
Pluribus: folds
Budd: calls 175
Eddie: folds
*** FLOP *** [6h Ts Qd]
Budd: checks
MrBlue: checks
*** TURN *** [6h Ts Qd] [7s]
Budd: checks
MrBlue: bets 412
Budd: calls 412
*** RIVER *** [6h Ts Qd] [7s] [5s]
Budd: checks
MrBlue: bets 1120
Budd: folds
Uncalled bet (1120) returned to MrBlue
MrBlue collected 1374.0 from pot
*** SUMMARY ***
Total pot 1374 | Rake 0
Board [6h Ts Qd 7s 5s]


PokerStars Hand #73067: Hold'em No Limit (50/100) - 2019/07/11 20:17:47 ET
Table 'Pluribus Session 73' 6-max (Play Money) Seat #6 is the button
Seat 1: Eddie (10000 in chips)
Seat 2: MrOrange (10000 in chips)
Seat 3: Bill (10000 in chips)
Seat 4: MrBlue (10000 in chips)
Seat 5: Pluribus (10000 in chips)
Seat 6: Budd (10000 in chips)
Eddie: posts small blind 50
MrOrange: posts big blind 100
*** HOLE CARDS ***
Dealt to Eddie [Tc Qh]
Dealt to MrOrange [2h 7s]
Dealt to Bill [Jc 2c]
Dealt to MrBlue [As 4c]
Dealt to Pluribus [8c 3c]
Dealt to Budd [Js 9c]
Bill: folds
MrBlue: folds
Pluribus: folds
Budd: raises 150 to 250
Eddie: folds
MrOrange: folds
Uncalled bet (150) returned to Budd
Budd collected 250.0 from pot
*** SUMMARY ***
Total pot 250 | Rake 0


PokerStars Hand #73068: Hold'em No Limit (50/100) - 2019/07/11 20:17:48 ET
Table 'Pluribus Session 73' 6-max (Play Money) Seat #6 is the button
Seat 1: MrOrange (10000 in chips)
Seat 2: Bill (10000 in chips)
Seat 3: MrBlue (10000 in chips)
Seat 4: Pluribus (10000 in chips)
Seat 5: Budd (10000 in chips)
Seat 6: Eddie (10000 in chips)
MrOrange: posts small blind 50
Bill: posts big blind 100
*** HOLE CARDS ***
Dealt to MrOrange [Js Jc]
Dealt to Bill [4c Th]
Dealt to MrBlue [5s As]
Dealt to Pluribus [3c Ks]
Dealt to Budd [Jh 8d]
Dealt to Eddie [7s 3d]
MrBlue: raises 125 to 225
Pluribus: folds
Budd: folds
Eddie: folds
MrOrange: raises 925 to 1150
Bill: folds
MrBlue: raises 1350 to 2500
MrOrange: folds
Uncalled bet (1350) returned to MrBlue
MrBlue collected 2400.0 from pot
*** SUMMARY ***
Total pot 2400 | Rake 0


PokerStars Hand #73069: Hold'em No Limit (50/100) - 2019/07/11 20:17:49 ET
Table 'Pluribus Session 73' 6-max (Play Money) Seat #6 is the button
Seat 1: Bill (10000 in chips)
Seat 2: MrBlue (10000 in chips)
Seat 3: Pluribus (10000 in chips)
Seat 4: Budd (10000 in chips)
Seat 5: Eddie (10000 in chips)
Seat 6: MrOrange (10000 in chips)
Bill: posts small blind 50
MrBlue: posts big blind 100
*** HOLE CARDS ***
Dealt to Bill [Ks 2s]
Dealt to MrBlue [As 5s]
Dealt to Pluribus [3d 4d]
Dealt to Budd [Qs 8d]
Dealt to Eddie [6s 8c]
Dealt to MrOrange [Qh 7c]
Pluribus: folds
Budd: folds
Eddie: folds
MrOrange: folds
Bill: raises 200 to 300
MrBlue: calls 200
*** FLOP *** [4h Tc Th]
Bill: checks
MrBlue: checks
*** TURN *** [4h Tc Th] [9h]
Bill: checks
MrBlue: checks
*** RIVER *** [4h Tc Th] [9h] [Qc]
Bill: checks
MrBlue: checks
*** SHOWDOWN ***
MrBlue: shows [As 5s]
MrBlue collected 600.0 from pot
*** SUMMARY ***
Total pot 600 | Rake 0
Board [4h Tc Th 9h Qc]
Seat 1: Bill showed [Ks 2s] and lost
Seat 2: MrBlue showed [As 5s] and won (600.0)


PokerStars Hand #73070: Hold'em No Limit (50/100) - 2019/07/11 20:17:50 ET
Table 'Pluribus Session 73' 6-max (Play Money) Seat #6 is the button
Seat 1: MrBlue (10000 in chips)
Seat 2: Pluribus (10000 in chips)
Seat 3: Budd (10000 in chips)
Seat 4: Eddie (10000 in chips)
Seat 5: MrOrange (10000 in chips)
Seat 6: Bill (10000 in chips)
MrBlue: posts small blind 50
Pluribus: posts big blind 100
*** HOLE CARDS ***
Dealt to MrBlue [8s Td]
Dealt to Pluribus [As 9h]
Dealt to Budd [5h 6d]
Dealt to Eddie [Ks Ac]
Dealt to MrOrange [Jc 9c]
Dealt to Bill [Qh Qs]
Budd: folds
Eddie: raises 100 to 200
MrOrange: folds
Bill: raises 525 to 725
MrBlue: folds
Pluribus: folds
Eddie: raises 9275 to 10000 and is all-in
Bill: calls 9275 and is all-in
*** FLOP *** [Qd 3c 2d]
*** TURN *** [Qd 3c 2d] [7c]
*** RIVER *** [Qd 3c 2d] [7c] [4h]
*** SHOWDOWN ***
Bill: shows [Qh Qs]
Bill collected 20150.0 from pot
*** SUMMARY ***
Total pot 20150 | Rake 0
Board [Qd 3c 2d 7c 4h]
Seat 4: Eddie showed [Ks Ac] and lost
Seat 6: Bill showed [Qh Qs] and won (20150.0)


PokerStars Hand #73071: Hold'em No Limit (50/100) - 2019/07/11 20:17:51 ET
Table 'Pluribus Session 73' 6-max (Play Money) Seat #6 is the button
Seat 1: Pluribus (10000 in chips)
Seat 2: Budd (10000 in chips)
Seat 3: Eddie (10000 in chips)
Seat 4: MrOrange (10000 in chips)
Seat 5: Bill (10000 in chips)
Seat 6: MrBlue (10000 in chips)
Pluribus: posts small blind 50
Budd: posts big blind 100
*** HOLE CARDS ***
Dealt to Pluribus [3d 6c]
Dealt to Budd [8s Js]
Dealt to Eddie [2s 2h]
Dealt to MrOrange [As 5s]
Dealt to Bill [4s 6d]
Dealt to MrBlue [Jc Jh]
Eddie: folds
MrOrange: raises 110 to 210
Bill: folds
MrBlue: calls 210
Pluribus: folds
Budd: calls 110
*** FLOP *** [5d Tc 7c]
Budd: checks
MrOrange: checks
MrBlue: bets 340
Budd: folds
MrOrange: folds
Uncalled bet (340) returned to MrBlue
MrBlue collected 680.0 from pot
*** SUMMARY ***
Total pot 680 | Rake 0
Board [5d Tc 7c]


PokerStars Hand #73072: Hold'em No Limit (50/100) - 2019/07/11 20:17:52 ET
Table 'Pluribus Session 73' 6-max (Play Money) Seat #6 is the button
Seat 1: Budd (10000 in chips)
Seat 2: Eddie (10000 in chips)
Seat 3: MrOrange (10000 in chips)
Seat 4: Bill (10000 in chips)
Seat 5: MrBlue (10000 in chips)
Seat 6: Pluribus (10000 in chips)
Budd: posts small blind 50
Eddie: posts big blind 100
*** HOLE CARDS ***
Dealt to Budd [3c 7h]
Dealt to Eddie [8d 6s]
Dealt to MrOrange [2c Ks]
Dealt to Bill [4h Kh]
Dealt to MrBlue [2h Td]
Dealt to Pluribus [9d 9h]
MrOrange: folds
Bill: folds
MrBlue: folds
Pluribus: raises 150 to 250
Budd: folds
Eddie: folds
Uncalled bet (150) returned to Pluribus
Pluribus collected 250.0 from pot
*** SUMMARY ***
Total pot 250 | Rake 0


PokerStars Hand #73073: Hold'em No Limit (50/100) - 2019/07/11 20:17:53 ET
Table 'Pluribus Session 73' 6-max (Play Money) Seat #6 is the button
Seat 1: Eddie (10000 in chips)
Seat 2: MrOrange (10000 in chips)
Seat 3: Bill (10000 in chips)
Seat 4: MrBlue (10000 in chips)
Seat 5: Pluribus (10000 in chips)
Seat 6: Budd (10000 in chips)
Eddie: posts small blind 50
MrOrange: posts big blind 100
*** HOLE CARDS ***
Dealt to Eddie [9h 6h]
Dealt to MrOrange [5d Kd]
Dealt to Bill [Jh 6c]
Dealt to MrBlue [4h Ks]
Dealt to Pluribus [2s As]
Dealt to Budd [7c Qc]
Bill: folds
MrBlue: folds
Pluribus: raises 187 to 287
Budd: folds
Eddie: folds
MrOrange: calls 187
*** FLOP *** [Ac 4s 3c]
MrOrange: checks
Pluribus: checks
*** TURN *** [Ac 4s 3c] [9d]
MrOrange: bets 800
Pluribus: calls 800
*** RIVER *** [Ac 4s 3c] [9d] [Qs]
MrOrange: bets 2550
Pluribus: folds
Uncalled bet (2550) returned to MrOrange
MrOrange collected 2224.0 from pot
*** SUMMARY ***
Total pot 2224 | Rake 0
Board [Ac 4s 3c 9d Qs]


PokerStars Hand #73074: Hold'em No Limit (50/100) - 2019/07/11 20:17:54 ET
Table 'Pluribus Session 73' 6-max (Play Money) Seat #6 is the button
Seat 1: MrOrange (10000 in chips)
Seat 2: Bill (10000 in chips)
Seat 3: MrBlue (10000 in chips)
Seat 4: Pluribus (10000 in chips)
Seat 5: Budd (10000 in chips)
Seat 6: Eddie (10000 in chips)
MrOrange: posts small blind 50
Bill: posts big blind 100
*** HOLE CARDS ***
Dealt to MrOrange [5d Qc]
Dealt to Bill [Ts 8h]
Dealt to MrBlue [8s 8c]
Dealt to Pluribus [9c 6h]
Dealt to Budd [5h 2c]
Dealt to Eddie [9s 4c]
MrBlue: raises 125 to 225
Pluribus: folds
Budd: folds
Eddie: folds
MrOrange: folds
Bill: folds
Uncalled bet (125) returned to MrBlue
MrBlue collected 250.0 from pot
*** SUMMARY ***
Total pot 250 | Rake 0


PokerStars Hand #73075: Hold'em No Limit (50/100) - 2019/07/11 20:17:55 ET
Table 'Pluribus Session 73' 6-max (Play Money) Seat #6 is the button
Seat 1: Bill (10000 in chips)
Seat 2: MrBlue (10000 in chips)
Seat 3: Pluribus (10000 in chips)
Seat 4: Budd (10000 in chips)
Seat 5: Eddie (10000 in chips)
Seat 6: MrOrange (10000 in chips)
Bill: posts small blind 50
MrBlue: posts big blind 100
*** HOLE CARDS ***
Dealt to Bill [4s 7c]
Dealt to MrBlue [3s Ac]
Dealt to Pluribus [Jc Ah]
Dealt to Budd [Tc Ts]
Dealt to Eddie [4d 8d]
Dealt to MrOrange [5d 4c]
Pluribus: raises 100 to 200
Budd: raises 520 to 720
Eddie: folds
MrOrange: folds
Bill: folds
MrBlue: folds
Pluribus: folds
Uncalled bet (520) returned to Budd
Budd collected 550.0 from pot
*** SUMMARY ***
Total pot 550 | Rake 0


PokerStars Hand #73076: Hold'em No Limit (50/100) - 2019/07/11 20:17:56 ET
Table 'Pluribus Session 73' 6-max (Play Money) Seat #6 is the button
Seat 1: MrBlue (10000 in chips)
Seat 2: Pluribus (10000 in chips)
Seat 3: Budd (10000 in chips)
Seat 4: Eddie (10000 in chips)
Seat 5: MrOrange (10000 in chips)
Seat 6: Bill (10000 in chips)
MrBlue: posts small blind 50
Pluribus: posts big blind 100
*** HOLE CARDS ***
Dealt to MrBlue [Qc Qh]
Dealt to Pluribus [9c 4c]
Dealt to Budd [8c Ad]
Dealt to Eddie [Th 7s]
Dealt to MrOrange [Kh 9h]
Dealt to Bill [3c Ks]
Budd: folds
Eddie: folds
MrOrange: raises 115 to 215
Bill: folds
MrBlue: raises 835 to 1050
Pluribus: folds
MrOrange: folds
Uncalled bet (835) returned to MrBlue
MrBlue collected 530.0 from pot
*** SUMMARY ***
Total pot 530 | Rake 0


PokerStars Hand #73077: Hold'em No Limit (50/100) - 2019/07/11 20:17:57 ET
Table 'Pluribus Session 73' 6-max (Play Money) Seat #6 is the button
Seat 1: Pluribus (10000 in chips)
Seat 2: Budd (10000 in chips)
Seat 3: Eddie (10000 in chips)
Seat 4: MrOrange (10000 in chips)
Seat 5: Bill (10000 in chips)
Seat 6: MrBlue (10000 in chips)
Pluribus: posts small blind 50
Budd: posts big blind 100
*** HOLE CARDS ***
Dealt to Pluribus [As 2s]
Dealt to Budd [Kc Qh]
Dealt to Eddie [5d 4h]
Dealt to MrOrange [9s Kh]
Dealt to Bill [3d 6h]
Dealt to MrBlue [2d Ah]
Eddie: folds
MrOrange: folds
Bill: folds
MrBlue: raises 125 to 225
Pluribus: calls 175
Budd: raises 925 to 1150
MrBlue: folds
Pluribus: folds
Uncalled bet (925) returned to Budd
Budd collected 675.0 from pot
*** SUMMARY ***
Total pot 675 | Rake 0


PokerStars Hand #73078: Hold'em No Limit (50/100) - 2019/07/11 20:17:58 ET
Table 'Pluribus Session 73' 6-max (Play Money) Seat #6 is the button
Seat 1: Budd (10000 in chips)
Seat 2: Eddie (10000 in chips)
Seat 3: MrOrange (10000 in chips)
Seat 4: Bill (10000 in chips)
Seat 5: MrBlue (10000 in chips)
Seat 6: Pluribus (10000 in chips)
Budd: posts small blind 50
Eddie: posts big blind 100
*** HOLE CARDS ***
Dealt to Budd [Jd Qd]
Dealt to Eddie [9d 2h]
Dealt to MrOrange [8c 7s]
Dealt to Bill [6s 8d]
Dealt to MrBlue [Tc 7d]
Dealt to Pluribus [Js 5s]
MrOrange: folds
Bill: folds
MrBlue: folds
Pluribus: raises 150 to 250
Budd: raises 800 to 1050
Eddie: folds
Pluribus: folds
Uncalled bet (800) returned to Budd
Budd collected 600.0 from pot
*** SUMMARY ***
Total pot 600 | Rake 0


PokerStars Hand #73079: Hold'em No Limit (50/100) - 2019/07/11 20:17:59 ET
Table 'Pluribus Session 73' 6-max (Play Money) Seat #6 is the button
Seat 1: Eddie (10000 in chips)
Seat 2: MrOrange (10000 in chips)
Seat 3: Bill (10000 in chips)
Seat 4: MrBlue (10000 in chips)
Seat 5: Pluribus (10000 in chips)
Seat 6: Budd (10000 in chips)
Eddie: posts small blind 50
MrOrange: posts big blind 100
*** HOLE CARDS ***
Dealt to Eddie [Jc 6h]
Dealt to MrOrange [4s 3d]
Dealt to Bill [Qs 3c]
Dealt to MrBlue [6d 2c]
Dealt to Pluribus [Qc Qd]
Dealt to Budd [8h As]
Bill: folds
MrBlue: folds
Pluribus: raises 125 to 225
Budd: folds
Eddie: folds
MrOrange: folds
Uncalled bet (125) returned to Pluribus
Pluribus collected 250.0 from pot
*** SUMMARY ***
Total pot 250 | Rake 0


PokerStars Hand #73080: Hold'em No Limit (50/100) - 2019/07/11 20:18:00 ET
Table 'Pluribus Session 73' 6-max (Play Money) Seat #6 is the button
Seat 1: MrOrange (10000 in chips)
Seat 2: Bill (10000 in chips)
Seat 3: MrBlue (10000 in chips)
Seat 4: Pluribus (10000 in chips)
Seat 5: Budd (10000 in chips)
Seat 6: Eddie (10000 in chips)
MrOrange: posts small blind 50
Bill: posts big blind 100
*** HOLE CARDS ***
Dealt to MrOrange [Qs Qd]
Dealt to Bill [6c 9d]
Dealt to MrBlue [8d 2c]
Dealt to Pluribus [9s Ah]
Dealt to Budd [Jh Qh]
Dealt to Eddie [4d 6d]
MrBlue: folds
Pluribus: folds
Budd: raises 125 to 225
Eddie: folds
MrOrange: raises 875 to 1100
Bill: folds
Budd: calls 875
*** FLOP *** [4h Ts Kc]
MrOrange: checks
Budd: bets 750
MrOrange: calls 750
*** TURN *** [4h Ts Kc] [6s]
MrOrange: checks
Budd: checks
*** RIVER *** [4h Ts Kc] [6s] [8h]
MrOrange: checks
Budd: checks
*** SHOWDOWN ***
MrOrange: shows [Qs Qd]
MrOrange collected 3800.0 from pot
*** SUMMARY ***
Total pot 3800 | Rake 0
Board [4h Ts Kc 6s 8h]
Seat 1: MrOrange showed [Qs Qd] and won (3800.0)
Seat 5: Budd showed [Jh Qh] and lost


PokerStars Hand #73081: Hold'em No Limit (50/100) - 2019/07/11 20:18:01 ET
Table 'Pluribus Session 73' 6-max (Play Money) Seat #6 is the button
Seat 1: Bill (10000 in chips)
Seat 2: MrBlue (10000 in chips)
Seat 3: Pluribus (10000 in chips)
Seat 4: Budd (10000 in chips)
Seat 5: Eddie (10000 in chips)
Seat 6: MrOrange (10000 in chips)
Bill: posts small blind 50
MrBlue: posts big blind 100
*** HOLE CARDS ***
Dealt to Bill [Qc 6c]
Dealt to MrBlue [2c Ad]
Dealt to Pluribus [Ks 8d]
Dealt to Budd [8h Kh]
Dealt to Eddie [Jd 9c]
Dealt to MrOrange [Jc 2h]
Pluribus: folds
Budd: raises 125 to 225
Eddie: folds
MrOrange: folds
Bill: folds
MrBlue: calls 125
*** FLOP *** [4h 4c 2s]
MrBlue: checks
Budd: bets 175
MrBlue: raises 425 to 600
Budd: folds
Uncalled bet (425) returned to MrBlue
MrBlue collected 850.0 from pot
*** SUMMARY ***
Total pot 850 | Rake 0
Board [4h 4c 2s]


PokerStars Hand #73082: Hold'em No Limit (50/100) - 2019/07/11 20:18:02 ET
Table 'Pluribus Session 73' 6-max (Play Money) Seat #6 is the button
Seat 1: MrBlue (10000 in chips)
Seat 2: Pluribus (10000 in chips)
Seat 3: Budd (10000 in chips)
Seat 4: Eddie (10000 in chips)
Seat 5: MrOrange (10000 in chips)
Seat 6: Bill (10000 in chips)
MrBlue: posts small blind 50
Pluribus: posts big blind 100
*** HOLE CARDS ***
Dealt to MrBlue [3c 9d]
Dealt to Pluribus [4c Ts]
Dealt to Budd [5s Ks]
Dealt to Eddie [8c 5d]
Dealt to MrOrange [Jh Jd]
Dealt to Bill [8h 2c]
Budd: folds
Eddie: folds
MrOrange: raises 115 to 215
Bill: folds
MrBlue: folds
Pluribus: folds
Uncalled bet (115) returned to MrOrange
MrOrange collected 250.0 from pot
*** SUMMARY ***
Total pot 250 | Rake 0


PokerStars Hand #73083: Hold'em No Limit (50/100) - 2019/07/11 20:18:03 ET
Table 'Pluribus Session 73' 6-max (Play Money) Seat #6 is the button
Seat 1: Pluribus (10000 in chips)
Seat 2: Budd (10000 in chips)
Seat 3: Eddie (10000 in chips)
Seat 4: MrOrange (10000 in chips)
Seat 5: Bill (10000 in chips)
Seat 6: MrBlue (10000 in chips)
Pluribus: posts small blind 50
Budd: posts big blind 100
*** HOLE CARDS ***
Dealt to Pluribus [4c 9c]
Dealt to Budd [9h As]
Dealt to Eddie [8h 8d]
Dealt to MrOrange [Qs 5d]
Dealt to Bill [2d Kh]
Dealt to MrBlue [7c Jh]
Eddie: raises 100 to 200
MrOrange: folds
Bill: folds
MrBlue: folds
Pluribus: folds
Budd: calls 100
*** FLOP *** [7h 7d Ts]
Budd: checks
Eddie: checks
*** TURN *** [7h 7d Ts] [4h]
Budd: checks
Eddie: checks
*** RIVER *** [7h 7d Ts] [4h] [8c]
Budd: checks
Eddie: bets 225
Budd: folds
Uncalled bet (225) returned to Eddie
Eddie collected 450.0 from pot
*** SUMMARY ***
Total pot 450 | Rake 0
Board [7h 7d Ts 4h 8c]


PokerStars Hand #73084: Hold'em No Limit (50/100) - 2019/07/11 20:18:04 ET
Table 'Pluribus Session 73' 6-max (Play Money) Seat #6 is the button
Seat 1: Budd (10000 in chips)
Seat 2: Eddie (10000 in chips)
Seat 3: MrOrange (10000 in chips)
Seat 4: Bill (10000 in chips)
Seat 5: MrBlue (10000 in chips)
Seat 6: Pluribus (10000 in chips)
Budd: posts small blind 50
Eddie: posts big blind 100
*** HOLE CARDS ***
Dealt to Budd [2s 7s]
Dealt to Eddie [Ad 5s]
Dealt to MrOrange [6h Ks]
Dealt to Bill [5c Td]
Dealt to MrBlue [Ts Ah]
Dealt to Pluribus [4c 7h]
MrOrange: folds
Bill: folds
MrBlue: raises 125 to 225
Pluribus: folds
Budd: folds
Eddie: calls 125
*** FLOP *** [6c 8h Qs]
Eddie: checks
MrBlue: checks
*** TURN *** [6c 8h Qs] [Qc]
Eddie: checks
MrBlue: checks
*** RIVER *** [6c 8h Qs] [Qc] [3c]
Eddie: checks
MrBlue: checks
*** SHOWDOWN ***
MrBlue: shows [Ts Ah]
MrBlue collected 500.0 from pot
*** SUMMARY ***
Total pot 500 | Rake 0
Board [6c 8h Qs Qc 3c]
Seat 2: Eddie showed [Ad 5s] and lost
Seat 5: MrBlue showed [Ts Ah] and won (500.0)


PokerStars Hand #73085: Hold'em No Limit (50/100) - 2019/07/11 20:18:05 ET
Table 'Pluribus Session 73' 6-max (Play Money) Seat #6 is the button
Seat 1: Eddie (10000 in chips)
Seat 2: MrOrange (10000 in chips)
Seat 3: Bill (10000 in chips)
Seat 4: MrBlue (10000 in chips)
Seat 5: Pluribus (10000 in chips)
Seat 6: Budd (10000 in chips)
Eddie: posts small blind 50
MrOrange: posts big blind 100
*** HOLE CARDS ***
Dealt to Eddie [3h 9s]
Dealt to MrOrange [Kd Ts]
Dealt to Bill [Th 7c]
Dealt to MrBlue [Ks 4h]
Dealt to Pluribus [Tc Qc]
Dealt to Budd [2d Jd]
Bill: folds
MrBlue: folds
Pluribus: raises 100 to 200
Budd: folds
Eddie: folds
MrOrange: calls 100
*** FLOP *** [Qh Jh Js]
MrOrange: checks
Pluribus: bets 225
MrOrange: raises 475 to 700
Pluribus: calls 475
*** TURN *** [Qh Jh Js] [Qs]
MrOrange: checks
Pluribus: bets 462
MrOrange: folds
Uncalled bet (462) returned to Pluribus
Pluribus collected 1850.0 from pot
*** SUMMARY ***
Total pot 1850 | Rake 0
Board [Qh Jh Js Qs]


PokerStars Hand #73086: Hold'em No Limit (50/100) - 2019/07/11 20:18:06 ET
Table 'Pluribus Session 73' 6-max (Play Money) Seat #6 is the button
Seat 1: MrOrange (10000 in chips)
Seat 2: Bill (10000 in chips)
Seat 3: MrBlue (10000 in chips)
Seat 4: Pluribus (10000 in chips)
Seat 5: Budd (10000 in chips)
Seat 6: Eddie (10000 in chips)
MrOrange: posts small blind 50
Bill: posts big blind 100
*** HOLE CARDS ***
Dealt to MrOrange [5d Ks]
Dealt to Bill [4c 5c]
Dealt to MrBlue [3h Ac]
Dealt to Pluribus [9h Qs]
Dealt to Budd [3s Ad]
Dealt to Eddie [6s Tc]
MrBlue: folds
Pluribus: folds
Budd: folds
Eddie: folds
MrOrange: folds
Uncalled bet (50) returned to Bill
Bill collected 100.0 from pot
*** SUMMARY ***
Total pot 100 | Rake 0


PokerStars Hand #73087: Hold'em No Limit (50/100) - 2019/07/11 20:18:07 ET
Table 'Pluribus Session 73' 6-max (Play Money) Seat #6 is the button
Seat 1: Bill (10000 in chips)
Seat 2: MrBlue (10000 in chips)
Seat 3: Pluribus (10000 in chips)
Seat 4: Budd (10000 in chips)
Seat 5: Eddie (10000 in chips)
Seat 6: MrOrange (10000 in chips)
Bill: posts small blind 50
MrBlue: posts big blind 100
*** HOLE CARDS ***
Dealt to Bill [Ks Jh]
Dealt to MrBlue [4h Ts]
Dealt to Pluribus [Kh Ah]
Dealt to Budd [Kc 2s]
Dealt to Eddie [3d 6d]
Dealt to MrOrange [5s 2c]
Pluribus: raises 100 to 200
Budd: folds
Eddie: folds
MrOrange: folds
Bill: folds
MrBlue: folds
Uncalled bet (100) returned to Pluribus
Pluribus collected 250.0 from pot
*** SUMMARY ***
Total pot 250 | Rake 0


PokerStars Hand #73088: Hold'em No Limit (50/100) - 2019/07/11 20:18:08 ET
Table 'Pluribus Session 73' 6-max (Play Money) Seat #6 is the button
Seat 1: MrBlue (10000 in chips)
Seat 2: Pluribus (10000 in chips)
Seat 3: Budd (10000 in chips)
Seat 4: Eddie (10000 in chips)
Seat 5: MrOrange (10000 in chips)
Seat 6: Bill (10000 in chips)
MrBlue: posts small blind 50
Pluribus: posts big blind 100
*** HOLE CARDS ***
Dealt to MrBlue [6d 2c]
Dealt to Pluribus [8h Jc]
Dealt to Budd [8c 4c]
Dealt to Eddie [6c Qc]
Dealt to MrOrange [Ah Kd]
Dealt to Bill [4s 9c]
Budd: folds
Eddie: folds
MrOrange: raises 115 to 215
Bill: folds
MrBlue: folds
Pluribus: folds
Uncalled bet (115) returned to MrOrange
MrOrange collected 250.0 from pot
*** SUMMARY ***
Total pot 250 | Rake 0


PokerStars Hand #73089: Hold'em No Limit (50/100) - 2019/07/11 20:18:09 ET
Table 'Pluribus Session 73' 6-max (Play Money) Seat #6 is the button
Seat 1: Pluribus (10000 in chips)
Seat 2: Budd (10000 in chips)
Seat 3: Eddie (10000 in chips)
Seat 4: MrOrange (10000 in chips)
Seat 5: Bill (10000 in chips)
Seat 6: MrBlue (10000 in chips)
Pluribus: posts small blind 50
Budd: posts big blind 100
*** HOLE CARDS ***
Dealt to Pluribus [7h 3s]
Dealt to Budd [6s Jc]
Dealt to Eddie [Ts 6h]
Dealt to MrOrange [Qc Ac]
Dealt to Bill [7c 8c]
Dealt to MrBlue [4d 4h]
Eddie: folds
MrOrange: raises 115 to 215
Bill: raises 445 to 660
MrBlue: folds
Pluribus: folds
Budd: folds
MrOrange: calls 445
*** FLOP *** [2d Qh Th]
MrOrange: checks
Bill: checks
*** TURN *** [2d Qh Th] [7s]
MrOrange: bets 1900
Bill: folds
Uncalled bet (1900) returned to MrOrange
MrOrange collected 1470.0 from pot
*** SUMMARY ***
Total pot 1470 | Rake 0
Board [2d Qh Th 7s]


PokerStars Hand #73090: Hold'em No Limit (50/100) - 2019/07/11 20:18:10 ET
Table 'Pluribus Session 73' 6-max (Play Money) Seat #6 is the button
Seat 1: Budd (10000 in chips)
Seat 2: Eddie (10000 in chips)
Seat 3: MrOrange (10000 in chips)
Seat 4: Bill (10000 in chips)
Seat 5: MrBlue (10000 in chips)
Seat 6: Pluribus (10000 in chips)
Budd: posts small blind 50
Eddie: posts big blind 100
*** HOLE CARDS ***
Dealt to Budd [4h Kd]
Dealt to Eddie [Qh 2d]
Dealt to MrOrange [7h Jh]
Dealt to Bill [Ac As]
Dealt to MrBlue [Th 8d]
Dealt to Pluribus [Js 4s]
MrOrange: folds
Bill: raises 125 to 225
MrBlue: folds
Pluribus: folds
Budd: folds
Eddie: folds
Uncalled bet (125) returned to Bill
Bill collected 250.0 from pot
*** SUMMARY ***
Total pot 250 | Rake 0


PokerStars Hand #73091: Hold'em No Limit (50/100) - 2019/07/11 20:18:11 ET
Table 'Pluribus Session 73' 6-max (Play Money) Seat #6 is the button
Seat 1: Eddie (10000 in chips)
Seat 2: MrOrange (10000 in chips)
Seat 3: Bill (10000 in chips)
Seat 4: MrBlue (10000 in chips)
Seat 5: Pluribus (10000 in chips)
Seat 6: Budd (10000 in chips)
Eddie: posts small blind 50
MrOrange: posts big blind 100
*** HOLE CARDS ***
Dealt to Eddie [2c Qh]
Dealt to MrOrange [6c Kc]
Dealt to Bill [9c 6s]
Dealt to MrBlue [7c 5d]
Dealt to Pluribus [2d Js]
Dealt to Budd [Ks 4c]
Bill: folds
MrBlue: folds
Pluribus: folds
Budd: folds
Eddie: folds
Uncalled bet (50) returned to MrOrange
MrOrange collected 100.0 from pot
*** SUMMARY ***
Total pot 100 | Rake 0


PokerStars Hand #73092: Hold'em No Limit (50/100) - 2019/07/11 20:18:12 ET
Table 'Pluribus Session 73' 6-max (Play Money) Seat #6 is the button
Seat 1: MrOrange (10000 in chips)
Seat 2: Bill (10000 in chips)
Seat 3: MrBlue (10000 in chips)
Seat 4: Pluribus (10000 in chips)
Seat 5: Budd (10000 in chips)
Seat 6: Eddie (10000 in chips)
MrOrange: posts small blind 50
Bill: posts big blind 100
*** HOLE CARDS ***
Dealt to MrOrange [Jh Kh]
Dealt to Bill [Qc 8h]
Dealt to MrBlue [9h Tc]
Dealt to Pluribus [4h 7s]
Dealt to Budd [2d Th]
Dealt to Eddie [2h 8s]
MrBlue: folds
Pluribus: folds
Budd: folds
Eddie: folds
MrOrange: raises 150 to 250
Bill: calls 150
*** FLOP *** [Jc 4c 5c]
MrOrange: checks
Bill: bets 250
MrOrange: calls 250
*** TURN *** [Jc 4c 5c] [2s]
MrOrange: checks
Bill: bets 1500
MrOrange: folds
Uncalled bet (1500) returned to Bill
Bill collected 1000.0 from pot
*** SUMMARY ***
Total pot 1000 | Rake 0
Board [Jc 4c 5c 2s]


PokerStars Hand #73093: Hold'em No Limit (50/100) - 2019/07/11 20:18:13 ET
Table 'Pluribus Session 73' 6-max (Play Money) Seat #6 is the button
Seat 1: Bill (10000 in chips)
Seat 2: MrBlue (10000 in chips)
Seat 3: Pluribus (10000 in chips)
Seat 4: Budd (10000 in chips)
Seat 5: Eddie (10000 in chips)
Seat 6: MrOrange (10000 in chips)
Bill: posts small blind 50
MrBlue: posts big blind 100
*** HOLE CARDS ***
Dealt to Bill [Jd 9s]
Dealt to MrBlue [6h 8s]
Dealt to Pluribus [Tc 5s]
Dealt to Budd [2s Ad]
Dealt to Eddie [4h 3h]
Dealt to MrOrange [8h Ah]
Pluribus: folds
Budd: folds
Eddie: folds
MrOrange: raises 150 to 250
Bill: folds
MrBlue: calls 150
*** FLOP *** [Qs 5d Ks]
MrBlue: checks
MrOrange: checks
*** TURN *** [Qs 5d Ks] [6d]
MrBlue: checks
MrOrange: checks
*** RIVER *** [Qs 5d Ks] [6d] [2h]
MrBlue: bets 180
MrOrange: folds
Uncalled bet (180) returned to MrBlue
MrBlue collected 550.0 from pot
*** SUMMARY ***
Total pot 550 | Rake 0
Board [Qs 5d Ks 6d 2h]


PokerStars Hand #73094: Hold'em No Limit (50/100) - 2019/07/11 20:18:14 ET
Table 'Pluribus Session 73' 6-max (Play Money) Seat #6 is the button
Seat 1: MrBlue (10000 in chips)
Seat 2: Pluribus (10000 in chips)
Seat 3: Budd (10000 in chips)
Seat 4: Eddie (10000 in chips)
Seat 5: MrOrange (10000 in chips)
Seat 6: Bill (10000 in chips)
MrBlue: posts small blind 50
Pluribus: posts big blind 100
*** HOLE CARDS ***
Dealt to MrBlue [Kc 7d]
Dealt to Pluribus [7s 6s]
Dealt to Budd [Qd Jc]
Dealt to Eddie [3s 5h]
Dealt to MrOrange [8h Td]
Dealt to Bill [9h 5c]
Budd: folds
Eddie: folds
MrOrange: folds
Bill: folds
MrBlue: calls 50
Pluribus: raises 175 to 275
MrBlue: calls 175
*** FLOP *** [4h 9d 6c]
MrBlue: checks
Pluribus: bets 275
MrBlue: folds
Uncalled bet (275) returned to Pluribus
Pluribus collected 550.0 from pot
*** SUMMARY ***
Total pot 550 | Rake 0
Board [4h 9d 6c]


PokerStars Hand #73095: Hold'em No Limit (50/100) - 2019/07/11 20:18:15 ET
Table 'Pluribus Session 73' 6-max (Play Money) Seat #6 is the button
Seat 1: Pluribus (10000 in chips)
Seat 2: Budd (10000 in chips)
Seat 3: Eddie (10000 in chips)
Seat 4: MrOrange (10000 in chips)
Seat 5: Bill (10000 in chips)
Seat 6: MrBlue (10000 in chips)
Pluribus: posts small blind 50
Budd: posts big blind 100
*** HOLE CARDS ***
Dealt to Pluribus [4c 2d]
Dealt to Budd [3s 4d]
Dealt to Eddie [Kd Jc]
Dealt to MrOrange [2c 9h]
Dealt to Bill [Ad 8s]
Dealt to MrBlue [9s Ac]
Eddie: folds
MrOrange: folds
Bill: folds
MrBlue: raises 125 to 225
Pluribus: folds
Budd: folds
Uncalled bet (125) returned to MrBlue
MrBlue collected 250.0 from pot
*** SUMMARY ***
Total pot 250 | Rake 0


PokerStars Hand #73096: Hold'em No Limit (50/100) - 2019/07/11 20:18:16 ET
Table 'Pluribus Session 73' 6-max (Play Money) Seat #6 is the button
Seat 1: Budd (10000 in chips)
Seat 2: Eddie (10000 in chips)
Seat 3: MrOrange (10000 in chips)
Seat 4: Bill (10000 in chips)
Seat 5: MrBlue (10000 in chips)
Seat 6: Pluribus (10000 in chips)
Budd: posts small blind 50
Eddie: posts big blind 100
*** HOLE CARDS ***
Dealt to Budd [Th 7h]
Dealt to Eddie [Qs 5d]
Dealt to MrOrange [Qh 6h]
Dealt to Bill [4d 3c]
Dealt to MrBlue [8d Kh]
Dealt to Pluribus [9s 5h]
MrOrange: folds
Bill: folds
MrBlue: folds
Pluribus: folds
Budd: raises 200 to 300
Eddie: folds
Uncalled bet (200) returned to Budd
Budd collected 200.0 from pot
*** SUMMARY ***
Total pot 200 | Rake 0


PokerStars Hand #73097: Hold'em No Limit (50/100) - 2019/07/11 20:18:17 ET
Table 'Pluribus Session 73' 6-max (Play Money) Seat #6 is the button
Seat 1: Eddie (10000 in chips)
Seat 2: MrOrange (10000 in chips)
Seat 3: Bill (10000 in chips)
Seat 4: MrBlue (10000 in chips)
Seat 5: Pluribus (10000 in chips)
Seat 6: Budd (10000 in chips)
Eddie: posts small blind 50
MrOrange: posts big blind 100
*** HOLE CARDS ***
Dealt to Eddie [Kd 9h]
Dealt to MrOrange [Kh Ad]
Dealt to Bill [6s 7c]
Dealt to MrBlue [Jc 5s]
Dealt to Pluribus [4h As]
Dealt to Budd [Ks Ts]
Bill: folds
MrBlue: folds
Pluribus: folds
Budd: raises 150 to 250
Eddie: folds
MrOrange: raises 950 to 1200
Budd: calls 950
*** FLOP *** [2h 6h 2d]
MrOrange: bets 800
Budd: folds
Uncalled bet (800) returned to MrOrange
MrOrange collected 2450.0 from pot
*** SUMMARY ***
Total pot 2450 | Rake 0
Board [2h 6h 2d]


PokerStars Hand #73098: Hold'em No Limit (50/100) - 2019/07/11 20:18:18 ET
Table 'Pluribus Session 73' 6-max (Play Money) Seat #6 is the button
Seat 1: MrOrange (10000 in chips)
Seat 2: Bill (10000 in chips)
Seat 3: MrBlue (10000 in chips)
Seat 4: Pluribus (10000 in chips)
Seat 5: Budd (10000 in chips)
Seat 6: Eddie (10000 in chips)
MrOrange: posts small blind 50
Bill: posts big blind 100
*** HOLE CARDS ***
Dealt to MrOrange [4d 2h]
Dealt to Bill [8d Kd]
Dealt to MrBlue [Ks Qc]
Dealt to Pluribus [4c 9c]
Dealt to Budd [6d 5d]
Dealt to Eddie [6c 9d]
MrBlue: folds
Pluribus: folds
Budd: raises 125 to 225
Eddie: folds
MrOrange: folds
Bill: calls 125
*** FLOP *** [4h Qd Kh]
Bill: checks
Budd: bets 175
Bill: raises 375 to 550
Budd: folds
Uncalled bet (375) returned to Bill
Bill collected 850.0 from pot
*** SUMMARY ***
Total pot 850 | Rake 0
Board [4h Qd Kh]


PokerStars Hand #73099: Hold'em No Limit (50/100) - 2019/07/11 20:18:19 ET
Table 'Pluribus Session 73' 6-max (Play Money) Seat #6 is the button
Seat 1: Bill (10000 in chips)
Seat 2: MrBlue (10000 in chips)
Seat 3: Pluribus (10000 in chips)
Seat 4: Budd (10000 in chips)
Seat 5: Eddie (10000 in chips)
Seat 6: MrOrange (10000 in chips)
Bill: posts small blind 50
MrBlue: posts big blind 100
*** HOLE CARDS ***
Dealt to Bill [2s Jc]
Dealt to MrBlue [9d Qd]
Dealt to Pluribus [Tc Qh]
Dealt to Budd [5c 3c]
Dealt to Eddie [2h Jh]
Dealt to MrOrange [Ts 7s]
Pluribus: folds
Budd: folds
Eddie: folds
MrOrange: folds
Bill: folds
Uncalled bet (50) returned to MrBlue
MrBlue collected 100.0 from pot
*** SUMMARY ***
Total pot 100 | Rake 0


PokerStars Hand #73100: Hold'em No Limit (50/100) - 2019/07/11 20:18:20 ET
Table 'Pluribus Session 73' 6-max (Play Money) Seat #6 is the button
Seat 1: MrBlue (10000 in chips)
Seat 2: Pluribus (10000 in chips)
Seat 3: Budd (10000 in chips)
Seat 4: Eddie (10000 in chips)
Seat 5: MrOrange (10000 in chips)
Seat 6: Bill (10000 in chips)
MrBlue: posts small blind 50
Pluribus: posts big blind 100
*** HOLE CARDS ***
Dealt to MrBlue [7d Js]
Dealt to Pluribus [Tc Kh]
Dealt to Budd [Th 8d]
Dealt to Eddie [4c Qc]
Dealt to MrOrange [4s Ks]
Dealt to Bill [2c Kc]
Budd: folds
Eddie: folds
MrOrange: folds
Bill: raises 150 to 250
MrBlue: folds
Pluribus: raises 825 to 1075
Bill: folds
Uncalled bet (825) returned to Pluribus
Pluribus collected 550.0 from pot
*** SUMMARY ***
Total pot 550 | Rake 0


PokerStars Hand #73101: Hold'em No Limit (50/100) - 2019/07/11 20:18:21 ET
Table 'Pluribus Session 73' 6-max (Play Money) Seat #6 is the button
Seat 1: Pluribus (10000 in chips)
Seat 2: Budd (10000 in chips)
Seat 3: Eddie (10000 in chips)
Seat 4: MrOrange (10000 in chips)
Seat 5: Bill (10000 in chips)
Seat 6: MrBlue (10000 in chips)
Pluribus: posts small blind 50
Budd: posts big blind 100
*** HOLE CARDS ***
Dealt to Pluribus [4s Qs]
Dealt to Budd [2c 4c]
Dealt to Eddie [Ac 5s]
Dealt to MrOrange [Td 9d]
Dealt to Bill [9h Ks]
Dealt to MrBlue [7s 3d]
Eddie: folds
MrOrange: calls 100
Bill: folds
MrBlue: folds
Pluribus: calls 50
Budd: checks
*** FLOP *** [Qc 8h 6c]
Pluribus: checks
Budd: bets 100
MrOrange: raises 324 to 424
Pluribus: folds
Budd: folds
Uncalled bet (324) returned to MrOrange
MrOrange collected 500.0 from pot
*** SUMMARY ***
Total pot 500 | Rake 0
Board [Qc 8h 6c]


PokerStars Hand #73102: Hold'em No Limit (50/100) - 2019/07/11 20:18:22 ET
Table 'Pluribus Session 73' 6-max (Play Money) Seat #6 is the button
Seat 1: Budd (10000 in chips)
Seat 2: Eddie (10000 in chips)
Seat 3: MrOrange (10000 in chips)
Seat 4: Bill (10000 in chips)
Seat 5: MrBlue (10000 in chips)
Seat 6: Pluribus (10000 in chips)
Budd: posts small blind 50
Eddie: posts big blind 100
*** HOLE CARDS ***
Dealt to Budd [Th 3d]
Dealt to Eddie [7h 7c]
Dealt to MrOrange [3c Ts]
Dealt to Bill [Qh 8h]
Dealt to MrBlue [3h Ks]
Dealt to Pluribus [Td 7s]
MrOrange: folds
Bill: raises 125 to 225
MrBlue: folds
Pluribus: folds
Budd: folds
Eddie: calls 125
*** FLOP *** [4d 2d 6h]
Eddie: checks
Bill: checks
*** TURN *** [4d 2d 6h] [3s]
Eddie: bets 250
Bill: folds
Uncalled bet (250) returned to Eddie
Eddie collected 500.0 from pot
*** SUMMARY ***
Total pot 500 | Rake 0
Board [4d 2d 6h 3s]


PokerStars Hand #73103: Hold'em No Limit (50/100) - 2019/07/11 20:18:23 ET
Table 'Pluribus Session 73' 6-max (Play Money) Seat #6 is the button
Seat 1: Eddie (10000 in chips)
Seat 2: MrOrange (10000 in chips)
Seat 3: Bill (10000 in chips)
Seat 4: MrBlue (10000 in chips)
Seat 5: Pluribus (10000 in chips)
Seat 6: Budd (10000 in chips)
Eddie: posts small blind 50
MrOrange: posts big blind 100
*** HOLE CARDS ***
Dealt to Eddie [3h Kd]
Dealt to MrOrange [9h As]
Dealt to Bill [4c Tc]
Dealt to MrBlue [6s Qs]
Dealt to Pluribus [4d 6d]
Dealt to Budd [2c Qc]
Bill: folds
MrBlue: folds
Pluribus: folds
Budd: raises 150 to 250
Eddie: folds
MrOrange: calls 150
*** FLOP *** [Ah 3c Jc]
MrOrange: checks
Budd: bets 175
MrOrange: calls 175
*** TURN *** [Ah 3c Jc] [7h]
MrOrange: checks
Budd: checks
*** RIVER *** [Ah 3c Jc] [7h] [Qd]
MrOrange: bets 800
Budd: calls 800
*** SHOWDOWN ***
MrOrange: shows [9h As]
MrOrange collected 2500.0 from pot
*** SUMMARY ***
Total pot 2500 | Rake 0
Board [Ah 3c Jc 7h Qd]
Seat 2: MrOrange showed [9h As] and won (2500.0)
Seat 6: Budd showed [2c Qc] and lost


PokerStars Hand #73104: Hold'em No Limit (50/100) - 2019/07/11 20:18:24 ET
Table 'Pluribus Session 73' 6-max (Play Money) Seat #6 is the button
Seat 1: MrOrange (10000 in chips)
Seat 2: Bill (10000 in chips)
Seat 3: MrBlue (10000 in chips)
Seat 4: Pluribus (10000 in chips)
Seat 5: Budd (10000 in chips)
Seat 6: Eddie (10000 in chips)
MrOrange: posts small blind 50
Bill: posts big blind 100
*** HOLE CARDS ***
Dealt to MrOrange [Qs Qh]
Dealt to Bill [As 7h]
Dealt to MrBlue [Th 3d]
Dealt to Pluribus [3c 9c]
Dealt to Budd [Qc Td]
Dealt to Eddie [2h Jd]
MrBlue: folds
Pluribus: folds
Budd: raises 125 to 225
Eddie: folds
MrOrange: raises 875 to 1100
Bill: folds
Budd: folds
Uncalled bet (875) returned to MrOrange
MrOrange collected 550.0 from pot
*** SUMMARY ***
Total pot 550 | Rake 0


PokerStars Hand #73105: Hold'em No Limit (50/100) - 2019/07/11 20:18:25 ET
Table 'Pluribus Session 73' 6-max (Play Money) Seat #6 is the button
Seat 1: Bill (10000 in chips)
Seat 2: MrBlue (10000 in chips)
Seat 3: Pluribus (10000 in chips)
Seat 4: Budd (10000 in chips)
Seat 5: Eddie (10000 in chips)
Seat 6: MrOrange (10000 in chips)
Bill: posts small blind 50
MrBlue: posts big blind 100
*** HOLE CARDS ***
Dealt to Bill [Ah Jd]
Dealt to MrBlue [Kc 9c]
Dealt to Pluribus [9h Jh]
Dealt to Budd [2d Qc]
Dealt to Eddie [Ac 6h]
Dealt to MrOrange [6d Tc]
Pluribus: raises 100 to 200
Budd: folds
Eddie: folds
MrOrange: folds
Bill: folds
MrBlue: calls 100
*** FLOP *** [5d 3c As]
MrBlue: checks
Pluribus: checks
*** TURN *** [5d 3c As] [4s]
MrBlue: checks
Pluribus: checks
*** RIVER *** [5d 3c As] [4s] [Qd]
MrBlue: checks
Pluribus: bets 225
MrBlue: folds
Uncalled bet (225) returned to Pluribus
Pluribus collected 450.0 from pot
*** SUMMARY ***
Total pot 450 | Rake 0
Board [5d 3c As 4s Qd]


PokerStars Hand #73106: Hold'em No Limit (50/100) - 2019/07/11 20:18:26 ET
Table 'Pluribus Session 73' 6-max (Play Money) Seat #6 is the button
Seat 1: MrBlue (10000 in chips)
Seat 2: Pluribus (10000 in chips)
Seat 3: Budd (10000 in chips)
Seat 4: Eddie (10000 in chips)
Seat 5: MrOrange (10000 in chips)
Seat 6: Bill (10000 in chips)
MrBlue: posts small blind 50
Pluribus: posts big blind 100
*** HOLE CARDS ***
Dealt to MrBlue [Jh 7s]
Dealt to Pluribus [3s Qc]
Dealt to Budd [4s 9h]
Dealt to Eddie [9s Qh]
Dealt to MrOrange [Ac 5d]
Dealt to Bill [Js Kd]
Budd: folds
Eddie: folds
MrOrange: folds
Bill: raises 150 to 250
MrBlue: folds
Pluribus: folds
Uncalled bet (150) returned to Bill
Bill collected 250.0 from pot
*** SUMMARY ***
Total pot 250 | Rake 0


PokerStars Hand #73107: Hold'em No Limit (50/100) - 2019/07/11 20:18:27 ET
Table 'Pluribus Session 73' 6-max (Play Money) Seat #6 is the button
Seat 1: Pluribus (10000 in chips)
Seat 2: Budd (10000 in chips)
Seat 3: Eddie (10000 in chips)
Seat 4: MrOrange (10000 in chips)
Seat 5: Bill (10000 in chips)
Seat 6: MrBlue (10000 in chips)
Pluribus: posts small blind 50
Budd: posts big blind 100
*** HOLE CARDS ***
Dealt to Pluribus [Ad Th]
Dealt to Budd [Qd 8s]
Dealt to Eddie [5c 4h]
Dealt to MrOrange [Js Qh]
Dealt to Bill [9h 5s]
Dealt to MrBlue [9d 4d]
Eddie: folds
MrOrange: folds
Bill: folds
MrBlue: raises 125 to 225
Pluribus: calls 175
Budd: raises 925 to 1150
MrBlue: folds
Pluribus: folds
Uncalled bet (925) returned to Budd
Budd collected 675.0 from pot
*** SUMMARY ***
Total pot 675 | Rake 0


PokerStars Hand #73108: Hold'em No Limit (50/100) - 2019/07/11 20:18:28 ET
Table 'Pluribus Session 73' 6-max (Play Money) Seat #6 is the button
Seat 1: Budd (10000 in chips)
Seat 2: Eddie (10000 in chips)
Seat 3: MrOrange (10000 in chips)
Seat 4: Bill (10000 in chips)
Seat 5: MrBlue (10000 in chips)
Seat 6: Pluribus (10000 in chips)
Budd: posts small blind 50
Eddie: posts big blind 100
*** HOLE CARDS ***
Dealt to Budd [Qc 2c]
Dealt to Eddie [Td 4h]
Dealt to MrOrange [3c As]
Dealt to Bill [Qh 7c]
Dealt to MrBlue [4s 3d]
Dealt to Pluribus [8d Kh]
MrOrange: folds
Bill: folds
MrBlue: folds
Pluribus: raises 150 to 250
Budd: folds
Eddie: folds
Uncalled bet (150) returned to Pluribus
Pluribus collected 250.0 from pot
*** SUMMARY ***
Total pot 250 | Rake 0


PokerStars Hand #73109: Hold'em No Limit (50/100) - 2019/07/11 20:18:29 ET
Table 'Pluribus Session 73' 6-max (Play Money) Seat #6 is the button
Seat 1: Eddie (10000 in chips)
Seat 2: MrOrange (10000 in chips)
Seat 3: Bill (10000 in chips)
Seat 4: MrBlue (10000 in chips)
Seat 5: Pluribus (10000 in chips)
Seat 6: Budd (10000 in chips)
Eddie: posts small blind 50
MrOrange: posts big blind 100
*** HOLE CARDS ***
Dealt to Eddie [8d 8s]
Dealt to MrOrange [9h 6h]
Dealt to Bill [5h Js]
Dealt to MrBlue [4s 3d]
Dealt to Pluribus [Jd Kd]
Dealt to Budd [5d 4c]
Bill: folds
MrBlue: folds
Pluribus: raises 150 to 250
Budd: folds
Eddie: calls 200
MrOrange: calls 150
*** FLOP *** [5s 4h Kc]
Eddie: checks
MrOrange: checks
Pluribus: bets 750
Eddie: folds
MrOrange: folds
Uncalled bet (750) returned to Pluribus
Pluribus collected 750.0 from pot
*** SUMMARY ***
Total pot 750 | Rake 0
Board [5s 4h Kc]


PokerStars Hand #73110: Hold'em No Limit (50/100) - 2019/07/11 20:18:30 ET
Table 'Pluribus Session 73' 6-max (Play Money) Seat #6 is the button
Seat 1: MrOrange (10000 in chips)
Seat 2: Bill (10000 in chips)
Seat 3: MrBlue (10000 in chips)
Seat 4: Pluribus (10000 in chips)
Seat 5: Budd (10000 in chips)
Seat 6: Eddie (10000 in chips)
MrOrange: posts small blind 50
Bill: posts big blind 100
*** HOLE CARDS ***
Dealt to MrOrange [2c 7s]
Dealt to Bill [Jc 3h]
Dealt to MrBlue [6c 7h]
Dealt to Pluribus [8c Qs]
Dealt to Budd [6h 5h]
Dealt to Eddie [8d Qd]
MrBlue: folds
Pluribus: folds
Budd: raises 125 to 225
Eddie: raises 575 to 800
MrOrange: folds
Bill: folds
Budd: calls 575
*** FLOP *** [7c 6s 9s]
Budd: checks
Eddie: bets 700
Budd: raises 1350 to 2050
Eddie: calls 1350
*** TURN *** [7c 6s 9s] [Kc]
Budd: checks
Eddie: checks
*** RIVER *** [7c 6s 9s] [Kc] [4c]
Budd: checks
Eddie: bets 7150 and is all-in
Budd: folds
Uncalled bet (7150) returned to Eddie
Eddie collected 5850.0 from pot
*** SUMMARY ***
Total pot 5850 | Rake 0
Board [7c 6s 9s Kc 4c]


PokerStars Hand #73111: Hold'em No Limit (50/100) - 2019/07/11 20:18:31 ET
Table 'Pluribus Session 73' 6-max (Play Money) Seat #6 is the button
Seat 1: Bill (10000 in chips)
Seat 2: MrBlue (10000 in chips)
Seat 3: Pluribus (10000 in chips)
Seat 4: Budd (10000 in chips)
Seat 5: Eddie (10000 in chips)
Seat 6: MrOrange (10000 in chips)
Bill: posts small blind 50
MrBlue: posts big blind 100
*** HOLE CARDS ***
Dealt to Bill [8d Kd]
Dealt to MrBlue [8c 5c]
Dealt to Pluribus [4h Kh]
Dealt to Budd [Ad 9c]
Dealt to Eddie [6s 8h]
Dealt to MrOrange [Qs Tc]
Pluribus: folds
Budd: folds
Eddie: folds
MrOrange: raises 150 to 250
Bill: folds
MrBlue: calls 150
*** FLOP *** [6c 2h 2d]
MrBlue: checks
MrOrange: bets 150
MrBlue: raises 425 to 575
MrOrange: folds
Uncalled bet (425) returned to MrBlue
MrBlue collected 850.0 from pot
*** SUMMARY ***
Total pot 850 | Rake 0
Board [6c 2h 2d]


PokerStars Hand #73112: Hold'em No Limit (50/100) - 2019/07/11 20:18:32 ET
Table 'Pluribus Session 73' 6-max (Play Money) Seat #6 is the button
Seat 1: MrBlue (10000 in chips)
Seat 2: Pluribus (10000 in chips)
Seat 3: Budd (10000 in chips)
Seat 4: Eddie (10000 in chips)
Seat 5: MrOrange (10000 in chips)
Seat 6: Bill (10000 in chips)
MrBlue: posts small blind 50
Pluribus: posts big blind 100
*** HOLE CARDS ***
Dealt to MrBlue [Qc 2d]
Dealt to Pluribus [Jd 2c]
Dealt to Budd [5h 4s]
Dealt to Eddie [Qh 9d]
Dealt to MrOrange [4h Ks]
Dealt to Bill [Kc Th]
Budd: folds
Eddie: folds
MrOrange: folds
Bill: raises 150 to 250
MrBlue: folds
Pluribus: folds
Uncalled bet (150) returned to Bill
Bill collected 250.0 from pot
*** SUMMARY ***
Total pot 250 | Rake 0


PokerStars Hand #73113: Hold'em No Limit (50/100) - 2019/07/11 20:18:33 ET
Table 'Pluribus Session 73' 6-max (Play Money) Seat #6 is the button
Seat 1: Pluribus (10000 in chips)
Seat 2: Budd (10000 in chips)
Seat 3: Eddie (10000 in chips)
Seat 4: MrOrange (10000 in chips)
Seat 5: Bill (10000 in chips)
Seat 6: MrBlue (10000 in chips)
Pluribus: posts small blind 50
Budd: posts big blind 100
*** HOLE CARDS ***
Dealt to Pluribus [8c Qd]
Dealt to Budd [2h Tc]
Dealt to Eddie [Qc 5d]
Dealt to MrOrange [3d Kd]
Dealt to Bill [Td 6s]
Dealt to MrBlue [9c 2s]
Eddie: folds
MrOrange: folds
Bill: folds
MrBlue: folds
Pluribus: calls 50
Budd: checks
*** FLOP *** [Ah As 4h]
Pluribus: bets 100
Budd: folds
Uncalled bet (100) returned to Pluribus
Pluribus collected 200.0 from pot
*** SUMMARY ***
Total pot 200 | Rake 0
Board [Ah As 4h]


PokerStars Hand #73114: Hold'em No Limit (50/100) - 2019/07/11 20:18:34 ET
Table 'Pluribus Session 73' 6-max (Play Money) Seat #6 is the button
Seat 1: Budd (10000 in chips)
Seat 2: Eddie (10000 in chips)
Seat 3: MrOrange (10000 in chips)
Seat 4: Bill (10000 in chips)
Seat 5: MrBlue (10000 in chips)
Seat 6: Pluribus (10000 in chips)
Budd: posts small blind 50
Eddie: posts big blind 100
*** HOLE CARDS ***
Dealt to Budd [Ks Qh]
Dealt to Eddie [Jd 2c]
Dealt to MrOrange [3c 7d]
Dealt to Bill [Qd 9s]
Dealt to MrBlue [Kc Tc]
Dealt to Pluribus [Td 2s]
MrOrange: folds
Bill: folds
MrBlue: raises 125 to 225
Pluribus: folds
Budd: calls 175
Eddie: folds
*** FLOP *** [7h 4c 2d]
Budd: checks
MrBlue: checks
*** TURN *** [7h 4c 2d] [Ts]
Budd: checks
MrBlue: bets 400
Budd: folds
Uncalled bet (400) returned to MrBlue
MrBlue collected 550.0 from pot
*** SUMMARY ***
Total pot 550 | Rake 0
Board [7h 4c 2d Ts]


PokerStars Hand #73115: Hold'em No Limit (50/100) - 2019/07/11 20:18:35 ET
Table 'Pluribus Session 73' 6-max (Play Money) Seat #6 is the button
Seat 1: Eddie (10000 in chips)
Seat 2: MrOrange (10000 in chips)
Seat 3: Bill (10000 in chips)
Seat 4: MrBlue (10000 in chips)
Seat 5: Pluribus (10000 in chips)
Seat 6: Budd (10000 in chips)
Eddie: posts small blind 50
MrOrange: posts big blind 100
*** HOLE CARDS ***
Dealt to Eddie [6s Ks]
Dealt to MrOrange [Js 8d]
Dealt to Bill [3s 4h]
Dealt to MrBlue [5h Td]
Dealt to Pluribus [8h 2d]
Dealt to Budd [5s Jh]
Bill: folds
MrBlue: folds
Pluribus: folds
Budd: folds
Eddie: raises 200 to 300
MrOrange: calls 200
*** FLOP *** [3c Tc 3d]
Eddie: checks
MrOrange: checks
*** TURN *** [3c Tc 3d] [9d]
Eddie: checks
MrOrange: bets 250
Eddie: folds
Uncalled bet (250) returned to MrOrange
MrOrange collected 600.0 from pot
*** SUMMARY ***
Total pot 600 | Rake 0
Board [3c Tc 3d 9d]


PokerStars Hand #73116: Hold'em No Limit (50/100) - 2019/07/11 20:18:36 ET
Table 'Pluribus Session 73' 6-max (Play Money) Seat #6 is the button
Seat 1: MrOrange (10000 in chips)
Seat 2: Bill (10000 in chips)
Seat 3: MrBlue (10000 in chips)
Seat 4: Pluribus (10000 in chips)
Seat 5: Budd (10000 in chips)
Seat 6: Eddie (10000 in chips)
MrOrange: posts small blind 50
Bill: posts big blind 100
*** HOLE CARDS ***
Dealt to MrOrange [7h Js]
Dealt to Bill [9c Qd]
Dealt to MrBlue [Jh 7c]
Dealt to Pluribus [3c 4c]
Dealt to Budd [5s Qs]
Dealt to Eddie [8s 6h]
MrBlue: folds
Pluribus: folds
Budd: folds
Eddie: folds
MrOrange: folds
Uncalled bet (50) returned to Bill
Bill collected 100.0 from pot
*** SUMMARY ***
Total pot 100 | Rake 0


PokerStars Hand #73117: Hold'em No Limit (50/100) - 2019/07/11 20:18:37 ET
Table 'Pluribus Session 73' 6-max (Play Money) Seat #6 is the button
Seat 1: Bill (10000 in chips)
Seat 2: MrBlue (10000 in chips)
Seat 3: Pluribus (10000 in chips)
Seat 4: Budd (10000 in chips)
Seat 5: Eddie (10000 in chips)
Seat 6: MrOrange (10000 in chips)
Bill: posts small blind 50
MrBlue: posts big blind 100
*** HOLE CARDS ***
Dealt to Bill [7d 3c]
Dealt to MrBlue [7s 5h]
Dealt to Pluribus [Js 4h]
Dealt to Budd [Jd 6c]
Dealt to Eddie [9c 5d]
Dealt to MrOrange [Qd 9h]
Pluribus: folds
Budd: folds
Eddie: folds
MrOrange: folds
Bill: folds
Uncalled bet (50) returned to MrBlue
MrBlue collected 100.0 from pot
*** SUMMARY ***
Total pot 100 | Rake 0


PokerStars Hand #73118: Hold'em No Limit (50/100) - 2019/07/11 20:18:38 ET
Table 'Pluribus Session 73' 6-max (Play Money) Seat #6 is the button
Seat 1: MrBlue (10000 in chips)
Seat 2: Pluribus (10000 in chips)
Seat 3: Budd (10000 in chips)
Seat 4: Eddie (10000 in chips)
Seat 5: MrOrange (10000 in chips)
Seat 6: Bill (10000 in chips)
MrBlue: posts small blind 50
Pluribus: posts big blind 100
*** HOLE CARDS ***
Dealt to MrBlue [3s 3d]
Dealt to Pluribus [3h 7h]
Dealt to Budd [Kh 4d]
Dealt to Eddie [6c Js]
Dealt to MrOrange [2h 8d]
Dealt to Bill [9h 9c]
Budd: folds
Eddie: folds
MrOrange: folds
Bill: raises 150 to 250
MrBlue: calls 200
Pluribus: calls 150
*** FLOP *** [Qs 5c Ad]
MrBlue: checks
Pluribus: checks
Bill: checks
*** TURN *** [Qs 5c Ad] [4h]
MrBlue: checks
Pluribus: checks
Bill: checks
*** RIVER *** [Qs 5c Ad] [4h] [Ac]
MrBlue: checks
Pluribus: bets 375
Bill: calls 375
MrBlue: folds
Bill collected 1500.0 from pot
*** SUMMARY ***
Total pot 1500 | Rake 0
Board [Qs 5c Ad 4h Ac]


PokerStars Hand #73119: Hold'em No Limit (50/100) - 2019/07/11 20:18:39 ET
Table 'Pluribus Session 73' 6-max (Play Money) Seat #6 is the button
Seat 1: Pluribus (10000 in chips)
Seat 2: Budd (10000 in chips)
Seat 3: Eddie (10000 in chips)
Seat 4: MrOrange (10000 in chips)
Seat 5: Bill (10000 in chips)
Seat 6: MrBlue (10000 in chips)
Pluribus: posts small blind 50
Budd: posts big blind 100
*** HOLE CARDS ***
Dealt to Pluribus [Jh 8h]
Dealt to Budd [Ts 8d]
Dealt to Eddie [Ac 4h]
Dealt to MrOrange [Kh 7s]
Dealt to Bill [6c 5c]
Dealt to MrBlue [Ks Js]
Eddie: folds
MrOrange: folds
Bill: raises 125 to 225
MrBlue: calls 225
Pluribus: folds
Budd: folds
*** FLOP *** [Kd 7d Ad]
Bill: checks
MrBlue: checks
*** TURN *** [Kd 7d Ad] [Qc]
Bill: checks
MrBlue: checks
*** RIVER *** [Kd 7d Ad] [Qc] [8s]
Bill: bets 450
MrBlue: calls 450
*** SHOWDOWN ***
MrBlue: shows [Ks Js]
MrBlue collected 1500.0 from pot
*** SUMMARY ***
Total pot 1500 | Rake 0
Board [Kd 7d Ad Qc 8s]
Seat 5: Bill showed [6c 5c] and lost
Seat 6: MrBlue showed [Ks Js] and won (1500.0)


PokerStars Hand #73120: Hold'em No Limit (50/100) - 2019/07/11 20:18:40 ET
Table 'Pluribus Session 73' 6-max (Play Money) Seat #6 is the button
Seat 1: Budd (10000 in chips)
Seat 2: Eddie (10000 in chips)
Seat 3: MrOrange (10000 in chips)
Seat 4: Bill (10000 in chips)
Seat 5: MrBlue (10000 in chips)
Seat 6: Pluribus (10000 in chips)
Budd: posts small blind 50
Eddie: posts big blind 100
*** HOLE CARDS ***
Dealt to Budd [5d Ks]
Dealt to Eddie [9s 3d]
Dealt to MrOrange [8c 6d]
Dealt to Bill [4d 4s]
Dealt to MrBlue [Tc 5s]
Dealt to Pluribus [3h Js]
MrOrange: folds
Bill: raises 125 to 225
MrBlue: folds
Pluribus: folds
Budd: folds
Eddie: folds
Uncalled bet (125) returned to Bill
Bill collected 250.0 from pot
*** SUMMARY ***
Total pot 250 | Rake 0


PokerStars Hand #73121: Hold'em No Limit (50/100) - 2019/07/11 20:18:41 ET
Table 'Pluribus Session 73' 6-max (Play Money) Seat #6 is the button
Seat 1: Eddie (10000 in chips)
Seat 2: MrOrange (10000 in chips)
Seat 3: Bill (10000 in chips)
Seat 4: MrBlue (10000 in chips)
Seat 5: Pluribus (10000 in chips)
Seat 6: Budd (10000 in chips)
Eddie: posts small blind 50
MrOrange: posts big blind 100
*** HOLE CARDS ***
Dealt to Eddie [7s Jd]
Dealt to MrOrange [Qc 7h]
Dealt to Bill [Ts 5h]
Dealt to MrBlue [3h Qd]
Dealt to Pluribus [Td 5s]
Dealt to Budd [4c 2h]
Bill: folds
MrBlue: folds
Pluribus: folds
Budd: folds
Eddie: calls 50
MrOrange: checks
*** FLOP *** [Kh 5d 9d]
Eddie: checks
MrOrange: checks
*** TURN *** [Kh 5d 9d] [Ad]
Eddie: checks
MrOrange: checks
*** RIVER *** [Kh 5d 9d] [Ad] [2d]
Eddie: bets 200
MrOrange: folds
Uncalled bet (200) returned to Eddie
Eddie collected 200.0 from pot
*** SUMMARY ***
Total pot 200 | Rake 0
Board [Kh 5d 9d Ad 2d]


PokerStars Hand #73122: Hold'em No Limit (50/100) - 2019/07/11 20:18:42 ET
Table 'Pluribus Session 73' 6-max (Play Money) Seat #6 is the button
Seat 1: MrOrange (10000 in chips)
Seat 2: Bill (10000 in chips)
Seat 3: MrBlue (10000 in chips)
Seat 4: Pluribus (10000 in chips)
Seat 5: Budd (10000 in chips)
Seat 6: Eddie (10000 in chips)
MrOrange: posts small blind 50
Bill: posts big blind 100
*** HOLE CARDS ***
Dealt to MrOrange [4h Ad]
Dealt to Bill [Kc 8d]
Dealt to MrBlue [6s 7s]
Dealt to Pluribus [3s 4d]
Dealt to Budd [5s 8h]
Dealt to Eddie [Qh 7d]
MrBlue: raises 125 to 225
Pluribus: folds
Budd: folds
Eddie: folds
MrOrange: folds
Bill: folds
Uncalled bet (125) returned to MrBlue
MrBlue collected 250.0 from pot
*** SUMMARY ***
Total pot 250 | Rake 0


PokerStars Hand #73123: Hold'em No Limit (50/100) - 2019/07/11 20:18:43 ET
Table 'Pluribus Session 73' 6-max (Play Money) Seat #6 is the button
Seat 1: Bill (10000 in chips)
Seat 2: MrBlue (10000 in chips)
Seat 3: Pluribus (10000 in chips)
Seat 4: Budd (10000 in chips)
Seat 5: Eddie (10000 in chips)
Seat 6: MrOrange (10000 in chips)
Bill: posts small blind 50
MrBlue: posts big blind 100
*** HOLE CARDS ***
Dealt to Bill [Tc 8h]
Dealt to MrBlue [8d 3s]
Dealt to Pluribus [6s 2h]
Dealt to Budd [Jc 7d]
Dealt to Eddie [7c 2d]
Dealt to MrOrange [Ad Ks]
Pluribus: folds
Budd: folds
Eddie: folds
MrOrange: raises 150 to 250
Bill: folds
MrBlue: folds
Uncalled bet (150) returned to MrOrange
MrOrange collected 250.0 from pot
*** SUMMARY ***
Total pot 250 | Rake 0


PokerStars Hand #73124: Hold'em No Limit (50/100) - 2019/07/11 20:18:44 ET
Table 'Pluribus Session 73' 6-max (Play Money) Seat #6 is the button
Seat 1: MrBlue (10000 in chips)
Seat 2: Pluribus (10000 in chips)
Seat 3: Budd (10000 in chips)
Seat 4: Eddie (10000 in chips)
Seat 5: MrOrange (10000 in chips)
Seat 6: Bill (10000 in chips)
MrBlue: posts small blind 50
Pluribus: posts big blind 100
*** HOLE CARDS ***
Dealt to MrBlue [Kc 2d]
Dealt to Pluribus [3d 5h]
Dealt to Budd [7s Ks]
Dealt to Eddie [Qd Jc]
Dealt to MrOrange [2h Ah]
Dealt to Bill [6c Qc]
Budd: folds
Eddie: raises 100 to 200
MrOrange: folds
Bill: folds
MrBlue: folds
Pluribus: calls 100
*** FLOP *** [5c 4s Qs]
Pluribus: checks
Eddie: bets 135
Pluribus: calls 135
*** TURN *** [5c 4s Qs] [2s]
Pluribus: checks
Eddie: bets 290
Pluribus: calls 290
*** RIVER *** [5c 4s Qs] [2s] [Jd]
Pluribus: checks
Eddie: bets 975
Pluribus: calls 975
*** SHOWDOWN ***
Eddie: shows [Qd Jc]
Eddie collected 3250.0 from pot
*** SUMMARY ***
Total pot 3250 | Rake 0
Board [5c 4s Qs 2s Jd]
Seat 2: Pluribus showed [3d 5h] and lost
Seat 4: Eddie showed [Qd Jc] and won (3250.0)


PokerStars Hand #73125: Hold'em No Limit (50/100) - 2019/07/11 20:18:45 ET
Table 'Pluribus Session 73' 6-max (Play Money) Seat #6 is the button
Seat 1: Pluribus (10000 in chips)
Seat 2: Budd (10000 in chips)
Seat 3: Eddie (10000 in chips)
Seat 4: MrOrange (10000 in chips)
Seat 5: Bill (10000 in chips)
Seat 6: MrBlue (10000 in chips)
Pluribus: posts small blind 50
Budd: posts big blind 100
*** HOLE CARDS ***
Dealt to Pluribus [4h 5h]
Dealt to Budd [4d Ts]
Dealt to Eddie [3c 6d]
Dealt to MrOrange [Jc As]
Dealt to Bill [Tc Ks]
Dealt to MrBlue [7h 9s]
Eddie: folds
MrOrange: raises 115 to 215
Bill: folds
MrBlue: folds
Pluribus: calls 165
Budd: folds
*** FLOP *** [6s 8c Qh]
Pluribus: checks
MrOrange: checks
*** TURN *** [6s 8c Qh] [Td]
Pluribus: checks
MrOrange: checks
*** RIVER *** [6s 8c Qh] [Td] [7s]
Pluribus: bets 1060
MrOrange: folds
Uncalled bet (1060) returned to Pluribus
Pluribus collected 530.0 from pot
*** SUMMARY ***
Total pot 530 | Rake 0
Board [6s 8c Qh Td 7s]


PokerStars Hand #73126: Hold'em No Limit (50/100) - 2019/07/11 20:18:46 ET
Table 'Pluribus Session 73' 6-max (Play Money) Seat #6 is the button
Seat 1: Budd (10000 in chips)
Seat 2: Eddie (10000 in chips)
Seat 3: MrOrange (10000 in chips)
Seat 4: Bill (10000 in chips)
Seat 5: MrBlue (10000 in chips)
Seat 6: Pluribus (10000 in chips)
Budd: posts small blind 50
Eddie: posts big blind 100
*** HOLE CARDS ***
Dealt to Budd [7c 7h]
Dealt to Eddie [2c Ah]
Dealt to MrOrange [5d Qs]
Dealt to Bill [8h Jd]
Dealt to MrBlue [6h Ac]
Dealt to Pluribus [Qd As]
MrOrange: folds
Bill: folds
MrBlue: raises 125 to 225
Pluribus: raises 600 to 825
Budd: folds
Eddie: folds
MrBlue: folds
Uncalled bet (600) returned to Pluribus
Pluribus collected 600.0 from pot
*** SUMMARY ***
Total pot 600 | Rake 0


PokerStars Hand #73127: Hold'em No Limit (50/100) - 2019/07/11 20:18:47 ET
Table 'Pluribus Session 73' 6-max (Play Money) Seat #6 is the button
Seat 1: Eddie (10000 in chips)
Seat 2: MrOrange (10000 in chips)
Seat 3: Bill (10000 in chips)
Seat 4: MrBlue (10000 in chips)
Seat 5: Pluribus (10000 in chips)
Seat 6: Budd (10000 in chips)
Eddie: posts small blind 50
MrOrange: posts big blind 100
*** HOLE CARDS ***
Dealt to Eddie [7h 6d]
Dealt to MrOrange [3c Jd]
Dealt to Bill [Qd 5s]
Dealt to MrBlue [Ah 4c]
Dealt to Pluribus [9d 2c]
Dealt to Budd [3h Tc]
Bill: folds
MrBlue: folds
Pluribus: folds
Budd: folds
Eddie: raises 200 to 300
MrOrange: folds
Uncalled bet (200) returned to Eddie
Eddie collected 200.0 from pot
*** SUMMARY ***
Total pot 200 | Rake 0


PokerStars Hand #73128: Hold'em No Limit (50/100) - 2019/07/11 20:18:48 ET
Table 'Pluribus Session 73' 6-max (Play Money) Seat #6 is the button
Seat 1: MrOrange (10000 in chips)
Seat 2: Bill (10000 in chips)
Seat 3: MrBlue (10000 in chips)
Seat 4: Pluribus (10000 in chips)
Seat 5: Budd (10000 in chips)
Seat 6: Eddie (10000 in chips)
MrOrange: posts small blind 50
Bill: posts big blind 100
*** HOLE CARDS ***
Dealt to MrOrange [7h 8d]
Dealt to Bill [3s 2h]
Dealt to MrBlue [Qh 3d]
Dealt to Pluribus [5c 9h]
Dealt to Budd [8c 9c]
Dealt to Eddie [As Qc]
MrBlue: folds
Pluribus: folds
Budd: raises 125 to 225
Eddie: calls 225
MrOrange: folds
Bill: folds
*** FLOP *** [3h 8h 4s]
Budd: checks
Eddie: checks
*** TURN *** [3h 8h 4s] [6s]
Budd: bets 300
Eddie: calls 300
*** RIVER *** [3h 8h 4s] [6s] [Ts]
Budd: bets 600
Eddie: raises 8875 to 9475 and is all-in
Budd: folds
Uncalled bet (8875) returned to Eddie
Eddie collected 2400.0 from pot
*** SUMMARY ***
Total pot 2400 | Rake 0
Board [3h 8h 4s 6s Ts]


PokerStars Hand #73129: Hold'em No Limit (50/100) - 2019/07/11 20:18:49 ET
Table 'Pluribus Session 73' 6-max (Play Money) Seat #6 is the button
Seat 1: Bill (10000 in chips)
Seat 2: MrBlue (10000 in chips)
Seat 3: Pluribus (10000 in chips)
Seat 4: Budd (10000 in chips)
Seat 5: Eddie (10000 in chips)
Seat 6: MrOrange (10000 in chips)
Bill: posts small blind 50
MrBlue: posts big blind 100
*** HOLE CARDS ***
Dealt to Bill [Jd Ts]
Dealt to MrBlue [3h Tc]
Dealt to Pluribus [Qc 2h]
Dealt to Budd [3c 6c]
Dealt to Eddie [8c 7c]
Dealt to MrOrange [6d Jh]
Pluribus: folds
Budd: folds
Eddie: raises 100 to 200
MrOrange: folds
Bill: folds
MrBlue: folds
Uncalled bet (100) returned to Eddie
Eddie collected 250.0 from pot
*** SUMMARY ***
Total pot 250 | Rake 0


PokerStars Hand #73130: Hold'em No Limit (50/100) - 2019/07/11 20:18:50 ET
Table 'Pluribus Session 73' 6-max (Play Money) Seat #6 is the button
Seat 1: MrBlue (10000 in chips)
Seat 2: Pluribus (10000 in chips)
Seat 3: Budd (10000 in chips)
Seat 4: Eddie (10000 in chips)
Seat 5: MrOrange (10000 in chips)
Seat 6: Bill (10000 in chips)
MrBlue: posts small blind 50
Pluribus: posts big blind 100
*** HOLE CARDS ***
Dealt to MrBlue [Ks 9c]
Dealt to Pluribus [8h Ts]
Dealt to Budd [Qd Qh]
Dealt to Eddie [7d 4s]
Dealt to MrOrange [7s 5s]
Dealt to Bill [5h 7h]
Budd: raises 125 to 225
Eddie: folds
MrOrange: folds
Bill: folds
MrBlue: folds
Pluribus: folds
Uncalled bet (125) returned to Budd
Budd collected 250.0 from pot
*** SUMMARY ***
Total pot 250 | Rake 0


PokerStars Hand #73131: Hold'em No Limit (50/100) - 2019/07/11 20:18:51 ET
Table 'Pluribus Session 73' 6-max (Play Money) Seat #6 is the button
Seat 1: Pluribus (10000 in chips)
Seat 2: Budd (10000 in chips)
Seat 3: Eddie (10000 in chips)
Seat 4: MrOrange (10000 in chips)
Seat 5: Bill (10000 in chips)
Seat 6: MrBlue (10000 in chips)
Pluribus: posts small blind 50
Budd: posts big blind 100
*** HOLE CARDS ***
Dealt to Pluribus [7c 3c]
Dealt to Budd [3s 9s]
Dealt to Eddie [Qc 8c]
Dealt to MrOrange [2h 5d]
Dealt to Bill [9c 5c]
Dealt to MrBlue [5s 3d]
Eddie: folds
MrOrange: folds
Bill: folds
MrBlue: folds
Pluribus: folds
Uncalled bet (50) returned to Budd
Budd collected 100.0 from pot
*** SUMMARY ***
Total pot 100 | Rake 0


PokerStars Hand #73132: Hold'em No Limit (50/100) - 2019/07/11 20:18:52 ET
Table 'Pluribus Session 73' 6-max (Play Money) Seat #6 is the button
Seat 1: Budd (10000 in chips)
Seat 2: Eddie (10000 in chips)
Seat 3: MrOrange (10000 in chips)
Seat 4: Bill (10000 in chips)
Seat 5: MrBlue (10000 in chips)
Seat 6: Pluribus (10000 in chips)
Budd: posts small blind 50
Eddie: posts big blind 100
*** HOLE CARDS ***
Dealt to Budd [2d 3h]
Dealt to Eddie [9d 5s]
Dealt to MrOrange [Kc Jd]
Dealt to Bill [7d 3s]
Dealt to MrBlue [6c Kh]
Dealt to Pluribus [4h 6s]
MrOrange: folds
Bill: folds
MrBlue: folds
Pluribus: folds
Budd: folds
Uncalled bet (50) returned to Eddie
Eddie collected 100.0 from pot
*** SUMMARY ***
Total pot 100 | Rake 0


PokerStars Hand #73133: Hold'em No Limit (50/100) - 2019/07/11 20:18:53 ET
Table 'Pluribus Session 73' 6-max (Play Money) Seat #6 is the button
Seat 1: Eddie (10000 in chips)
Seat 2: MrOrange (10000 in chips)
Seat 3: Bill (10000 in chips)
Seat 4: MrBlue (10000 in chips)
Seat 5: Pluribus (10000 in chips)
Seat 6: Budd (10000 in chips)
Eddie: posts small blind 50
MrOrange: posts big blind 100
*** HOLE CARDS ***
Dealt to Eddie [5h 4d]
Dealt to MrOrange [2c Ks]
Dealt to Bill [8c 3s]
Dealt to MrBlue [Qd As]
Dealt to Pluribus [7h 6d]
Dealt to Budd [3h 6s]
Bill: folds
MrBlue: raises 125 to 225
Pluribus: folds
Budd: folds
Eddie: folds
MrOrange: folds
Uncalled bet (125) returned to MrBlue
MrBlue collected 250.0 from pot
*** SUMMARY ***
Total pot 250 | Rake 0


PokerStars Hand #73134: Hold'em No Limit (50/100) - 2019/07/11 20:18:54 ET
Table 'Pluribus Session 73' 6-max (Play Money) Seat #6 is the button
Seat 1: MrOrange (10000 in chips)
Seat 2: Bill (10000 in chips)
Seat 3: MrBlue (10000 in chips)
Seat 4: Pluribus (10000 in chips)
Seat 5: Budd (10000 in chips)
Seat 6: Eddie (10000 in chips)
MrOrange: posts small blind 50
Bill: posts big blind 100
*** HOLE CARDS ***
Dealt to MrOrange [7d 5h]
Dealt to Bill [9c 3s]
Dealt to MrBlue [5d Ah]
Dealt to Pluribus [4s Qh]
Dealt to Budd [2s Kc]
Dealt to Eddie [9s 5c]
MrBlue: folds
Pluribus: folds
Budd: folds
Eddie: folds
MrOrange: folds
Uncalled bet (50) returned to Bill
Bill collected 100.0 from pot
*** SUMMARY ***
Total pot 100 | Rake 0


PokerStars Hand #73135: Hold'em No Limit (50/100) - 2019/07/11 20:18:55 ET
Table 'Pluribus Session 73' 6-max (Play Money) Seat #6 is the button
Seat 1: Bill (10000 in chips)
Seat 2: MrBlue (10000 in chips)
Seat 3: Pluribus (10000 in chips)
Seat 4: Budd (10000 in chips)
Seat 5: Eddie (10000 in chips)
Seat 6: MrOrange (10000 in chips)
Bill: posts small blind 50
MrBlue: posts big blind 100
*** HOLE CARDS ***
Dealt to Bill [2h 4c]
Dealt to MrBlue [5d 3d]
Dealt to Pluribus [As 9s]
Dealt to Budd [Tc Qh]
Dealt to Eddie [6d Ac]
Dealt to MrOrange [Jd 5h]
Pluribus: raises 100 to 200
Budd: folds
Eddie: folds
MrOrange: folds
Bill: folds
MrBlue: calls 100
*** FLOP *** [9c Qs Jc]
MrBlue: checks
Pluribus: checks
*** TURN *** [9c Qs Jc] [7s]
MrBlue: checks
Pluribus: bets 225
MrBlue: folds
Uncalled bet (225) returned to Pluribus
Pluribus collected 450.0 from pot
*** SUMMARY ***
Total pot 450 | Rake 0
Board [9c Qs Jc 7s]


PokerStars Hand #73136: Hold'em No Limit (50/100) - 2019/07/11 20:18:56 ET
Table 'Pluribus Session 73' 6-max (Play Money) Seat #6 is the button
Seat 1: MrBlue (10000 in chips)
Seat 2: Pluribus (10000 in chips)
Seat 3: Budd (10000 in chips)
Seat 4: Eddie (10000 in chips)
Seat 5: MrOrange (10000 in chips)
Seat 6: Bill (10000 in chips)
MrBlue: posts small blind 50
Pluribus: posts big blind 100
*** HOLE CARDS ***
Dealt to MrBlue [3d 5s]
Dealt to Pluribus [4h 7c]
Dealt to Budd [3c Qc]
Dealt to Eddie [Td 4s]
Dealt to MrOrange [Ad 2d]
Dealt to Bill [As 8s]
Budd: folds
Eddie: folds
MrOrange: raises 115 to 215
Bill: calls 215
MrBlue: folds
Pluribus: folds
*** FLOP *** [Jc Jh Qh]
MrOrange: checks
Bill: bets 200
MrOrange: folds
Uncalled bet (200) returned to Bill
Bill collected 580.0 from pot
*** SUMMARY ***
Total pot 580 | Rake 0
Board [Jc Jh Qh]


PokerStars Hand #73137: Hold'em No Limit (50/100) - 2019/07/11 20:18:57 ET
Table 'Pluribus Session 73' 6-max (Play Money) Seat #6 is the button
Seat 1: Pluribus (10000 in chips)
Seat 2: Budd (10000 in chips)
Seat 3: Eddie (10000 in chips)
Seat 4: MrOrange (10000 in chips)
Seat 5: Bill (10000 in chips)
Seat 6: MrBlue (10000 in chips)
Pluribus: posts small blind 50
Budd: posts big blind 100
*** HOLE CARDS ***
Dealt to Pluribus [2h 3d]
Dealt to Budd [As Kd]
Dealt to Eddie [8s 3s]
Dealt to MrOrange [Ac 3h]
Dealt to Bill [Jh 9c]
Dealt to MrBlue [Th Tc]
Eddie: folds
MrOrange: folds
Bill: folds
MrBlue: raises 125 to 225
Pluribus: folds
Budd: raises 875 to 1100
MrBlue: raises 1400 to 2500
Budd: raises 7500 to 10000 and is all-in
MrBlue: calls 7500 and is all-in
*** FLOP *** [2s 8h 7s]
*** TURN *** [2s 8h 7s] [4h]
*** RIVER *** [2s 8h 7s] [4h] [6d]
*** SHOWDOWN ***
MrBlue: shows [Th Tc]
MrBlue collected 20050.0 from pot
*** SUMMARY ***
Total pot 20050 | Rake 0
Board [2s 8h 7s 4h 6d]
Seat 2: Budd showed [As Kd] and lost
Seat 6: MrBlue showed [Th Tc] and won (20050.0)


PokerStars Hand #73138: Hold'em No Limit (50/100) - 2019/07/11 20:18:58 ET
Table 'Pluribus Session 73' 6-max (Play Money) Seat #6 is the button
Seat 1: Budd (10000 in chips)
Seat 2: Eddie (10000 in chips)
Seat 3: MrOrange (10000 in chips)
Seat 4: Bill (10000 in chips)
Seat 5: MrBlue (10000 in chips)
Seat 6: Pluribus (10000 in chips)
Budd: posts small blind 50
Eddie: posts big blind 100
*** HOLE CARDS ***
Dealt to Budd [8h Qc]
Dealt to Eddie [Js Ad]
Dealt to MrOrange [5s Qs]
Dealt to Bill [8c 9h]
Dealt to MrBlue [4s 2d]
Dealt to Pluribus [4c 9c]
MrOrange: folds
Bill: folds
MrBlue: folds
Pluribus: folds
Budd: raises 200 to 300
Eddie: calls 200
*** FLOP *** [7c 8d 5c]
Budd: checks
Eddie: checks
*** TURN *** [7c 8d 5c] [Ah]
Budd: checks
Eddie: checks
*** RIVER *** [7c 8d 5c] [Ah] [Kd]
Budd: checks
Eddie: bets 450
Budd: folds
Uncalled bet (450) returned to Eddie
Eddie collected 600.0 from pot
*** SUMMARY ***
Total pot 600 | Rake 0
Board [7c 8d 5c Ah Kd]


PokerStars Hand #73139: Hold'em No Limit (50/100) - 2019/07/11 20:18:59 ET
Table 'Pluribus Session 73' 6-max (Play Money) Seat #6 is the button
Seat 1: Eddie (10000 in chips)
Seat 2: MrOrange (10000 in chips)
Seat 3: Bill (10000 in chips)
Seat 4: MrBlue (10000 in chips)
Seat 5: Pluribus (10000 in chips)
Seat 6: Budd (10000 in chips)
Eddie: posts small blind 50
MrOrange: posts big blind 100
*** HOLE CARDS ***
Dealt to Eddie [Qc Kc]
Dealt to MrOrange [3d 9d]
Dealt to Bill [8h 2d]
Dealt to MrBlue [5c 4s]
Dealt to Pluribus [5d 4h]
Dealt to Budd [Ac Jh]
Bill: folds
MrBlue: folds
Pluribus: folds
Budd: raises 150 to 250
Eddie: raises 900 to 1150
MrOrange: folds
Budd: calls 900
*** FLOP *** [2h Qh 9c]
Eddie: bets 1700
Budd: folds
Uncalled bet (1700) returned to Eddie
Eddie collected 2400.0 from pot
*** SUMMARY ***
Total pot 2400 | Rake 0
Board [2h Qh 9c]


PokerStars Hand #73140: Hold'em No Limit (50/100) - 2019/07/11 20:19:00 ET
Table 'Pluribus Session 73' 6-max (Play Money) Seat #6 is the button
Seat 1: MrOrange (10000 in chips)
Seat 2: Bill (10000 in chips)
Seat 3: MrBlue (10000 in chips)
Seat 4: Pluribus (10000 in chips)
Seat 5: Budd (10000 in chips)
Seat 6: Eddie (10000 in chips)
MrOrange: posts small blind 50
Bill: posts big blind 100
*** HOLE CARDS ***
Dealt to MrOrange [Qd 4s]
Dealt to Bill [5h 9d]
Dealt to MrBlue [2h 8h]
Dealt to Pluribus [3c 5d]
Dealt to Budd [Ah 4d]
Dealt to Eddie [9c Td]
MrBlue: folds
Pluribus: folds
Budd: folds
Eddie: raises 122 to 222
MrOrange: folds
Bill: folds
Uncalled bet (122) returned to Eddie
Eddie collected 250.0 from pot
*** SUMMARY ***
Total pot 250 | Rake 0


PokerStars Hand #73141: Hold'em No Limit (50/100) - 2019/07/11 20:19:01 ET
Table 'Pluribus Session 73' 6-max (Play Money) Seat #6 is the button
Seat 1: Bill (10000 in chips)
Seat 2: MrBlue (10000 in chips)
Seat 3: Pluribus (10000 in chips)
Seat 4: Budd (10000 in chips)
Seat 5: Eddie (10000 in chips)
Seat 6: MrOrange (10000 in chips)
Bill: posts small blind 50
MrBlue: posts big blind 100
*** HOLE CARDS ***
Dealt to Bill [4s 3h]
Dealt to MrBlue [8s Td]
Dealt to Pluribus [7s 7c]
Dealt to Budd [9h 8h]
Dealt to Eddie [2c 3d]
Dealt to MrOrange [6s 3c]
Pluribus: raises 100 to 200
Budd: folds
Eddie: folds
MrOrange: folds
Bill: folds
MrBlue: calls 100
*** FLOP *** [7h 9s 2s]
MrBlue: checks
Pluribus: bets 450
MrBlue: calls 450
*** TURN *** [7h 9s 2s] [6d]
MrBlue: checks
Pluribus: bets 675
MrBlue: calls 675
*** RIVER *** [7h 9s 2s] [6d] [Ah]
MrBlue: checks
Pluribus: bets 2700
MrBlue: raises 5975 to 8675 and is all-in
Pluribus: calls 5975 and is all-in
*** SHOWDOWN ***
MrBlue: shows [8s Td]
MrBlue collected 20050.0 from pot
*** SUMMARY ***
Total pot 20050 | Rake 0
Board [7h 9s 2s 6d Ah]
Seat 2: MrBlue showed [8s Td] and won (20050.0)
Seat 3: Pluribus showed [7s 7c] and lost


PokerStars Hand #73142: Hold'em No Limit (50/100) - 2019/07/11 20:19:02 ET
Table 'Pluribus Session 73' 6-max (Play Money) Seat #6 is the button
Seat 1: MrBlue (10000 in chips)
Seat 2: Pluribus (10000 in chips)
Seat 3: Budd (10000 in chips)
Seat 4: Eddie (10000 in chips)
Seat 5: MrOrange (10000 in chips)
Seat 6: Bill (10000 in chips)
MrBlue: posts small blind 50
Pluribus: posts big blind 100
*** HOLE CARDS ***
Dealt to MrBlue [4d 2d]
Dealt to Pluribus [8s Kc]
Dealt to Budd [2c 2h]
Dealt to Eddie [Ts Ks]
Dealt to MrOrange [9d 7c]
Dealt to Bill [4c 2s]
Budd: folds
Eddie: raises 100 to 200
MrOrange: folds
Bill: folds
MrBlue: folds
Pluribus: calls 100
*** FLOP *** [5h 5d 3c]
Pluribus: checks
Eddie: bets 135
Pluribus: folds
Uncalled bet (135) returned to Eddie
Eddie collected 450.0 from pot
*** SUMMARY ***
Total pot 450 | Rake 0
Board [5h 5d 3c]


PokerStars Hand #73143: Hold'em No Limit (50/100) - 2019/07/11 20:19:03 ET
Table 'Pluribus Session 73' 6-max (Play Money) Seat #6 is the button
Seat 1: Pluribus (10000 in chips)
Seat 2: Budd (10000 in chips)
Seat 3: Eddie (10000 in chips)
Seat 4: MrOrange (10000 in chips)
Seat 5: Bill (10000 in chips)
Seat 6: MrBlue (10000 in chips)
Pluribus: posts small blind 50
Budd: posts big blind 100
*** HOLE CARDS ***
Dealt to Pluribus [4h Qh]
Dealt to Budd [5s Ts]
Dealt to Eddie [Kd 2s]
Dealt to MrOrange [Jc Qs]
Dealt to Bill [6s Ah]
Dealt to MrBlue [5h Ac]
Eddie: folds
MrOrange: folds
Bill: folds
MrBlue: raises 125 to 225
Pluribus: folds
Budd: calls 125
*** FLOP *** [9d Kc Ad]
Budd: checks
MrBlue: bets 375
Budd: folds
Uncalled bet (375) returned to MrBlue
MrBlue collected 500.0 from pot
*** SUMMARY ***
Total pot 500 | Rake 0
Board [9d Kc Ad]


PokerStars Hand #73144: Hold'em No Limit (50/100) - 2019/07/11 20:19:04 ET
Table 'Pluribus Session 73' 6-max (Play Money) Seat #6 is the button
Seat 1: Budd (10000 in chips)
Seat 2: Eddie (10000 in chips)
Seat 3: MrOrange (10000 in chips)
Seat 4: Bill (10000 in chips)
Seat 5: MrBlue (10000 in chips)
Seat 6: Pluribus (10000 in chips)
Budd: posts small blind 50
Eddie: posts big blind 100
*** HOLE CARDS ***
Dealt to Budd [3h 4h]
Dealt to Eddie [8h Ks]
Dealt to MrOrange [6c As]
Dealt to Bill [Jd Js]
Dealt to MrBlue [Kd 5c]
Dealt to Pluribus [Ah 8c]
MrOrange: folds
Bill: raises 125 to 225
MrBlue: folds
Pluribus: folds
Budd: folds
Eddie: folds
Uncalled bet (125) returned to Bill
Bill collected 250.0 from pot
*** SUMMARY ***
Total pot 250 | Rake 0


PokerStars Hand #73145: Hold'em No Limit (50/100) - 2019/07/11 20:19:05 ET
Table 'Pluribus Session 73' 6-max (Play Money) Seat #6 is the button
Seat 1: Eddie (10000 in chips)
Seat 2: MrOrange (10000 in chips)
Seat 3: Bill (10000 in chips)
Seat 4: MrBlue (10000 in chips)
Seat 5: Pluribus (10000 in chips)
Seat 6: Budd (10000 in chips)
Eddie: posts small blind 50
MrOrange: posts big blind 100
*** HOLE CARDS ***
Dealt to Eddie [8h Ts]
Dealt to MrOrange [4d Tc]
Dealt to Bill [5d 6d]
Dealt to MrBlue [Qc 3s]
Dealt to Pluribus [3h 2c]
Dealt to Budd [Ac 7c]
Bill: raises 125 to 225
MrBlue: folds
Pluribus: folds
Budd: folds
Eddie: folds
MrOrange: folds
Uncalled bet (125) returned to Bill
Bill collected 250.0 from pot
*** SUMMARY ***
Total pot 250 | Rake 0


PokerStars Hand #73146: Hold'em No Limit (50/100) - 2019/07/11 20:19:06 ET
Table 'Pluribus Session 73' 6-max (Play Money) Seat #6 is the button
Seat 1: MrOrange (10000 in chips)
Seat 2: Bill (10000 in chips)
Seat 3: MrBlue (10000 in chips)
Seat 4: Pluribus (10000 in chips)
Seat 5: Budd (10000 in chips)
Seat 6: Eddie (10000 in chips)
MrOrange: posts small blind 50
Bill: posts big blind 100
*** HOLE CARDS ***
Dealt to MrOrange [Jc 6h]
Dealt to Bill [3d 7c]
Dealt to MrBlue [4c 5d]
Dealt to Pluribus [6d Js]
Dealt to Budd [8s Ad]
Dealt to Eddie [2h Kc]
MrBlue: folds
Pluribus: folds
Budd: folds
Eddie: folds
MrOrange: folds
Uncalled bet (50) returned to Bill
Bill collected 100.0 from pot
*** SUMMARY ***
Total pot 100 | Rake 0


PokerStars Hand #73147: Hold'em No Limit (50/100) - 2019/07/11 20:19:07 ET
Table 'Pluribus Session 73' 6-max (Play Money) Seat #6 is the button
Seat 1: Bill (10000 in chips)
Seat 2: MrBlue (10000 in chips)
Seat 3: Pluribus (10000 in chips)
Seat 4: Budd (10000 in chips)
Seat 5: Eddie (10000 in chips)
Seat 6: MrOrange (10000 in chips)
Bill: posts small blind 50
MrBlue: posts big blind 100
*** HOLE CARDS ***
Dealt to Bill [3d 7c]
Dealt to MrBlue [Tc Th]
Dealt to Pluribus [Kh As]
Dealt to Budd [Ts Jd]
Dealt to Eddie [3c 2h]
Dealt to MrOrange [4h 8c]
Pluribus: raises 100 to 200
Budd: folds
Eddie: folds
MrOrange: folds
Bill: folds
MrBlue: calls 100
*** FLOP *** [Kc 4c 2c]
MrBlue: checks
Pluribus: bets 225
MrBlue: calls 225
*** TURN *** [Kc 4c 2c] [Kd]
MrBlue: checks
Pluribus: checks
*** RIVER *** [Kc 4c 2c] [Kd] [Td]
MrBlue: checks
Pluribus: bets 675
MrBlue: raises 3825 to 4500
Pluribus: folds
Uncalled bet (3825) returned to MrBlue
MrBlue collected 2250.0 from pot
*** SUMMARY ***
Total pot 2250 | Rake 0
Board [Kc 4c 2c Kd Td]
