PokerStars Hand #114073: Hold'em No Limit (50/100) - 2019/07/12 07:41:13 ET
Table 'Pluribus Session 114' 6-max (Play Money) Seat #6 is the button
Seat 1: MrPink (10000 in chips)
Seat 2: MrOrange (10000 in chips)
Seat 3: MrBrown (10000 in chips)
Seat 4: MrBlue (10000 in chips)
Seat 5: Pluribus (10000 in chips)
Seat 6: Eddie (10000 in chips)
MrPink: posts small blind 50
MrOrange: posts big blind 100
*** HOLE CARDS ***
Dealt to MrPink [Qh Ks]
Dealt to MrOrange [3h 9h]
Dealt to MrBrown [4d 3s]
Dealt to MrBlue [Kc Jd]
Dealt to Pluribus [Kh Qd]
Dealt to Eddie [2d 2h]
MrBrown: folds
MrBlue: folds
Pluribus: raises 187 to 287
Eddie: calls 287
MrPink: raises 1163 to 1450
MrOrange: folds
Pluribus: folds
Eddie: folds
Uncalled bet (1163) returned to MrPink
MrPink collected 961.0 from pot
*** SUMMARY ***
Total pot 961 | Rake 0


PokerStars Hand #114074: Hold'em No Limit (50/100) - 2019/07/12 07:41:14 ET
Table 'Pluribus Session 114' 6-max (Play Money) Seat #6 is the button
Seat 1: MrOrange (10000 in chips)
Seat 2: MrBrown (10000 in chips)
Seat 3: MrBlue (10000 in chips)
Seat 4: Pluribus (10000 in chips)
Seat 5: Eddie (10000 in chips)
Seat 6: MrPink (10000 in chips)
MrOrange: posts small blind 50
MrBrown: posts big blind 100
*** HOLE CARDS ***
Dealt to MrOrange [4h 8c]
Dealt to MrBrown [6d Qd]
Dealt to MrBlue [2d 2s]
Dealt to Pluribus [7d 9d]
Dealt to Eddie [2h 5h]
Dealt to MrPink [Th 9c]
MrBlue: raises 125 to 225
Pluribus: folds
Eddie: folds
MrPink: folds
MrOrange: folds
MrBrown: calls 125
*** FLOP *** [Qc Ad 5s]
MrBrown: checks
MrBlue: bets 250
MrBrown: calls 250
*** TURN *** [Qc Ad 5s] [9h]
MrBrown: checks
MrBlue: checks
*** RIVER *** [Qc Ad 5s] [9h] [4s]
MrBrown: checks
MrBlue: checks
*** SHOWDOWN ***
MrBrown: shows [6d Qd]
MrBrown collected 1000.0 from pot
*** SUMMARY ***
Total pot 1000 | Rake 0
Board [Qc Ad 5s 9h 4s]
Seat 2: MrBrown showed [6d Qd] and won (1000.0)
Seat 3: MrBlue showed [2d 2s] and lost


PokerStars Hand #114075: Hold'em No Limit (50/100) - 2019/07/12 07:41:15 ET
Table 'Pluribus Session 114' 6-max (Play Money) Seat #6 is the button
Seat 1: MrBrown (10000 in chips)
Seat 2: MrBlue (10000 in chips)
Seat 3: Pluribus (10000 in chips)
Seat 4: Eddie (10000 in chips)
Seat 5: MrPink (10000 in chips)
Seat 6: MrOrange (10000 in chips)
MrBrown: posts small blind 50
MrBlue: posts big blind 100
*** HOLE CARDS ***
Dealt to MrBrown [Ks 2s]
Dealt to MrBlue [5h 3c]
Dealt to Pluribus [Ts 8s]
Dealt to Eddie [Ad As]
Dealt to MrPink [3s Qh]
Dealt to MrOrange [Kh Tc]
Pluribus: folds
Eddie: raises 100 to 200
MrPink: folds
MrOrange: folds
MrBrown: folds
MrBlue: calls 100
*** FLOP *** [5d 3h 9c]
MrBlue: checks
Eddie: bets 500
MrBlue: raises 1087 to 1587
Eddie: calls 1087
*** TURN *** [5d 3h 9c] [8h]
MrBlue: checks
Eddie: bets 1812
MrBlue: calls 1812
*** RIVER *** [5d 3h 9c] [8h] [Qc]
MrBlue: checks
Eddie: bets 6401 and is all-in
MrBlue: folds
Uncalled bet (6401) returned to Eddie
Eddie collected 7248.0 from pot
*** SUMMARY ***
Total pot 7248 | Rake 0
Board [5d 3h 9c 8h Qc]


PokerStars Hand #114076: Hold'em No Limit (50/100) - 2019/07/12 07:41:16 ET
Table 'Pluribus Session 114' 6-max (Play Money) Seat #6 is the button
Seat 1: MrBlue (10000 in chips)
Seat 2: Pluribus (10000 in chips)
Seat 3: Eddie (10000 in chips)
Seat 4: MrPink (10000 in chips)
Seat 5: MrOrange (10000 in chips)
Seat 6: MrBrown (10000 in chips)
MrBlue: posts small blind 50
Pluribus: posts big blind 100
*** HOLE CARDS ***
Dealt to MrBlue [2d Qd]
Dealt to Pluribus [6s Jd]
Dealt to Eddie [Kh 6c]
Dealt to MrPink [7d Tc]
Dealt to MrOrange [Qc 4d]
Dealt to MrBrown [Td 8h]
Eddie: folds
MrPink: folds
MrOrange: folds
MrBrown: raises 175 to 275
MrBlue: folds
Pluribus: folds
Uncalled bet (175) returned to MrBrown
MrBrown collected 250.0 from pot
*** SUMMARY ***
Total pot 250 | Rake 0


PokerStars Hand #114077: Hold'em No Limit (50/100) - 2019/07/12 07:41:17 ET
Table 'Pluribus Session 114' 6-max (Play Money) Seat #6 is the button
Seat 1: Pluribus (10000 in chips)
Seat 2: Eddie (10000 in chips)
Seat 3: MrPink (10000 in chips)
Seat 4: MrOrange (10000 in chips)
Seat 5: MrBrown (10000 in chips)
Seat 6: MrBlue (10000 in chips)
Pluribus: posts small blind 50
Eddie: posts big blind 100
*** HOLE CARDS ***
Dealt to Pluribus [7d 6c]
Dealt to Eddie [5d 5s]
Dealt to MrPink [Ks 9h]
Dealt to MrOrange [Td 9s]
Dealt to MrBrown [Kh Qc]
Dealt to MrBlue [Tc 2c]
MrPink: folds
MrOrange: folds
MrBrown: raises 150 to 250
MrBlue: folds
Pluribus: folds
Eddie: calls 150
*** FLOP *** [7h 5c 2d]
Eddie: checks
MrBrown: checks
*** TURN *** [7h 5c 2d] [Ah]
Eddie: checks
MrBrown: checks
*** RIVER *** [7h 5c 2d] [Ah] [As]
Eddie: checks
MrBrown: checks
*** SHOWDOWN ***
Eddie: shows [5d 5s]
Eddie collected 550.0 from pot
*** SUMMARY ***
Total pot 550 | Rake 0
Board [7h 5c 2d Ah As]
Seat 2: Eddie showed [5d 5s] and won (550.0)
Seat 5: MrBrown showed [Kh Qc] and lost


PokerStars Hand #114078: Hold'em No Limit (50/100) - 2019/07/12 07:41:18 ET
Table 'Pluribus Session 114' 6-max (Play Money) Seat #6 is the button
Seat 1: Eddie (10000 in chips)
Seat 2: MrPink (10000 in chips)
Seat 3: MrOrange (10000 in chips)
Seat 4: MrBrown (10000 in chips)
Seat 5: MrBlue (10000 in chips)
Seat 6: Pluribus (10000 in chips)
Eddie: posts small blind 50
MrPink: posts big blind 100
*** HOLE CARDS ***
Dealt to Eddie [6h 4s]
Dealt to MrPink [3d 8s]
Dealt to MrOrange [9h 8h]
Dealt to MrBrown [6d Jh]
Dealt to MrBlue [Tc 3h]
Dealt to Pluribus [7s 9c]
MrOrange: raises 100 to 200
MrBrown: folds
MrBlue: folds
Pluribus: folds
Eddie: folds
MrPink: folds
Uncalled bet (100) returned to MrOrange
MrOrange collected 250.0 from pot
*** SUMMARY ***
Total pot 250 | Rake 0


PokerStars Hand #114079: Hold'em No Limit (50/100) - 2019/07/12 07:41:19 ET
Table 'Pluribus Session 114' 6-max (Play Money) Seat #6 is the button
Seat 1: MrPink (10000 in chips)
Seat 2: MrOrange (10000 in chips)
Seat 3: MrBrown (10000 in chips)
Seat 4: MrBlue (10000 in chips)
Seat 5: Pluribus (10000 in chips)
Seat 6: Eddie (10000 in chips)
MrPink: posts small blind 50
MrOrange: posts big blind 100
*** HOLE CARDS ***
Dealt to MrPink [8d 9c]
Dealt to MrOrange [7s 4h]
Dealt to MrBrown [Qs 9h]
Dealt to MrBlue [Kh Jd]
Dealt to Pluribus [Td 3d]
Dealt to Eddie [3s 7d]
MrBrown: folds
MrBlue: folds
Pluribus: folds
Eddie: folds
MrPink: calls 50
MrOrange: raises 250 to 350
MrPink: calls 250
*** FLOP *** [8c Ks Ts]
MrPink: checks
MrOrange: checks
*** TURN *** [8c Ks Ts] [Ac]
MrPink: checks
MrOrange: checks
*** RIVER *** [8c Ks Ts] [Ac] [2c]
MrPink: checks
MrOrange: bets 375
MrPink: folds
Uncalled bet (375) returned to MrOrange
MrOrange collected 700.0 from pot
*** SUMMARY ***
Total pot 700 | Rake 0
Board [8c Ks Ts Ac 2c]


PokerStars Hand #114080: Hold'em No Limit (50/100) - 2019/07/12 07:41:20 ET
Table 'Pluribus Session 114' 6-max (Play Money) Seat #6 is the button
Seat 1: MrOrange (10000 in chips)
Seat 2: MrBrown (10000 in chips)
Seat 3: MrBlue (10000 in chips)
Seat 4: Pluribus (10000 in chips)
Seat 5: Eddie (10000 in chips)
Seat 6: MrPink (10000 in chips)
MrOrange: posts small blind 50
MrBrown: posts big blind 100
*** HOLE CARDS ***
Dealt to MrOrange [8h 6s]
Dealt to MrBrown [7h 6d]
Dealt to MrBlue [2c 3h]
Dealt to Pluribus [Qs Jc]
Dealt to Eddie [Jh 3d]
Dealt to MrPink [7c Ac]
MrBlue: folds
Pluribus: raises 125 to 225
Eddie: folds
MrPink: calls 225
MrOrange: folds
MrBrown: raises 990 to 1215
Pluribus: folds
MrPink: folds
Uncalled bet (990) returned to MrBrown
MrBrown collected 725.0 from pot
*** SUMMARY ***
Total pot 725 | Rake 0


PokerStars Hand #114081: Hold'em No Limit (50/100) - 2019/07/12 07:41:21 ET
Table 'Pluribus Session 114' 6-max (Play Money) Seat #6 is the button
Seat 1: MrBrown (10000 in chips)
Seat 2: MrBlue (10000 in chips)
Seat 3: Pluribus (10000 in chips)
Seat 4: Eddie (10000 in chips)
Seat 5: MrPink (10000 in chips)
Seat 6: MrOrange (10000 in chips)
MrBrown: posts small blind 50
MrBlue: posts big blind 100
*** HOLE CARDS ***
Dealt to MrBrown [4s 5s]
Dealt to MrBlue [9h 8d]
Dealt to Pluribus [7s 5c]
Dealt to Eddie [9d 2d]
Dealt to MrPink [Td 4d]
Dealt to MrOrange [9c 8c]
Pluribus: folds
Eddie: folds
MrPink: folds
MrOrange: raises 125 to 225
MrBrown: raises 675 to 900
MrBlue: folds
MrOrange: calls 675
*** FLOP *** [Th 2c As]
MrBrown: bets 800
MrOrange: folds
Uncalled bet (800) returned to MrBrown
MrBrown collected 1900.0 from pot
*** SUMMARY ***
Total pot 1900 | Rake 0
Board [Th 2c As]


PokerStars Hand #114082: Hold'em No Limit (50/100) - 2019/07/12 07:41:22 ET
Table 'Pluribus Session 114' 6-max (Play Money) Seat #6 is the button
Seat 1: MrBlue (10000 in chips)
Seat 2: Pluribus (10000 in chips)
Seat 3: Eddie (10000 in chips)
Seat 4: MrPink (10000 in chips)
Seat 5: MrOrange (10000 in chips)
Seat 6: MrBrown (10000 in chips)
MrBlue: posts small blind 50
Pluribus: posts big blind 100
*** HOLE CARDS ***
Dealt to MrBlue [9s 3c]
Dealt to Pluribus [Qd 6h]
Dealt to Eddie [6s 5h]
Dealt to MrPink [Qh Ts]
Dealt to MrOrange [4s 9h]
Dealt to MrBrown [7d 8d]
Eddie: folds
MrPink: folds
MrOrange: folds
MrBrown: raises 175 to 275
MrBlue: folds
Pluribus: folds
Uncalled bet (175) returned to MrBrown
MrBrown collected 250.0 from pot
*** SUMMARY ***
Total pot 250 | Rake 0


PokerStars Hand #114083: Hold'em No Limit (50/100) - 2019/07/12 07:41:23 ET
Table 'Pluribus Session 114' 6-max (Play Money) Seat #6 is the button
Seat 1: Pluribus (10000 in chips)
Seat 2: Eddie (10000 in chips)
Seat 3: MrPink (10000 in chips)
Seat 4: MrOrange (10000 in chips)
Seat 5: MrBrown (10000 in chips)
Seat 6: MrBlue (10000 in chips)
Pluribus: posts small blind 50
Eddie: posts big blind 100
*** HOLE CARDS ***
Dealt to Pluribus [3d Ad]
Dealt to Eddie [Th Ah]
Dealt to MrPink [Jd 7s]
Dealt to MrOrange [6d 2s]
Dealt to MrBrown [Ks Kd]
Dealt to MrBlue [5d 4h]
MrPink: folds
MrOrange: folds
MrBrown: raises 150 to 250
MrBlue: folds
Pluribus: calls 200
Eddie: raises 1050 to 1300
MrBrown: raises 1450 to 2750
Pluribus: folds
Eddie: calls 1450
*** FLOP *** [7d 8s Jc]
Eddie: checks
MrBrown: bets 7250 and is all-in
Eddie: folds
Uncalled bet (7250) returned to MrBrown
MrBrown collected 5750.0 from pot
*** SUMMARY ***
Total pot 5750 | Rake 0
Board [7d 8s Jc]


PokerStars Hand #114084: Hold'em No Limit (50/100) - 2019/07/12 07:41:24 ET
Table 'Pluribus Session 114' 6-max (Play Money) Seat #6 is the button
Seat 1: Eddie (10000 in chips)
Seat 2: MrPink (10000 in chips)
Seat 3: MrOrange (10000 in chips)
Seat 4: MrBrown (10000 in chips)
Seat 5: MrBlue (10000 in chips)
Seat 6: Pluribus (10000 in chips)
Eddie: posts small blind 50
MrPink: posts big blind 100
*** HOLE CARDS ***
Dealt to Eddie [5d Kh]
Dealt to MrPink [Kc 7d]
Dealt to MrOrange [8s 4s]
Dealt to MrBrown [Jc Ts]
Dealt to MrBlue [9d Qs]
Dealt to Pluribus [Qc As]
MrOrange: folds
MrBrown: folds
MrBlue: folds
Pluribus: raises 125 to 225
Eddie: folds
MrPink: calls 125
*** FLOP *** [Ah 7h 6s]
MrPink: checks
Pluribus: bets 500
MrPink: calls 500
*** TURN *** [Ah 7h 6s] [8d]
MrPink: checks
Pluribus: checks
*** RIVER *** [Ah 7h 6s] [8d] [8h]
MrPink: checks
Pluribus: checks
*** SHOWDOWN ***
Pluribus: shows [Qc As]
Pluribus collected 1500.0 from pot
*** SUMMARY ***
Total pot 1500 | Rake 0
Board [Ah 7h 6s 8d 8h]
Seat 2: MrPink showed [Kc 7d] and lost
Seat 6: Pluribus showed [Qc As] and won (1500.0)


PokerStars Hand #114085: Hold'em No Limit (50/100) - 2019/07/12 07:41:25 ET
Table 'Pluribus Session 114' 6-max (Play Money) Seat #6 is the button
Seat 1: MrPink (10000 in chips)
Seat 2: MrOrange (10000 in chips)
Seat 3: MrBrown (10000 in chips)
Seat 4: MrBlue (10000 in chips)
Seat 5: Pluribus (10000 in chips)
Seat 6: Eddie (10000 in chips)
MrPink: posts small blind 50
MrOrange: posts big blind 100
*** HOLE CARDS ***
Dealt to MrPink [6c 9s]
Dealt to MrOrange [7h 5s]
Dealt to MrBrown [Ah 3h]
Dealt to MrBlue [Ad Th]
Dealt to Pluribus [5h 3d]
Dealt to Eddie [Kd 8h]
MrBrown: raises 125 to 225
MrBlue: folds
Pluribus: folds
Eddie: folds
MrPink: folds
MrOrange: folds
Uncalled bet (125) returned to MrBrown
MrBrown collected 250.0 from pot
*** SUMMARY ***
Total pot 250 | Rake 0


PokerStars Hand #114086: Hold'em No Limit (50/100) - 2019/07/12 07:41:26 ET
Table 'Pluribus Session 114' 6-max (Play Money) Seat #6 is the button
Seat 1: MrOrange (10000 in chips)
Seat 2: MrBrown (10000 in chips)
Seat 3: MrBlue (10000 in chips)
Seat 4: Pluribus (10000 in chips)
Seat 5: Eddie (10000 in chips)
Seat 6: MrPink (10000 in chips)
MrOrange: posts small blind 50
MrBrown: posts big blind 100
*** HOLE CARDS ***
Dealt to MrOrange [7s 6c]
Dealt to MrBrown [5d 7c]
Dealt to MrBlue [3h 4c]
Dealt to Pluribus [Ad 2c]
Dealt to Eddie [3c Ts]
Dealt to MrPink [Jh 8h]
MrBlue: folds
Pluribus: folds
Eddie: folds
MrPink: raises 150 to 250
MrOrange: folds
MrBrown: calls 150
*** FLOP *** [4d As 6h]
MrBrown: checks
MrPink: bets 130
MrBrown: calls 130
*** TURN *** [4d As 6h] [Th]
MrBrown: checks
MrPink: bets 1100
MrBrown: raises 1505 to 2605
MrPink: calls 1505
*** RIVER *** [4d As 6h] [Th] [Qd]
MrBrown: bets 7015 and is all-in
MrPink: folds
Uncalled bet (7015) returned to MrBrown
MrBrown collected 6020.0 from pot
*** SUMMARY ***
Total pot 6020 | Rake 0
Board [4d As 6h Th Qd]


PokerStars Hand #114087: Hold'em No Limit (50/100) - 2019/07/12 07:41:27 ET
Table 'Pluribus Session 114' 6-max (Play Money) Seat #6 is the button
Seat 1: MrBrown (10000 in chips)
Seat 2: MrBlue (10000 in chips)
Seat 3: Pluribus (10000 in chips)
Seat 4: Eddie (10000 in chips)
Seat 5: MrPink (10000 in chips)
Seat 6: MrOrange (10000 in chips)
MrBrown: posts small blind 50
MrBlue: posts big blind 100
*** HOLE CARDS ***
Dealt to MrBrown [9s 3d]
Dealt to MrBlue [Js 9d]
Dealt to Pluribus [Kc Th]
Dealt to Eddie [2h 9c]
Dealt to MrPink [7s Jc]
Dealt to MrOrange [Td 4d]
Pluribus: raises 187 to 287
Eddie: folds
MrPink: folds
MrOrange: folds
MrBrown: folds
MrBlue: calls 187
*** FLOP *** [8s 7d 4h]
MrBlue: checks
Pluribus: checks
*** TURN *** [8s 7d 4h] [6d]
MrBlue: bets 360
Pluribus: calls 360
*** RIVER *** [8s 7d 4h] [6d] [Ts]
MrBlue: checks
Pluribus: checks
*** SHOWDOWN ***
MrBlue: shows [Js 9d]
MrBlue collected 1344.0 from pot
*** SUMMARY ***
Total pot 1344 | Rake 0
Board [8s 7d 4h 6d Ts]
Seat 2: MrBlue showed [Js 9d] and won (1344.0)
Seat 3: Pluribus showed [Kc Th] and lost


PokerStars Hand #114088: Hold'em No Limit (50/100) - 2019/07/12 07:41:28 ET
Table 'Pluribus Session 114' 6-max (Play Money) Seat #6 is the button
Seat 1: MrBlue (10000 in chips)
Seat 2: Pluribus (10000 in chips)
Seat 3: Eddie (10000 in chips)
Seat 4: MrPink (10000 in chips)
Seat 5: MrOrange (10000 in chips)
Seat 6: MrBrown (10000 in chips)
MrBlue: posts small blind 50
Pluribus: posts big blind 100
*** HOLE CARDS ***
Dealt to MrBlue [3h 2s]
Dealt to Pluribus [3d Ad]
Dealt to Eddie [5h 8c]
Dealt to MrPink [3c 4c]
Dealt to MrOrange [Qs 7s]
Dealt to MrBrown [As 7c]
Eddie: folds
MrPink: folds
MrOrange: folds
MrBrown: raises 170 to 270
MrBlue: folds
Pluribus: calls 170
*** FLOP *** [4d Qh 9d]
Pluribus: checks
MrBrown: checks
*** TURN *** [4d Qh 9d] [Kh]
Pluribus: bets 1180
MrBrown: folds
Uncalled bet (1180) returned to Pluribus
Pluribus collected 590.0 from pot
*** SUMMARY ***
Total pot 590 | Rake 0
Board [4d Qh 9d Kh]


PokerStars Hand #114089: Hold'em No Limit (50/100) - 2019/07/12 07:41:29 ET
Table 'Pluribus Session 114' 6-max (Play Money) Seat #6 is the button
Seat 1: Pluribus (10000 in chips)
Seat 2: Eddie (10000 in chips)
Seat 3: MrPink (10000 in chips)
Seat 4: MrOrange (10000 in chips)
Seat 5: MrBrown (10000 in chips)
Seat 6: MrBlue (10000 in chips)
Pluribus: posts small blind 50
Eddie: posts big blind 100
*** HOLE CARDS ***
Dealt to Pluribus [Kh Td]
Dealt to Eddie [8c 3s]
Dealt to MrPink [Ah 9d]
Dealt to MrOrange [3c 2s]
Dealt to MrBrown [Ad 7s]
Dealt to MrBlue [8d 5s]
MrPink: folds
MrOrange: folds
MrBrown: folds
MrBlue: folds
Pluribus: calls 50
Eddie: checks
*** FLOP *** [Tc 5d Qc]
Pluribus: bets 100
Eddie: folds
Uncalled bet (100) returned to Pluribus
Pluribus collected 200.0 from pot
*** SUMMARY ***
Total pot 200 | Rake 0
Board [Tc 5d Qc]


PokerStars Hand #114090: Hold'em No Limit (50/100) - 2019/07/12 07:41:30 ET
Table 'Pluribus Session 114' 6-max (Play Money) Seat #6 is the button
Seat 1: Eddie (10000 in chips)
Seat 2: MrPink (10000 in chips)
Seat 3: MrOrange (10000 in chips)
Seat 4: MrBrown (10000 in chips)
Seat 5: MrBlue (10000 in chips)
Seat 6: Pluribus (10000 in chips)
Eddie: posts small blind 50
MrPink: posts big blind 100
*** HOLE CARDS ***
Dealt to Eddie [4c 9d]
Dealt to MrPink [3c Qs]
Dealt to MrOrange [Kd Kc]
Dealt to MrBrown [Qd 6s]
Dealt to MrBlue [2s Qh]
Dealt to Pluribus [7s As]
MrOrange: raises 100 to 200
MrBrown: folds
MrBlue: folds
Pluribus: raises 550 to 750
Eddie: folds
MrPink: folds
MrOrange: calls 550
*** FLOP *** [Jh 9c 9h]
MrOrange: checks
Pluribus: checks
*** TURN *** [Jh 9c 9h] [9s]
MrOrange: bets 555
Pluribus: folds
Uncalled bet (555) returned to MrOrange
MrOrange collected 1650.0 from pot
*** SUMMARY ***
Total pot 1650 | Rake 0
Board [Jh 9c 9h 9s]


PokerStars Hand #114091: Hold'em No Limit (50/100) - 2019/07/12 07:41:31 ET
Table 'Pluribus Session 114' 6-max (Play Money) Seat #6 is the button
Seat 1: MrPink (10000 in chips)
Seat 2: MrOrange (10000 in chips)
Seat 3: MrBrown (10000 in chips)
Seat 4: MrBlue (10000 in chips)
Seat 5: Pluribus (10000 in chips)
Seat 6: Eddie (10000 in chips)
MrPink: posts small blind 50
MrOrange: posts big blind 100
*** HOLE CARDS ***
Dealt to MrPink [2d 7h]
Dealt to MrOrange [6h 8h]
Dealt to MrBrown [5h 7s]
Dealt to MrBlue [Th Kc]
Dealt to Pluribus [Jd Qs]
Dealt to Eddie [2s 4d]
MrBrown: folds
MrBlue: folds
Pluribus: raises 125 to 225
Eddie: folds
MrPink: folds
MrOrange: raises 975 to 1200
Pluribus: folds
Uncalled bet (975) returned to MrOrange
MrOrange collected 500.0 from pot
*** SUMMARY ***
Total pot 500 | Rake 0


PokerStars Hand #114092: Hold'em No Limit (50/100) - 2019/07/12 07:41:32 ET
Table 'Pluribus Session 114' 6-max (Play Money) Seat #6 is the button
Seat 1: MrOrange (10000 in chips)
Seat 2: MrBrown (10000 in chips)
Seat 3: MrBlue (10000 in chips)
Seat 4: Pluribus (10000 in chips)
Seat 5: Eddie (10000 in chips)
Seat 6: MrPink (10000 in chips)
MrOrange: posts small blind 50
MrBrown: posts big blind 100
*** HOLE CARDS ***
Dealt to MrOrange [Js Jc]
Dealt to MrBrown [7s 2h]
Dealt to MrBlue [Qh 7h]
Dealt to Pluribus [2c 9d]
Dealt to Eddie [9s Kd]
Dealt to MrPink [Qd 5s]
MrBlue: folds
Pluribus: folds
Eddie: folds
MrPink: folds
MrOrange: raises 150 to 250
MrBrown: folds
Uncalled bet (150) returned to MrOrange
MrOrange collected 200.0 from pot
*** SUMMARY ***
Total pot 200 | Rake 0


PokerStars Hand #114093: Hold'em No Limit (50/100) - 2019/07/12 07:41:33 ET
Table 'Pluribus Session 114' 6-max (Play Money) Seat #6 is the button
Seat 1: MrBrown (10000 in chips)
Seat 2: MrBlue (10000 in chips)
Seat 3: Pluribus (10000 in chips)
Seat 4: Eddie (10000 in chips)
Seat 5: MrPink (10000 in chips)
Seat 6: MrOrange (10000 in chips)
MrBrown: posts small blind 50
MrBlue: posts big blind 100
*** HOLE CARDS ***
Dealt to MrBrown [Qs Ac]
Dealt to MrBlue [Kc 2h]
Dealt to Pluribus [8h 7s]
Dealt to Eddie [6d 5s]
Dealt to MrPink [9h 5d]
Dealt to MrOrange [Ad 2s]
Pluribus: folds
Eddie: folds
MrPink: folds
MrOrange: raises 125 to 225
MrBrown: raises 675 to 900
MrBlue: folds
MrOrange: folds
Uncalled bet (675) returned to MrBrown
MrBrown collected 550.0 from pot
*** SUMMARY ***
Total pot 550 | Rake 0


PokerStars Hand #114094: Hold'em No Limit (50/100) - 2019/07/12 07:41:34 ET
Table 'Pluribus Session 114' 6-max (Play Money) Seat #6 is the button
Seat 1: MrBlue (10000 in chips)
Seat 2: Pluribus (10000 in chips)
Seat 3: Eddie (10000 in chips)
Seat 4: MrPink (10000 in chips)
Seat 5: MrOrange (10000 in chips)
Seat 6: MrBrown (10000 in chips)
MrBlue: posts small blind 50
Pluribus: posts big blind 100
*** HOLE CARDS ***
Dealt to MrBlue [5s Ad]
Dealt to Pluribus [Ac 8h]
Dealt to Eddie [9h 2c]
Dealt to MrPink [2d 3s]
Dealt to MrOrange [Jd 9c]
Dealt to MrBrown [Jc Th]
Eddie: folds
MrPink: folds
MrOrange: folds
MrBrown: raises 175 to 275
MrBlue: folds
Pluribus: calls 175
*** FLOP *** [5c Qh Ts]
Pluribus: checks
MrBrown: checks
*** TURN *** [5c Qh Ts] [Qs]
Pluribus: checks
MrBrown: bets 200
Pluribus: folds
Uncalled bet (200) returned to MrBrown
MrBrown collected 600.0 from pot
*** SUMMARY ***
Total pot 600 | Rake 0
Board [5c Qh Ts Qs]


PokerStars Hand #114095: Hold'em No Limit (50/100) - 2019/07/12 07:41:35 ET
Table 'Pluribus Session 114' 6-max (Play Money) Seat #6 is the button
Seat 1: Pluribus (10000 in chips)
Seat 2: Eddie (10000 in chips)
Seat 3: MrPink (10000 in chips)
Seat 4: MrOrange (10000 in chips)
Seat 5: MrBrown (10000 in chips)
Seat 6: MrBlue (10000 in chips)
Pluribus: posts small blind 50
Eddie: posts big blind 100
*** HOLE CARDS ***
Dealt to Pluribus [3h 9d]
Dealt to Eddie [8h Kh]
Dealt to MrPink [2s 9h]
Dealt to MrOrange [2h 6c]
Dealt to MrBrown [Tc 5h]
Dealt to MrBlue [Ks 3d]
MrPink: folds
MrOrange: folds
MrBrown: folds
MrBlue: folds
Pluribus: folds
Uncalled bet (50) returned to Eddie
Eddie collected 100.0 from pot
*** SUMMARY ***
Total pot 100 | Rake 0


PokerStars Hand #114096: Hold'em No Limit (50/100) - 2019/07/12 07:41:36 ET
Table 'Pluribus Session 114' 6-max (Play Money) Seat #6 is the button
Seat 1: Eddie (10000 in chips)
Seat 2: MrPink (10000 in chips)
Seat 3: MrOrange (10000 in chips)
Seat 4: MrBrown (10000 in chips)
Seat 5: MrBlue (10000 in chips)
Seat 6: Pluribus (10000 in chips)
Eddie: posts small blind 50
MrPink: posts big blind 100
*** HOLE CARDS ***
Dealt to Eddie [9c 9h]
Dealt to MrPink [7h 8s]
Dealt to MrOrange [6d Jd]
Dealt to MrBrown [8c Qc]
Dealt to MrBlue [Kc 5d]
Dealt to Pluribus [Tc 7s]
MrOrange: folds
MrBrown: folds
MrBlue: folds
Pluribus: folds
Eddie: raises 135 to 235
MrPink: calls 135
*** FLOP *** [4d 2c Td]
Eddie: checks
MrPink: checks
*** TURN *** [4d 2c Td] [8h]
Eddie: bets 140
MrPink: calls 140
*** RIVER *** [4d 2c Td] [8h] [Kh]
Eddie: bets 250
MrPink: calls 250
*** SHOWDOWN ***
Eddie: shows [9c 9h]
Eddie collected 1250.0 from pot
*** SUMMARY ***
Total pot 1250 | Rake 0
Board [4d 2c Td 8h Kh]
Seat 1: Eddie showed [9c 9h] and won (1250.0)
Seat 2: MrPink showed [7h 8s] and lost


PokerStars Hand #114097: Hold'em No Limit (50/100) - 2019/07/12 07:41:37 ET
Table 'Pluribus Session 114' 6-max (Play Money) Seat #6 is the button
Seat 1: MrPink (10000 in chips)
Seat 2: MrOrange (10000 in chips)
Seat 3: MrBrown (10000 in chips)
Seat 4: MrBlue (10000 in chips)
Seat 5: Pluribus (10000 in chips)
Seat 6: Eddie (10000 in chips)
MrPink: posts small blind 50
MrOrange: posts big blind 100
*** HOLE CARDS ***
Dealt to MrPink [6h 5d]
Dealt to MrOrange [7s 3h]
Dealt to MrBrown [9h Td]
Dealt to MrBlue [4h Ts]
Dealt to Pluribus [Ks 9c]
Dealt to Eddie [2h 3c]
MrBrown: folds
MrBlue: folds
Pluribus: folds
Eddie: folds
MrPink: folds
Uncalled bet (50) returned to MrOrange
MrOrange collected 100.0 from pot
*** SUMMARY ***
Total pot 100 | Rake 0


PokerStars Hand #114098: Hold'em No Limit (50/100) - 2019/07/12 07:41:38 ET
Table 'Pluribus Session 114' 6-max (Play Money) Seat #6 is the button
Seat 1: MrOrange (10000 in chips)
Seat 2: MrBrown (10000 in chips)
Seat 3: MrBlue (10000 in chips)
Seat 4: Pluribus (10000 in chips)
Seat 5: Eddie (10000 in chips)
Seat 6: MrPink (10000 in chips)
MrOrange: posts small blind 50
MrBrown: posts big blind 100
*** HOLE CARDS ***
Dealt to MrOrange [4c 8c]
Dealt to MrBrown [Th 8s]
Dealt to MrBlue [2s 5d]
Dealt to Pluribus [9c 2h]
Dealt to Eddie [9d 3d]
Dealt to MrPink [2c Jd]
MrBlue: folds
Pluribus: folds
Eddie: folds
MrPink: folds
MrOrange: folds
Uncalled bet (50) returned to MrBrown
MrBrown collected 100.0 from pot
*** SUMMARY ***
Total pot 100 | Rake 0


PokerStars Hand #114099: Hold'em No Limit (50/100) - 2019/07/12 07:41:39 ET
Table 'Pluribus Session 114' 6-max (Play Money) Seat #6 is the button
Seat 1: MrBrown (10000 in chips)
Seat 2: MrBlue (10000 in chips)
Seat 3: Pluribus (10000 in chips)
Seat 4: Eddie (10000 in chips)
Seat 5: MrPink (10000 in chips)
Seat 6: MrOrange (10000 in chips)
MrBrown: posts small blind 50
MrBlue: posts big blind 100
*** HOLE CARDS ***
Dealt to MrBrown [4d Qc]
Dealt to MrBlue [Th 9s]
Dealt to Pluribus [Kd 8s]
Dealt to Eddie [3c 8h]
Dealt to MrPink [Ts Qd]
Dealt to MrOrange [3h Kh]
Pluribus: folds
Eddie: folds
MrPink: raises 110 to 210
MrOrange: folds
MrBrown: folds
MrBlue: calls 110
*** FLOP *** [Ac 5h 6s]
MrBlue: checks
MrPink: bets 115
MrBlue: folds
Uncalled bet (115) returned to MrPink
MrPink collected 470.0 from pot
*** SUMMARY ***
Total pot 470 | Rake 0
Board [Ac 5h 6s]


PokerStars Hand #114100: Hold'em No Limit (50/100) - 2019/07/12 07:41:40 ET
Table 'Pluribus Session 114' 6-max (Play Money) Seat #6 is the button
Seat 1: MrBlue (10000 in chips)
Seat 2: Pluribus (10000 in chips)
Seat 3: Eddie (10000 in chips)
Seat 4: MrPink (10000 in chips)
Seat 5: MrOrange (10000 in chips)
Seat 6: MrBrown (10000 in chips)
MrBlue: posts small blind 50
Pluribus: posts big blind 100
*** HOLE CARDS ***
Dealt to MrBlue [Qd 3c]
Dealt to Pluribus [6d Kd]
Dealt to Eddie [8s 9s]
Dealt to MrPink [3d 8d]
Dealt to MrOrange [Ah 9c]
Dealt to MrBrown [4s Td]
Eddie: raises 100 to 200
MrPink: folds
MrOrange: folds
MrBrown: folds
MrBlue: folds
Pluribus: calls 100
*** FLOP *** [8h 5h 5s]
Pluribus: checks
Eddie: checks
*** TURN *** [8h 5h 5s] [As]
Pluribus: checks
Eddie: bets 200
Pluribus: folds
Uncalled bet (200) returned to Eddie
Eddie collected 450.0 from pot
*** SUMMARY ***
Total pot 450 | Rake 0
Board [8h 5h 5s As]


PokerStars Hand #114101: Hold'em No Limit (50/100) - 2019/07/12 07:41:41 ET
Table 'Pluribus Session 114' 6-max (Play Money) Seat #6 is the button
Seat 1: Pluribus (10000 in chips)
Seat 2: Eddie (10000 in chips)
Seat 3: MrPink (10000 in chips)
Seat 4: MrOrange (10000 in chips)
Seat 5: MrBrown (10000 in chips)
Seat 6: MrBlue (10000 in chips)
Pluribus: posts small blind 50
Eddie: posts big blind 100
*** HOLE CARDS ***
Dealt to Pluribus [Jc 8c]
Dealt to Eddie [4h 9h]
Dealt to MrPink [Ac Js]
Dealt to MrOrange [3d Qh]
Dealt to MrBrown [6h 9s]
Dealt to MrBlue [2c 8d]
MrPink: raises 110 to 210
MrOrange: folds
MrBrown: folds
MrBlue: folds
Pluribus: folds
Eddie: calls 110
*** FLOP *** [7s 6s 4s]
Eddie: checks
MrPink: bets 115
Eddie: calls 115
*** TURN *** [7s 6s 4s] [Kd]
Eddie: checks
MrPink: checks
*** RIVER *** [7s 6s 4s] [Kd] [3c]
Eddie: checks
MrPink: checks
*** SHOWDOWN ***
Eddie: shows [4h 9h]
Eddie collected 700.0 from pot
*** SUMMARY ***
Total pot 700 | Rake 0
Board [7s 6s 4s Kd 3c]
Seat 2: Eddie showed [4h 9h] and won (700.0)
Seat 3: MrPink showed [Ac Js] and lost


PokerStars Hand #114102: Hold'em No Limit (50/100) - 2019/07/12 07:41:42 ET
Table 'Pluribus Session 114' 6-max (Play Money) Seat #6 is the button
Seat 1: Eddie (10000 in chips)
Seat 2: MrPink (10000 in chips)
Seat 3: MrOrange (10000 in chips)
Seat 4: MrBrown (10000 in chips)
Seat 5: MrBlue (10000 in chips)
Seat 6: Pluribus (10000 in chips)
Eddie: posts small blind 50
MrPink: posts big blind 100
*** HOLE CARDS ***
Dealt to Eddie [Ah 6d]
Dealt to MrPink [8d Th]
Dealt to MrOrange [5s Js]
Dealt to MrBrown [3h 4h]
Dealt to MrBlue [Ks As]
Dealt to Pluribus [3c Ad]
MrOrange: folds
MrBrown: raises 150 to 250
MrBlue: raises 550 to 800
Pluribus: folds
Eddie: folds
MrPink: folds
MrBrown: folds
Uncalled bet (550) returned to MrBlue
MrBlue collected 650.0 from pot
*** SUMMARY ***
Total pot 650 | Rake 0


PokerStars Hand #114103: Hold'em No Limit (50/100) - 2019/07/12 07:41:43 ET
Table 'Pluribus Session 114' 6-max (Play Money) Seat #6 is the button
Seat 1: MrPink (10000 in chips)
Seat 2: MrOrange (10000 in chips)
Seat 3: MrBrown (10000 in chips)
Seat 4: MrBlue (10000 in chips)
Seat 5: Pluribus (10000 in chips)
Seat 6: Eddie (10000 in chips)
MrPink: posts small blind 50
MrOrange: posts big blind 100
*** HOLE CARDS ***
Dealt to MrPink [8c Th]
Dealt to MrOrange [9h 8s]
Dealt to MrBrown [Jc 2c]
Dealt to MrBlue [5c 9c]
Dealt to Pluribus [3c 5d]
Dealt to Eddie [Kd Qs]
MrBrown: folds
MrBlue: folds
Pluribus: folds
Eddie: raises 125 to 225
MrPink: folds
MrOrange: calls 125
*** FLOP *** [Jd 2d Ks]
MrOrange: checks
Eddie: bets 450
MrOrange: folds
Uncalled bet (450) returned to Eddie
Eddie collected 500.0 from pot
*** SUMMARY ***
Total pot 500 | Rake 0
Board [Jd 2d Ks]


PokerStars Hand #114104: Hold'em No Limit (50/100) - 2019/07/12 07:41:44 ET
Table 'Pluribus Session 114' 6-max (Play Money) Seat #6 is the button
Seat 1: MrOrange (10000 in chips)
Seat 2: MrBrown (10000 in chips)
Seat 3: MrBlue (10000 in chips)
Seat 4: Pluribus (10000 in chips)
Seat 5: Eddie (10000 in chips)
Seat 6: MrPink (10000 in chips)
MrOrange: posts small blind 50
MrBrown: posts big blind 100
*** HOLE CARDS ***
Dealt to MrOrange [6c 8s]
Dealt to MrBrown [5s 2d]
Dealt to MrBlue [6d 2s]
Dealt to Pluribus [6s Ah]
Dealt to Eddie [Th 2h]
Dealt to MrPink [Qc Jd]
MrBlue: folds
Pluribus: folds
Eddie: folds
MrPink: raises 150 to 250
MrOrange: folds
MrBrown: folds
Uncalled bet (150) returned to MrPink
MrPink collected 250.0 from pot
*** SUMMARY ***
Total pot 250 | Rake 0


PokerStars Hand #114105: Hold'em No Limit (50/100) - 2019/07/12 07:41:45 ET
Table 'Pluribus Session 114' 6-max (Play Money) Seat #6 is the button
Seat 1: MrBrown (10000 in chips)
Seat 2: MrBlue (10000 in chips)
Seat 3: Pluribus (10000 in chips)
Seat 4: Eddie (10000 in chips)
Seat 5: MrPink (10000 in chips)
Seat 6: MrOrange (10000 in chips)
MrBrown: posts small blind 50
MrBlue: posts big blind 100
*** HOLE CARDS ***
Dealt to MrBrown [3c 8d]
Dealt to MrBlue [As 4h]
Dealt to Pluribus [Qd 6h]
Dealt to Eddie [6s Ks]
Dealt to MrPink [6d Kc]
Dealt to MrOrange [Th 8c]
Pluribus: folds
Eddie: raises 100 to 200
MrPink: folds
MrOrange: folds
MrBrown: folds
MrBlue: calls 100
*** FLOP *** [7s 2h Ts]
MrBlue: checks
Eddie: bets 135
MrBlue: folds
Uncalled bet (135) returned to Eddie
Eddie collected 450.0 from pot
*** SUMMARY ***
Total pot 450 | Rake 0
Board [7s 2h Ts]


PokerStars Hand #114106: Hold'em No Limit (50/100) - 2019/07/12 07:41:46 ET
Table 'Pluribus Session 114' 6-max (Play Money) Seat #6 is the button
Seat 1: MrBlue (10000 in chips)
Seat 2: Pluribus (10000 in chips)
Seat 3: Eddie (10000 in chips)
Seat 4: MrPink (10000 in chips)
Seat 5: MrOrange (10000 in chips)
Seat 6: MrBrown (10000 in chips)
MrBlue: posts small blind 50
Pluribus: posts big blind 100
*** HOLE CARDS ***
Dealt to MrBlue [Js As]
Dealt to Pluribus [3h 3c]
Dealt to Eddie [Ad 7s]
Dealt to MrPink [Kc 2h]
Dealt to MrOrange [2s 3d]
Dealt to MrBrown [6d 6s]
Eddie: folds
MrPink: folds
MrOrange: folds
MrBrown: raises 175 to 275
MrBlue: raises 1030 to 1305
Pluribus: folds
MrBrown: folds
Uncalled bet (1030) returned to MrBlue
MrBlue collected 650.0 from pot
*** SUMMARY ***
Total pot 650 | Rake 0


PokerStars Hand #114107: Hold'em No Limit (50/100) - 2019/07/12 07:41:47 ET
Table 'Pluribus Session 114' 6-max (Play Money) Seat #6 is the button
Seat 1: Pluribus (10000 in chips)
Seat 2: Eddie (10000 in chips)
Seat 3: MrPink (10000 in chips)
Seat 4: MrOrange (10000 in chips)
Seat 5: MrBrown (10000 in chips)
Seat 6: MrBlue (10000 in chips)
Pluribus: posts small blind 50
Eddie: posts big blind 100
*** HOLE CARDS ***
Dealt to Pluribus [Jh 3d]
Dealt to Eddie [Kc 4h]
Dealt to MrPink [Ac 2s]
Dealt to MrOrange [Kd 4c]
Dealt to MrBrown [8s 2c]
Dealt to MrBlue [Qh Tc]
MrPink: folds
MrOrange: folds
MrBrown: folds
MrBlue: raises 125 to 225
Pluribus: folds
Eddie: calls 125
*** FLOP *** [Js 3s 8c]
Eddie: checks
MrBlue: checks
*** TURN *** [Js 3s 8c] [Ah]
Eddie: checks
MrBlue: bets 375
Eddie: folds
Uncalled bet (375) returned to MrBlue
MrBlue collected 500.0 from pot
*** SUMMARY ***
Total pot 500 | Rake 0
Board [Js 3s 8c Ah]


PokerStars Hand #114108: Hold'em No Limit (50/100) - 2019/07/12 07:41:48 ET
Table 'Pluribus Session 114' 6-max (Play Money) Seat #6 is the button
Seat 1: Eddie (10000 in chips)
Seat 2: MrPink (10000 in chips)
Seat 3: MrOrange (10000 in chips)
Seat 4: MrBrown (10000 in chips)
Seat 5: MrBlue (10000 in chips)
Seat 6: Pluribus (10000 in chips)
Eddie: posts small blind 50
MrPink: posts big blind 100
*** HOLE CARDS ***
Dealt to Eddie [9s 2c]
Dealt to MrPink [8d 8c]
Dealt to MrOrange [5h 9c]
Dealt to MrBrown [8s Jc]
Dealt to MrBlue [8h Qh]
Dealt to Pluribus [5s 3h]
MrOrange: folds
MrBrown: folds
MrBlue: raises 125 to 225
Pluribus: folds
Eddie: folds
MrPink: calls 125
*** FLOP *** [Kc 9d Qd]
MrPink: checks
MrBlue: checks
*** TURN *** [Kc 9d Qd] [As]
MrPink: checks
MrBlue: checks
*** RIVER *** [Kc 9d Qd] [As] [7s]
MrPink: checks
MrBlue: checks
*** SHOWDOWN ***
MrBlue: shows [8h Qh]
MrBlue collected 500.0 from pot
*** SUMMARY ***
Total pot 500 | Rake 0
Board [Kc 9d Qd As 7s]
Seat 2: MrPink showed [8d 8c] and lost
Seat 5: MrBlue showed [8h Qh] and won (500.0)


PokerStars Hand #114109: Hold'em No Limit (50/100) - 2019/07/12 07:41:49 ET
Table 'Pluribus Session 114' 6-max (Play Money) Seat #6 is the button
Seat 1: MrPink (10000 in chips)
Seat 2: MrOrange (10000 in chips)
Seat 3: MrBrown (10000 in chips)
Seat 4: MrBlue (10000 in chips)
Seat 5: Pluribus (10000 in chips)
Seat 6: Eddie (10000 in chips)
MrPink: posts small blind 50
MrOrange: posts big blind 100
*** HOLE CARDS ***
Dealt to MrPink [3h As]
Dealt to MrOrange [5s 7h]
Dealt to MrBrown [6d 3d]
Dealt to MrBlue [5h 6s]
Dealt to Pluribus [7d 8h]
Dealt to Eddie [Ts Qd]
MrBrown: folds
MrBlue: folds
Pluribus: folds
Eddie: raises 125 to 225
MrPink: folds
MrOrange: folds
Uncalled bet (125) returned to Eddie
Eddie collected 250.0 from pot
*** SUMMARY ***
Total pot 250 | Rake 0


PokerStars Hand #114110: Hold'em No Limit (50/100) - 2019/07/12 07:41:50 ET
Table 'Pluribus Session 114' 6-max (Play Money) Seat #6 is the button
Seat 1: MrOrange (10000 in chips)
Seat 2: MrBrown (10000 in chips)
Seat 3: MrBlue (10000 in chips)
Seat 4: Pluribus (10000 in chips)
Seat 5: Eddie (10000 in chips)
Seat 6: MrPink (10000 in chips)
MrOrange: posts small blind 50
MrBrown: posts big blind 100
*** HOLE CARDS ***
Dealt to MrOrange [6s 8h]
Dealt to MrBrown [8s As]
Dealt to MrBlue [Ad Qd]
Dealt to Pluribus [6h Ah]
Dealt to Eddie [4s Jc]
Dealt to MrPink [Jd Jh]
MrBlue: raises 125 to 225
Pluribus: folds
Eddie: folds
MrPink: raises 475 to 700
MrOrange: folds
MrBrown: folds
MrBlue: calls 475
*** FLOP *** [7h 9h Th]
MrBlue: checks
MrPink: bets 350
MrBlue: folds
Uncalled bet (350) returned to MrPink
MrPink collected 1550.0 from pot
*** SUMMARY ***
Total pot 1550 | Rake 0
Board [7h 9h Th]


PokerStars Hand #114111: Hold'em No Limit (50/100) - 2019/07/12 07:41:51 ET
Table 'Pluribus Session 114' 6-max (Play Money) Seat #6 is the button
Seat 1: MrBrown (10000 in chips)
Seat 2: MrBlue (10000 in chips)
Seat 3: Pluribus (10000 in chips)
Seat 4: Eddie (10000 in chips)
Seat 5: MrPink (10000 in chips)
Seat 6: MrOrange (10000 in chips)
MrBrown: posts small blind 50
MrBlue: posts big blind 100
*** HOLE CARDS ***
Dealt to MrBrown [8h Kc]
Dealt to MrBlue [8s Th]
Dealt to Pluribus [2h Ad]
Dealt to Eddie [3h Ks]
Dealt to MrPink [3d Tc]
Dealt to MrOrange [Jd 7h]
Pluribus: folds
Eddie: folds
MrPink: folds
MrOrange: folds
MrBrown: calls 50
MrBlue: checks
*** FLOP *** [9c Js Ts]
MrBrown: bets 200
MrBlue: calls 200
*** TURN *** [9c Js Ts] [9d]
MrBrown: checks
MrBlue: checks
*** RIVER *** [9c Js Ts] [9d] [Td]
MrBrown: checks
MrBlue: bets 300
MrBrown: folds
Uncalled bet (300) returned to MrBlue
MrBlue collected 600.0 from pot
*** SUMMARY ***
Total pot 600 | Rake 0
Board [9c Js Ts 9d Td]


PokerStars Hand #114112: Hold'em No Limit (50/100) - 2019/07/12 07:41:52 ET
Table 'Pluribus Session 114' 6-max (Play Money) Seat #6 is the button
Seat 1: MrBlue (10000 in chips)
Seat 2: Pluribus (10000 in chips)
Seat 3: Eddie (10000 in chips)
Seat 4: MrPink (10000 in chips)
Seat 5: MrOrange (10000 in chips)
Seat 6: MrBrown (10000 in chips)
MrBlue: posts small blind 50
Pluribus: posts big blind 100
*** HOLE CARDS ***
Dealt to MrBlue [As Ac]
Dealt to Pluribus [7h 7c]
Dealt to Eddie [6s Th]
Dealt to MrPink [3c 8c]
Dealt to MrOrange [8h 5c]
Dealt to MrBrown [2c 9c]
Eddie: folds
MrPink: folds
MrOrange: folds
MrBrown: folds
MrBlue: calls 50
Pluribus: raises 175 to 275
MrBlue: raises 1100 to 1375
Pluribus: calls 1100
*** FLOP *** [Jd Kd 3s]
MrBlue: bets 1375
Pluribus: folds
Uncalled bet (1375) returned to MrBlue
MrBlue collected 2750.0 from pot
*** SUMMARY ***
Total pot 2750 | Rake 0
Board [Jd Kd 3s]


PokerStars Hand #114113: Hold'em No Limit (50/100) - 2019/07/12 07:41:53 ET
Table 'Pluribus Session 114' 6-max (Play Money) Seat #6 is the button
Seat 1: Pluribus (10000 in chips)
Seat 2: Eddie (10000 in chips)
Seat 3: MrPink (10000 in chips)
Seat 4: MrOrange (10000 in chips)
Seat 5: MrBrown (10000 in chips)
Seat 6: MrBlue (10000 in chips)
Pluribus: posts small blind 50
Eddie: posts big blind 100
*** HOLE CARDS ***
Dealt to Pluribus [8d Qc]
Dealt to Eddie [6d 7h]
Dealt to MrPink [5d 4s]
Dealt to MrOrange [9d Jc]
Dealt to MrBrown [6h 2s]
Dealt to MrBlue [Jd Kc]
MrPink: folds
MrOrange: folds
MrBrown: folds
MrBlue: raises 125 to 225
Pluribus: folds
Eddie: calls 125
*** FLOP *** [Ad As Jh]
Eddie: checks
MrBlue: bets 200
Eddie: folds
Uncalled bet (200) returned to MrBlue
MrBlue collected 500.0 from pot
*** SUMMARY ***
Total pot 500 | Rake 0
Board [Ad As Jh]


PokerStars Hand #114114: Hold'em No Limit (50/100) - 2019/07/12 07:41:54 ET
Table 'Pluribus Session 114' 6-max (Play Money) Seat #6 is the button
Seat 1: Eddie (10000 in chips)
Seat 2: MrPink (10000 in chips)
Seat 3: MrOrange (10000 in chips)
Seat 4: MrBrown (10000 in chips)
Seat 5: MrBlue (10000 in chips)
Seat 6: Pluribus (10000 in chips)
Eddie: posts small blind 50
MrPink: posts big blind 100
*** HOLE CARDS ***
Dealt to Eddie [6d 5c]
Dealt to MrPink [Ah 2h]
Dealt to MrOrange [7d Th]
Dealt to MrBrown [Kd 3s]
Dealt to MrBlue [4d 8d]
Dealt to Pluribus [4c Qh]
MrOrange: folds
MrBrown: folds
MrBlue: folds
Pluribus: folds
Eddie: folds
Uncalled bet (50) returned to MrPink
MrPink collected 100.0 from pot
*** SUMMARY ***
Total pot 100 | Rake 0


PokerStars Hand #114115: Hold'em No Limit (50/100) - 2019/07/12 07:41:55 ET
Table 'Pluribus Session 114' 6-max (Play Money) Seat #6 is the button
Seat 1: MrPink (10000 in chips)
Seat 2: MrOrange (10000 in chips)
Seat 3: MrBrown (10000 in chips)
Seat 4: MrBlue (10000 in chips)
Seat 5: Pluribus (10000 in chips)
Seat 6: Eddie (10000 in chips)
MrPink: posts small blind 50
MrOrange: posts big blind 100
*** HOLE CARDS ***
Dealt to MrPink [Jc 7c]
Dealt to MrOrange [Jd Jh]
Dealt to MrBrown [Js 3h]
Dealt to MrBlue [Th 5c]
Dealt to Pluribus [6s 8d]
Dealt to Eddie [Qs 4s]
MrBrown: folds
MrBlue: folds
Pluribus: folds
Eddie: raises 125 to 225
MrPink: folds
MrOrange: raises 975 to 1200
Eddie: folds
Uncalled bet (975) returned to MrOrange
MrOrange collected 500.0 from pot
*** SUMMARY ***
Total pot 500 | Rake 0


PokerStars Hand #114116: Hold'em No Limit (50/100) - 2019/07/12 07:41:56 ET
Table 'Pluribus Session 114' 6-max (Play Money) Seat #6 is the button
Seat 1: MrOrange (10000 in chips)
Seat 2: MrBrown (10000 in chips)
Seat 3: MrBlue (10000 in chips)
Seat 4: Pluribus (10000 in chips)
Seat 5: Eddie (10000 in chips)
Seat 6: MrPink (10000 in chips)
MrOrange: posts small blind 50
MrBrown: posts big blind 100
*** HOLE CARDS ***
Dealt to MrOrange [5c 3d]
Dealt to MrBrown [Tc 4s]
Dealt to MrBlue [5d Qd]
Dealt to Pluribus [6c 8h]
Dealt to Eddie [7h 6h]
Dealt to MrPink [2s 3s]
MrBlue: folds
Pluribus: folds
Eddie: raises 110 to 210
MrPink: folds
MrOrange: folds
MrBrown: folds
Uncalled bet (110) returned to Eddie
Eddie collected 250.0 from pot
*** SUMMARY ***
Total pot 250 | Rake 0


PokerStars Hand #114117: Hold'em No Limit (50/100) - 2019/07/12 07:41:57 ET
Table 'Pluribus Session 114' 6-max (Play Money) Seat #6 is the button
Seat 1: MrBrown (10000 in chips)
Seat 2: MrBlue (10000 in chips)
Seat 3: Pluribus (10000 in chips)
Seat 4: Eddie (10000 in chips)
Seat 5: MrPink (10000 in chips)
Seat 6: MrOrange (10000 in chips)
MrBrown: posts small blind 50
MrBlue: posts big blind 100
*** HOLE CARDS ***
Dealt to MrBrown [Ac Jh]
Dealt to MrBlue [Jc 4h]
Dealt to Pluribus [Ah Kh]
Dealt to Eddie [3s Qh]
Dealt to MrPink [5h 3h]
Dealt to MrOrange [Tc As]
Pluribus: raises 100 to 200
Eddie: folds
MrPink: folds
MrOrange: folds
MrBrown: calls 150
MrBlue: folds
*** FLOP *** [7s Th 4d]
MrBrown: checks
Pluribus: checks
*** TURN *** [7s Th 4d] [9h]
MrBrown: checks
Pluribus: checks
*** RIVER *** [7s Th 4d] [9h] [8d]
MrBrown: bets 250
Pluribus: folds
Uncalled bet (250) returned to MrBrown
MrBrown collected 500.0 from pot
*** SUMMARY ***
Total pot 500 | Rake 0
Board [7s Th 4d 9h 8d]


PokerStars Hand #114118: Hold'em No Limit (50/100) - 2019/07/12 07:41:58 ET
Table 'Pluribus Session 114' 6-max (Play Money) Seat #6 is the button
Seat 1: MrBlue (10000 in chips)
Seat 2: Pluribus (10000 in chips)
Seat 3: Eddie (10000 in chips)
Seat 4: MrPink (10000 in chips)
Seat 5: MrOrange (10000 in chips)
Seat 6: MrBrown (10000 in chips)
MrBlue: posts small blind 50
Pluribus: posts big blind 100
*** HOLE CARDS ***
Dealt to MrBlue [2d 7s]
Dealt to Pluribus [4h Ks]
Dealt to Eddie [4d 5c]
Dealt to MrPink [2c Js]
Dealt to MrOrange [Ts 3c]
Dealt to MrBrown [6h 9h]
Eddie: folds
MrPink: folds
MrOrange: folds
MrBrown: raises 175 to 275
MrBlue: folds
Pluribus: folds
Uncalled bet (175) returned to MrBrown
MrBrown collected 250.0 from pot
*** SUMMARY ***
Total pot 250 | Rake 0


PokerStars Hand #114119: Hold'em No Limit (50/100) - 2019/07/12 07:41:59 ET
Table 'Pluribus Session 114' 6-max (Play Money) Seat #6 is the button
Seat 1: Pluribus (10000 in chips)
Seat 2: Eddie (10000 in chips)
Seat 3: MrPink (10000 in chips)
Seat 4: MrOrange (10000 in chips)
Seat 5: MrBrown (10000 in chips)
Seat 6: MrBlue (10000 in chips)
Pluribus: posts small blind 50
Eddie: posts big blind 100
*** HOLE CARDS ***
Dealt to Pluribus [Tc Th]
Dealt to Eddie [7h 2d]
Dealt to MrPink [Ad 5h]
Dealt to MrOrange [6h 6s]
Dealt to MrBrown [Qs 2c]
Dealt to MrBlue [2s 5c]
MrPink: folds
MrOrange: raises 105 to 205
MrBrown: folds
MrBlue: folds
Pluribus: raises 745 to 950
Eddie: folds
MrOrange: calls 745
*** FLOP *** [6d Qc Kd]
Pluribus: bets 1000
MrOrange: raises 1725 to 2725
Pluribus: folds
Uncalled bet (1725) returned to MrOrange
MrOrange collected 4000.0 from pot
*** SUMMARY ***
Total pot 4000 | Rake 0
Board [6d Qc Kd]


PokerStars Hand #114120: Hold'em No Limit (50/100) - 2019/07/12 07:42:00 ET
Table 'Pluribus Session 114' 6-max (Play Money) Seat #6 is the button
Seat 1: Eddie (10000 in chips)
Seat 2: MrPink (10000 in chips)
Seat 3: MrOrange (10000 in chips)
Seat 4: MrBrown (10000 in chips)
Seat 5: MrBlue (10000 in chips)
Seat 6: Pluribus (10000 in chips)
Eddie: posts small blind 50
MrPink: posts big blind 100
*** HOLE CARDS ***
Dealt to Eddie [Th 8h]
Dealt to MrPink [7d 6d]
Dealt to MrOrange [7h As]
Dealt to MrBrown [Qc Kc]
Dealt to MrBlue [Ad 6h]
Dealt to Pluribus [4s Jd]
MrOrange: folds
MrBrown: raises 150 to 250
MrBlue: folds
Pluribus: folds
Eddie: folds
MrPink: calls 150
*** FLOP *** [2h Qh 5c]
MrPink: checks
MrBrown: bets 275
MrPink: folds
Uncalled bet (275) returned to MrBrown
MrBrown collected 550.0 from pot
*** SUMMARY ***
Total pot 550 | Rake 0
Board [2h Qh 5c]


PokerStars Hand #114121: Hold'em No Limit (50/100) - 2019/07/12 07:42:01 ET
Table 'Pluribus Session 114' 6-max (Play Money) Seat #6 is the button
Seat 1: MrPink (10000 in chips)
Seat 2: MrOrange (10000 in chips)
Seat 3: MrBrown (10000 in chips)
Seat 4: MrBlue (10000 in chips)
Seat 5: Pluribus (10000 in chips)
Seat 6: Eddie (10000 in chips)
MrPink: posts small blind 50
MrOrange: posts big blind 100
*** HOLE CARDS ***
Dealt to MrPink [Ks 3c]
Dealt to MrOrange [9s As]
Dealt to MrBrown [Qc 2h]
Dealt to MrBlue [Th 6c]
Dealt to Pluribus [9c 3s]
Dealt to Eddie [Ac 3h]
MrBrown: folds
MrBlue: folds
Pluribus: folds
Eddie: folds
MrPink: folds
Uncalled bet (50) returned to MrOrange
MrOrange collected 100.0 from pot
*** SUMMARY ***
Total pot 100 | Rake 0


PokerStars Hand #114122: Hold'em No Limit (50/100) - 2019/07/12 07:42:02 ET
Table 'Pluribus Session 114' 6-max (Play Money) Seat #6 is the button
Seat 1: MrOrange (10000 in chips)
Seat 2: MrBrown (10000 in chips)
Seat 3: MrBlue (10000 in chips)
Seat 4: Pluribus (10000 in chips)
Seat 5: Eddie (10000 in chips)
Seat 6: MrPink (10000 in chips)
MrOrange: posts small blind 50
MrBrown: posts big blind 100
*** HOLE CARDS ***
Dealt to MrOrange [9s 7s]
Dealt to MrBrown [Ks 4d]
Dealt to MrBlue [2c 8d]
Dealt to Pluribus [Kd 5c]
Dealt to Eddie [4h 2h]
Dealt to MrPink [Th 3s]
MrBlue: folds
Pluribus: folds
Eddie: folds
MrPink: folds
MrOrange: raises 150 to 250
MrBrown: calls 150
*** FLOP *** [8s 4c Qd]
MrOrange: bets 150
MrBrown: calls 150
*** TURN *** [8s 4c Qd] [6c]
MrOrange: bets 550
MrBrown: folds
Uncalled bet (550) returned to MrOrange
MrOrange collected 800.0 from pot
*** SUMMARY ***
Total pot 800 | Rake 0
Board [8s 4c Qd 6c]


PokerStars Hand #114123: Hold'em No Limit (50/100) - 2019/07/12 07:42:03 ET
Table 'Pluribus Session 114' 6-max (Play Money) Seat #6 is the button
Seat 1: MrBrown (10000 in chips)
Seat 2: MrBlue (10000 in chips)
Seat 3: Pluribus (10000 in chips)
Seat 4: Eddie (10000 in chips)
Seat 5: MrPink (10000 in chips)
Seat 6: MrOrange (10000 in chips)
MrBrown: posts small blind 50
MrBlue: posts big blind 100
*** HOLE CARDS ***
Dealt to MrBrown [Ks 9h]
Dealt to MrBlue [9d Jh]
Dealt to Pluribus [4d Ac]
Dealt to Eddie [8c 6h]
Dealt to MrPink [4h 8d]
Dealt to MrOrange [Qd Tc]
Pluribus: folds
Eddie: folds
MrPink: folds
MrOrange: raises 125 to 225
MrBrown: folds
MrBlue: calls 125
*** FLOP *** [2h Td Jd]
MrBlue: checks
MrOrange: checks
*** TURN *** [2h Td Jd] [Th]
MrBlue: checks
MrOrange: bets 375
MrBlue: calls 375
*** RIVER *** [2h Td Jd] [Th] [As]
MrBlue: checks
MrOrange: bets 1250
MrBlue: folds
Uncalled bet (1250) returned to MrOrange
MrOrange collected 1250.0 from pot
*** SUMMARY ***
Total pot 1250 | Rake 0
Board [2h Td Jd Th As]


PokerStars Hand #114124: Hold'em No Limit (50/100) - 2019/07/12 07:42:04 ET
Table 'Pluribus Session 114' 6-max (Play Money) Seat #6 is the button
Seat 1: MrBlue (10000 in chips)
Seat 2: Pluribus (10000 in chips)
Seat 3: Eddie (10000 in chips)
Seat 4: MrPink (10000 in chips)
Seat 5: MrOrange (10000 in chips)
Seat 6: MrBrown (10000 in chips)
MrBlue: posts small blind 50
Pluribus: posts big blind 100
*** HOLE CARDS ***
Dealt to MrBlue [5c 9h]
Dealt to Pluribus [8s 5h]
Dealt to Eddie [Ts Qd]
Dealt to MrPink [Ac Ah]
Dealt to MrOrange [Td 8c]
Dealt to MrBrown [7s 2c]
Eddie: folds
MrPink: raises 110 to 210
MrOrange: folds
MrBrown: folds
MrBlue: folds
Pluribus: folds
Uncalled bet (110) returned to MrPink
MrPink collected 250.0 from pot
*** SUMMARY ***
Total pot 250 | Rake 0


PokerStars Hand #114125: Hold'em No Limit (50/100) - 2019/07/12 07:42:05 ET
Table 'Pluribus Session 114' 6-max (Play Money) Seat #6 is the button
Seat 1: Pluribus (10000 in chips)
Seat 2: Eddie (10000 in chips)
Seat 3: MrPink (10000 in chips)
Seat 4: MrOrange (10000 in chips)
Seat 5: MrBrown (10000 in chips)
Seat 6: MrBlue (10000 in chips)
Pluribus: posts small blind 50
Eddie: posts big blind 100
*** HOLE CARDS ***
Dealt to Pluribus [As Qc]
Dealt to Eddie [3s 9s]
Dealt to MrPink [4c 6d]
Dealt to MrOrange [Qs 7h]
Dealt to MrBrown [2c 8h]
Dealt to MrBlue [Qh 6s]
MrPink: folds
MrOrange: folds
MrBrown: folds
MrBlue: folds
Pluribus: raises 175 to 275
Eddie: calls 175
*** FLOP *** [Ad 2h 8d]
Pluribus: bets 275
Eddie: folds
Uncalled bet (275) returned to Pluribus
Pluribus collected 550.0 from pot
*** SUMMARY ***
Total pot 550 | Rake 0
Board [Ad 2h 8d]


PokerStars Hand #114126: Hold'em No Limit (50/100) - 2019/07/12 07:42:06 ET
Table 'Pluribus Session 114' 6-max (Play Money) Seat #6 is the button
Seat 1: Eddie (10000 in chips)
Seat 2: MrPink (10000 in chips)
Seat 3: MrOrange (10000 in chips)
Seat 4: MrBrown (10000 in chips)
Seat 5: MrBlue (10000 in chips)
Seat 6: Pluribus (10000 in chips)
Eddie: posts small blind 50
MrPink: posts big blind 100
*** HOLE CARDS ***
Dealt to Eddie [7c Jh]
Dealt to MrPink [Ks 6c]
Dealt to MrOrange [5h 2c]
Dealt to MrBrown [Th 6d]
Dealt to MrBlue [7h 7d]
Dealt to Pluribus [3d 4s]
MrOrange: folds
MrBrown: folds
MrBlue: raises 125 to 225
Pluribus: folds
Eddie: folds
MrPink: folds
Uncalled bet (125) returned to MrBlue
MrBlue collected 250.0 from pot
*** SUMMARY ***
Total pot 250 | Rake 0


PokerStars Hand #114127: Hold'em No Limit (50/100) - 2019/07/12 07:42:07 ET
Table 'Pluribus Session 114' 6-max (Play Money) Seat #6 is the button
Seat 1: MrPink (10000 in chips)
Seat 2: MrOrange (10000 in chips)
Seat 3: MrBrown (10000 in chips)
Seat 4: MrBlue (10000 in chips)
Seat 5: Pluribus (10000 in chips)
Seat 6: Eddie (10000 in chips)
MrPink: posts small blind 50
MrOrange: posts big blind 100
*** HOLE CARDS ***
Dealt to MrPink [6s Ks]
Dealt to MrOrange [6h 7h]
Dealt to MrBrown [Js Jd]
Dealt to MrBlue [5h Ah]
Dealt to Pluribus [6c 9s]
Dealt to Eddie [2h 8c]
MrBrown: raises 125 to 225
MrBlue: raises 500 to 725
Pluribus: folds
Eddie: folds
MrPink: folds
MrOrange: folds
MrBrown: calls 500
*** FLOP *** [8s Qs Jh]
MrBrown: checks
MrBlue: checks
*** TURN *** [8s Qs Jh] [Ad]
MrBrown: bets 1200
MrBlue: folds
Uncalled bet (1200) returned to MrBrown
MrBrown collected 1600.0 from pot
*** SUMMARY ***
Total pot 1600 | Rake 0
Board [8s Qs Jh Ad]


PokerStars Hand #114128: Hold'em No Limit (50/100) - 2019/07/12 07:42:08 ET
Table 'Pluribus Session 114' 6-max (Play Money) Seat #6 is the button
Seat 1: MrOrange (10000 in chips)
Seat 2: MrBrown (10000 in chips)
Seat 3: MrBlue (10000 in chips)
Seat 4: Pluribus (10000 in chips)
Seat 5: Eddie (10000 in chips)
Seat 6: MrPink (10000 in chips)
MrOrange: posts small blind 50
MrBrown: posts big blind 100
*** HOLE CARDS ***
Dealt to MrOrange [Jh 6d]
Dealt to MrBrown [3h 2h]
Dealt to MrBlue [9s Jd]
Dealt to Pluribus [9c 4s]
Dealt to Eddie [2c 7d]
Dealt to MrPink [As 8c]
MrBlue: folds
Pluribus: folds
Eddie: folds
MrPink: raises 150 to 250
MrOrange: folds
MrBrown: raises 650 to 900
MrPink: folds
Uncalled bet (650) returned to MrBrown
MrBrown collected 550.0 from pot
*** SUMMARY ***
Total pot 550 | Rake 0


PokerStars Hand #114129: Hold'em No Limit (50/100) - 2019/07/12 07:42:09 ET
Table 'Pluribus Session 114' 6-max (Play Money) Seat #6 is the button
Seat 1: MrBrown (10000 in chips)
Seat 2: MrBlue (10000 in chips)
Seat 3: Pluribus (10000 in chips)
Seat 4: Eddie (10000 in chips)
Seat 5: MrPink (10000 in chips)
Seat 6: MrOrange (10000 in chips)
MrBrown: posts small blind 50
MrBlue: posts big blind 100
*** HOLE CARDS ***
Dealt to MrBrown [5s 4h]
Dealt to MrBlue [3c Jh]
Dealt to Pluribus [3s 8d]
Dealt to Eddie [6s 7c]
Dealt to MrPink [9s 6h]
Dealt to MrOrange [Js 8h]
Pluribus: folds
Eddie: folds
MrPink: folds
MrOrange: folds
MrBrown: folds
Uncalled bet (50) returned to MrBlue
MrBlue collected 100.0 from pot
*** SUMMARY ***
Total pot 100 | Rake 0


PokerStars Hand #114130: Hold'em No Limit (50/100) - 2019/07/12 07:42:10 ET
Table 'Pluribus Session 114' 6-max (Play Money) Seat #6 is the button
Seat 1: MrBlue (10000 in chips)
Seat 2: Pluribus (10000 in chips)
Seat 3: Eddie (10000 in chips)
Seat 4: MrPink (10000 in chips)
Seat 5: MrOrange (10000 in chips)
Seat 6: MrBrown (10000 in chips)
MrBlue: posts small blind 50
Pluribus: posts big blind 100
*** HOLE CARDS ***
Dealt to MrBlue [9h Ks]
Dealt to Pluribus [As 3d]
Dealt to Eddie [Td Kh]
Dealt to MrPink [3s Ad]
Dealt to MrOrange [2s Tc]
Dealt to MrBrown [Js 8s]
Eddie: folds
MrPink: folds
MrOrange: folds
MrBrown: raises 175 to 275
MrBlue: folds
Pluribus: folds
Uncalled bet (175) returned to MrBrown
MrBrown collected 250.0 from pot
*** SUMMARY ***
Total pot 250 | Rake 0


PokerStars Hand #114131: Hold'em No Limit (50/100) - 2019/07/12 07:42:11 ET
Table 'Pluribus Session 114' 6-max (Play Money) Seat #6 is the button
Seat 1: Pluribus (10000 in chips)
Seat 2: Eddie (10000 in chips)
Seat 3: MrPink (10000 in chips)
Seat 4: MrOrange (10000 in chips)
Seat 5: MrBrown (10000 in chips)
Seat 6: MrBlue (10000 in chips)
Pluribus: posts small blind 50
Eddie: posts big blind 100
*** HOLE CARDS ***
Dealt to Pluribus [Qc Ah]
Dealt to Eddie [3s 8h]
Dealt to MrPink [6d 5s]
Dealt to MrOrange [Th Kh]
Dealt to MrBrown [As 3h]
Dealt to MrBlue [3c Qs]
MrPink: folds
MrOrange: raises 105 to 205
MrBrown: folds
MrBlue: folds
Pluribus: raises 620 to 825
Eddie: folds
MrOrange: folds
Uncalled bet (620) returned to Pluribus
Pluribus collected 510.0 from pot
*** SUMMARY ***
Total pot 510 | Rake 0


PokerStars Hand #114132: Hold'em No Limit (50/100) - 2019/07/12 07:42:12 ET
Table 'Pluribus Session 114' 6-max (Play Money) Seat #6 is the button
Seat 1: Eddie (10000 in chips)
Seat 2: MrPink (10000 in chips)
Seat 3: MrOrange (10000 in chips)
Seat 4: MrBrown (10000 in chips)
Seat 5: MrBlue (10000 in chips)
Seat 6: Pluribus (10000 in chips)
Eddie: posts small blind 50
MrPink: posts big blind 100
*** HOLE CARDS ***
Dealt to Eddie [3d 9h]
Dealt to MrPink [Kh 4c]
Dealt to MrOrange [3s 2s]
Dealt to MrBrown [7c 4d]
Dealt to MrBlue [7h Ah]
Dealt to Pluribus [4s 9s]
MrOrange: folds
MrBrown: folds
MrBlue: raises 125 to 225
Pluribus: folds
Eddie: folds
MrPink: folds
Uncalled bet (125) returned to MrBlue
MrBlue collected 250.0 from pot
*** SUMMARY ***
Total pot 250 | Rake 0


PokerStars Hand #114133: Hold'em No Limit (50/100) - 2019/07/12 07:42:13 ET
Table 'Pluribus Session 114' 6-max (Play Money) Seat #6 is the button
Seat 1: MrPink (10000 in chips)
Seat 2: MrOrange (10000 in chips)
Seat 3: MrBrown (10000 in chips)
Seat 4: MrBlue (10000 in chips)
Seat 5: Pluribus (10000 in chips)
Seat 6: Eddie (10000 in chips)
MrPink: posts small blind 50
MrOrange: posts big blind 100
*** HOLE CARDS ***
Dealt to MrPink [Td 4d]
Dealt to MrOrange [9s 5d]
Dealt to MrBrown [5h 8d]
Dealt to MrBlue [5c Ts]
Dealt to Pluribus [7s 9h]
Dealt to Eddie [2c 8c]
MrBrown: folds
MrBlue: folds
Pluribus: folds
Eddie: folds
MrPink: calls 50
MrOrange: raises 275 to 375
MrPink: folds
Uncalled bet (275) returned to MrOrange
MrOrange collected 200.0 from pot
*** SUMMARY ***
Total pot 200 | Rake 0


PokerStars Hand #114134: Hold'em No Limit (50/100) - 2019/07/12 07:42:14 ET
Table 'Pluribus Session 114' 6-max (Play Money) Seat #6 is the button
Seat 1: MrOrange (10000 in chips)
Seat 2: MrBrown (10000 in chips)
Seat 3: MrBlue (10000 in chips)
Seat 4: Pluribus (10000 in chips)
Seat 5: Eddie (10000 in chips)
Seat 6: MrPink (10000 in chips)
MrOrange: posts small blind 50
MrBrown: posts big blind 100
*** HOLE CARDS ***
Dealt to MrOrange [6h 6c]
Dealt to MrBrown [Ks 7c]
Dealt to MrBlue [Qc 5s]
Dealt to Pluribus [Th 8h]
Dealt to Eddie [Ts 9c]
Dealt to MrPink [2h 5d]
MrBlue: folds
Pluribus: raises 125 to 225
Eddie: folds
MrPink: folds
MrOrange: calls 175
MrBrown: folds
*** FLOP *** [8d Ad Ac]
MrOrange: checks
Pluribus: checks
*** TURN *** [8d Ad Ac] [4c]
MrOrange: checks
Pluribus: bets 137
MrOrange: calls 137
*** RIVER *** [8d Ad Ac] [4c] [Js]
MrOrange: checks
Pluribus: checks
*** SHOWDOWN ***
Pluribus: shows [Th 8h]
Pluribus collected 824.0 from pot
*** SUMMARY ***
Total pot 824 | Rake 0
Board [8d Ad Ac 4c Js]
Seat 1: MrOrange showed [6h 6c] and lost
Seat 4: Pluribus showed [Th 8h] and won (824.0)


PokerStars Hand #114135: Hold'em No Limit (50/100) - 2019/07/12 07:42:15 ET
Table 'Pluribus Session 114' 6-max (Play Money) Seat #6 is the button
Seat 1: MrBrown (10000 in chips)
Seat 2: MrBlue (10000 in chips)
Seat 3: Pluribus (10000 in chips)
Seat 4: Eddie (10000 in chips)
Seat 5: MrPink (10000 in chips)
Seat 6: MrOrange (10000 in chips)
MrBrown: posts small blind 50
MrBlue: posts big blind 100
*** HOLE CARDS ***
Dealt to MrBrown [6d 3s]
Dealt to MrBlue [9h Jc]
Dealt to Pluribus [Js 9d]
Dealt to Eddie [7s Ts]
Dealt to MrPink [Jh 8c]
Dealt to MrOrange [2s Kd]
Pluribus: folds
Eddie: raises 100 to 200
MrPink: folds
MrOrange: folds
MrBrown: folds
MrBlue: calls 100
*** FLOP *** [4h Ah 7d]
MrBlue: checks
Eddie: checks
*** TURN *** [4h Ah 7d] [Qh]
MrBlue: checks
Eddie: checks
*** RIVER *** [4h Ah 7d] [Qh] [9c]
MrBlue: checks
Eddie: checks
*** SHOWDOWN ***
MrBlue: shows [9h Jc]
MrBlue collected 450.0 from pot
*** SUMMARY ***
Total pot 450 | Rake 0
Board [4h Ah 7d Qh 9c]
Seat 2: MrBlue showed [9h Jc] and won (450.0)
Seat 4: Eddie showed [7s Ts] and lost


PokerStars Hand #114136: Hold'em No Limit (50/100) - 2019/07/12 07:42:16 ET
Table 'Pluribus Session 114' 6-max (Play Money) Seat #6 is the button
Seat 1: MrBlue (10000 in chips)
Seat 2: Pluribus (10000 in chips)
Seat 3: Eddie (10000 in chips)
Seat 4: MrPink (10000 in chips)
Seat 5: MrOrange (10000 in chips)
Seat 6: MrBrown (10000 in chips)
MrBlue: posts small blind 50
Pluribus: posts big blind 100
*** HOLE CARDS ***
Dealt to MrBlue [4c Ks]
Dealt to Pluribus [Td Jh]
Dealt to Eddie [3c Ts]
Dealt to MrPink [3s 6d]
Dealt to MrOrange [5d 9h]
Dealt to MrBrown [4h 8d]
Eddie: folds
MrPink: folds
MrOrange: folds
MrBrown: folds
MrBlue: folds
Uncalled bet (50) returned to Pluribus
Pluribus collected 100.0 from pot
*** SUMMARY ***
Total pot 100 | Rake 0


PokerStars Hand #114137: Hold'em No Limit (50/100) - 2019/07/12 07:42:17 ET
Table 'Pluribus Session 114' 6-max (Play Money) Seat #6 is the button
Seat 1: Pluribus (10000 in chips)
Seat 2: Eddie (10000 in chips)
Seat 3: MrPink (10000 in chips)
Seat 4: MrOrange (10000 in chips)
Seat 5: MrBrown (10000 in chips)
Seat 6: MrBlue (10000 in chips)
Pluribus: posts small blind 50
Eddie: posts big blind 100
*** HOLE CARDS ***
Dealt to Pluribus [2h 5h]
Dealt to Eddie [As 8d]
Dealt to MrPink [Ah 9h]
Dealt to MrOrange [7c 7s]
Dealt to MrBrown [6d 8h]
Dealt to MrBlue [6h Td]
MrPink: raises 110 to 210
MrOrange: calls 210
MrBrown: folds
MrBlue: folds
Pluribus: folds
Eddie: folds
*** FLOP *** [Qh Ad Kd]
MrPink: checks
MrOrange: checks
*** TURN *** [Qh Ad Kd] [2s]
MrPink: checks
MrOrange: checks
*** RIVER *** [Qh Ad Kd] [2s] [Ks]
MrPink: bets 180
MrOrange: folds
Uncalled bet (180) returned to MrPink
MrPink collected 570.0 from pot
*** SUMMARY ***
Total pot 570 | Rake 0
Board [Qh Ad Kd 2s Ks]


PokerStars Hand #114138: Hold'em No Limit (50/100) - 2019/07/12 07:42:18 ET
Table 'Pluribus Session 114' 6-max (Play Money) Seat #6 is the button
Seat 1: Eddie (10000 in chips)
Seat 2: MrPink (10000 in chips)
Seat 3: MrOrange (10000 in chips)
Seat 4: MrBrown (10000 in chips)
Seat 5: MrBlue (10000 in chips)
Seat 6: Pluribus (10000 in chips)
Eddie: posts small blind 50
MrPink: posts big blind 100
*** HOLE CARDS ***
Dealt to Eddie [6c 4c]
Dealt to MrPink [8c 3h]
Dealt to MrOrange [3s Td]
Dealt to MrBrown [7c 9c]
Dealt to MrBlue [Jd Ac]
Dealt to Pluribus [Ts 2d]
MrOrange: folds
MrBrown: folds
MrBlue: raises 125 to 225
Pluribus: folds
Eddie: folds
MrPink: folds
Uncalled bet (125) returned to MrBlue
MrBlue collected 250.0 from pot
*** SUMMARY ***
Total pot 250 | Rake 0


PokerStars Hand #114139: Hold'em No Limit (50/100) - 2019/07/12 07:42:19 ET
Table 'Pluribus Session 114' 6-max (Play Money) Seat #6 is the button
Seat 1: MrPink (10000 in chips)
Seat 2: MrOrange (10000 in chips)
Seat 3: MrBrown (10000 in chips)
Seat 4: MrBlue (10000 in chips)
Seat 5: Pluribus (10000 in chips)
Seat 6: Eddie (10000 in chips)
MrPink: posts small blind 50
MrOrange: posts big blind 100
*** HOLE CARDS ***
Dealt to MrPink [7d Qc]
Dealt to MrOrange [3c 7h]
Dealt to MrBrown [Ks 8s]
Dealt to MrBlue [9s Tc]
Dealt to Pluribus [2c 2s]
Dealt to Eddie [Td 6c]
MrBrown: folds
MrBlue: folds
Pluribus: raises 100 to 200
Eddie: folds
MrPink: folds
MrOrange: folds
Uncalled bet (100) returned to Pluribus
Pluribus collected 250.0 from pot
*** SUMMARY ***
Total pot 250 | Rake 0


PokerStars Hand #114140: Hold'em No Limit (50/100) - 2019/07/12 07:42:20 ET
Table 'Pluribus Session 114' 6-max (Play Money) Seat #6 is the button
Seat 1: MrOrange (10000 in chips)
Seat 2: MrBrown (10000 in chips)
Seat 3: MrBlue (10000 in chips)
Seat 4: Pluribus (10000 in chips)
Seat 5: Eddie (10000 in chips)
Seat 6: MrPink (10000 in chips)
MrOrange: posts small blind 50
MrBrown: posts big blind 100
*** HOLE CARDS ***
Dealt to MrOrange [5c 8h]
Dealt to MrBrown [Ks Kc]
Dealt to MrBlue [Kd Ac]
Dealt to Pluribus [9c 3c]
Dealt to Eddie [5d 9s]
Dealt to MrPink [6h 6c]
MrBlue: raises 125 to 225
Pluribus: folds
Eddie: folds
MrPink: calls 225
MrOrange: folds
MrBrown: raises 875 to 1100
MrBlue: calls 875
MrPink: folds
*** FLOP *** [As Qh Tc]
MrBrown: checks
MrBlue: bets 1000
MrBrown: calls 1000
*** TURN *** [As Qh Tc] [Qs]
MrBrown: checks
MrBlue: bets 2000
MrBrown: folds
Uncalled bet (2000) returned to MrBlue
MrBlue collected 4475.0 from pot
*** SUMMARY ***
Total pot 4475 | Rake 0
Board [As Qh Tc Qs]


PokerStars Hand #114141: Hold'em No Limit (50/100) - 2019/07/12 07:42:21 ET
Table 'Pluribus Session 114' 6-max (Play Money) Seat #6 is the button
Seat 1: MrBrown (10000 in chips)
Seat 2: MrBlue (10000 in chips)
Seat 3: Pluribus (10000 in chips)
Seat 4: Eddie (10000 in chips)
Seat 5: MrPink (10000 in chips)
Seat 6: MrOrange (10000 in chips)
MrBrown: posts small blind 50
MrBlue: posts big blind 100
*** HOLE CARDS ***
Dealt to MrBrown [Jc 3c]
Dealt to MrBlue [6d Jh]
Dealt to Pluribus [7h Kh]
Dealt to Eddie [3d 6s]
Dealt to MrPink [2h 4c]
Dealt to MrOrange [Kd 7s]
Pluribus: raises 100 to 200
Eddie: folds
MrPink: folds
MrOrange: folds
MrBrown: folds
MrBlue: folds
Uncalled bet (100) returned to Pluribus
Pluribus collected 250.0 from pot
*** SUMMARY ***
Total pot 250 | Rake 0


PokerStars Hand #114142: Hold'em No Limit (50/100) - 2019/07/12 07:42:22 ET
Table 'Pluribus Session 114' 6-max (Play Money) Seat #6 is the button
Seat 1: MrBlue (10000 in chips)
Seat 2: Pluribus (10000 in chips)
Seat 3: Eddie (10000 in chips)
Seat 4: MrPink (10000 in chips)
Seat 5: MrOrange (10000 in chips)
Seat 6: MrBrown (10000 in chips)
MrBlue: posts small blind 50
Pluribus: posts big blind 100
*** HOLE CARDS ***
Dealt to MrBlue [4s 3d]
Dealt to Pluribus [Js 8h]
Dealt to Eddie [9s Jd]
Dealt to MrPink [6s Ks]
Dealt to MrOrange [Td 2d]
Dealt to MrBrown [Ad 9h]
Eddie: folds
MrPink: raises 110 to 210
MrOrange: folds
MrBrown: folds
MrBlue: folds
Pluribus: folds
Uncalled bet (110) returned to MrPink
MrPink collected 250.0 from pot
*** SUMMARY ***
Total pot 250 | Rake 0


PokerStars Hand #114143: Hold'em No Limit (50/100) - 2019/07/12 07:42:23 ET
Table 'Pluribus Session 114' 6-max (Play Money) Seat #6 is the button
Seat 1: Pluribus (10000 in chips)
Seat 2: Eddie (10000 in chips)
Seat 3: MrPink (10000 in chips)
Seat 4: MrOrange (10000 in chips)
Seat 5: MrBrown (10000 in chips)
Seat 6: MrBlue (10000 in chips)
Pluribus: posts small blind 50
Eddie: posts big blind 100
*** HOLE CARDS ***
Dealt to Pluribus [Jc Qd]
Dealt to Eddie [Tc Qc]
Dealt to MrPink [2d 5s]
Dealt to MrOrange [2s 6c]
Dealt to MrBrown [Qh 2c]
Dealt to MrBlue [4d 3d]
MrPink: folds
MrOrange: folds
MrBrown: folds
MrBlue: raises 125 to 225
Pluribus: calls 175
Eddie: raises 1125 to 1350
MrBlue: folds
Pluribus: folds
Uncalled bet (1125) returned to Eddie
Eddie collected 675.0 from pot
*** SUMMARY ***
Total pot 675 | Rake 0


PokerStars Hand #114144: Hold'em No Limit (50/100) - 2019/07/12 07:42:24 ET
Table 'Pluribus Session 114' 6-max (Play Money) Seat #6 is the button
Seat 1: Eddie (10000 in chips)
Seat 2: MrPink (10000 in chips)
Seat 3: MrOrange (10000 in chips)
Seat 4: MrBrown (10000 in chips)
Seat 5: MrBlue (10000 in chips)
Seat 6: Pluribus (10000 in chips)
Eddie: posts small blind 50
MrPink: posts big blind 100
*** HOLE CARDS ***
Dealt to Eddie [5s Kd]
Dealt to MrPink [4d Ts]
Dealt to MrOrange [2h 2c]
Dealt to MrBrown [2s Qc]
Dealt to MrBlue [Jd Jc]
Dealt to Pluribus [Jh 5d]
MrOrange: folds
MrBrown: folds
MrBlue: raises 125 to 225
Pluribus: folds
Eddie: folds
MrPink: folds
Uncalled bet (125) returned to MrBlue
MrBlue collected 250.0 from pot
*** SUMMARY ***
Total pot 250 | Rake 0


PokerStars Hand #114145: Hold'em No Limit (50/100) - 2019/07/12 07:42:25 ET
Table 'Pluribus Session 114' 6-max (Play Money) Seat #6 is the button
Seat 1: MrPink (10000 in chips)
Seat 2: MrOrange (10000 in chips)
Seat 3: MrBrown (10000 in chips)
Seat 4: MrBlue (10000 in chips)
Seat 5: Pluribus (10000 in chips)
Seat 6: Eddie (10000 in chips)
MrPink: posts small blind 50
MrOrange: posts big blind 100
*** HOLE CARDS ***
Dealt to MrPink [Ad 8h]
Dealt to MrOrange [7h Ac]
Dealt to MrBrown [As Th]
Dealt to MrBlue [Ks Kd]
Dealt to Pluribus [2h 2s]
Dealt to Eddie [Js 5h]
MrBrown: folds
MrBlue: raises 125 to 225
Pluribus: folds
Eddie: folds
MrPink: folds
MrOrange: folds
Uncalled bet (125) returned to MrBlue
MrBlue collected 250.0 from pot
*** SUMMARY ***
Total pot 250 | Rake 0


PokerStars Hand #114146: Hold'em No Limit (50/100) - 2019/07/12 07:42:26 ET
Table 'Pluribus Session 114' 6-max (Play Money) Seat #6 is the button
Seat 1: MrOrange (10000 in chips)
Seat 2: MrBrown (10000 in chips)
Seat 3: MrBlue (10000 in chips)
Seat 4: Pluribus (10000 in chips)
Seat 5: Eddie (10000 in chips)
Seat 6: MrPink (10000 in chips)
MrOrange: posts small blind 50
MrBrown: posts big blind 100
*** HOLE CARDS ***
Dealt to MrOrange [As 8h]
Dealt to MrBrown [2d 2s]
Dealt to MrBlue [9d 4d]
Dealt to Pluribus [6c 9h]
Dealt to Eddie [5h Js]
Dealt to MrPink [5d 4h]
MrBlue: folds
Pluribus: folds
Eddie: folds
MrPink: folds
MrOrange: raises 150 to 250
MrBrown: calls 150
*** FLOP *** [5c 7s 3s]
MrOrange: checks
MrBrown: checks
*** TURN *** [5c 7s 3s] [Kh]
MrOrange: checks
MrBrown: checks
*** RIVER *** [5c 7s 3s] [Kh] [6s]
MrOrange: checks
MrBrown: checks
*** SHOWDOWN ***
MrBrown: shows [2d 2s]
MrBrown collected 500.0 from pot
*** SUMMARY ***
Total pot 500 | Rake 0
Board [5c 7s 3s Kh 6s]
Seat 1: MrOrange showed [As 8h] and lost
Seat 2: MrBrown showed [2d 2s] and won (500.0)


PokerStars Hand #114147: Hold'em No Limit (50/100) - 2019/07/12 07:42:27 ET
Table 'Pluribus Session 114' 6-max (Play Money) Seat #6 is the button
Seat 1: MrBrown (10000 in chips)
Seat 2: MrBlue (10000 in chips)
Seat 3: Pluribus (10000 in chips)
Seat 4: Eddie (10000 in chips)
Seat 5: MrPink (10000 in chips)
Seat 6: MrOrange (10000 in chips)
MrBrown: posts small blind 50
MrBlue: posts big blind 100
*** HOLE CARDS ***
Dealt to MrBrown [5h Kd]
Dealt to MrBlue [9s Qs]
Dealt to Pluribus [Qh As]
Dealt to Eddie [3h Qd]
Dealt to MrPink [3d 3c]
Dealt to MrOrange [6d Ac]
Pluribus: raises 100 to 200
Eddie: folds
MrPink: folds
MrOrange: folds
MrBrown: folds
MrBlue: calls 100
*** FLOP *** [9h 8s Kh]
MrBlue: checks
Pluribus: bets 225
MrBlue: calls 225
*** TURN *** [9h 8s Kh] [Js]
MrBlue: checks
Pluribus: bets 900
MrBlue: calls 900
*** RIVER *** [9h 8s Kh] [Js] [Ah]
MrBlue: checks
Pluribus: checks
*** SHOWDOWN ***
Pluribus: shows [Qh As]
Pluribus collected 2700.0 from pot
*** SUMMARY ***
Total pot 2700 | Rake 0
Board [9h 8s Kh Js Ah]
Seat 2: MrBlue showed [9s Qs] and lost
Seat 3: Pluribus showed [Qh As] and won (2700.0)


PokerStars Hand #114148: Hold'em No Limit (50/100) - 2019/07/12 07:42:28 ET
Table 'Pluribus Session 114' 6-max (Play Money) Seat #6 is the button
Seat 1: MrBlue (10000 in chips)
Seat 2: Pluribus (10000 in chips)
Seat 3: Eddie (10000 in chips)
Seat 4: MrPink (10000 in chips)
Seat 5: MrOrange (10000 in chips)
Seat 6: MrBrown (10000 in chips)
MrBlue: posts small blind 50
Pluribus: posts big blind 100
*** HOLE CARDS ***
Dealt to MrBlue [8c 4h]
Dealt to Pluribus [6c Th]
Dealt to Eddie [Kc Jh]
Dealt to MrPink [6s Qd]
Dealt to MrOrange [Js 5d]
Dealt to MrBrown [Ts 6h]
Eddie: raises 100 to 200
MrPink: folds
MrOrange: folds
MrBrown: folds
MrBlue: folds
Pluribus: folds
Uncalled bet (100) returned to Eddie
Eddie collected 250.0 from pot
*** SUMMARY ***
Total pot 250 | Rake 0


PokerStars Hand #114149: Hold'em No Limit (50/100) - 2019/07/12 07:42:29 ET
Table 'Pluribus Session 114' 6-max (Play Money) Seat #6 is the button
Seat 1: Pluribus (10000 in chips)
Seat 2: Eddie (10000 in chips)
Seat 3: MrPink (10000 in chips)
Seat 4: MrOrange (10000 in chips)
Seat 5: MrBrown (10000 in chips)
Seat 6: MrBlue (10000 in chips)
Pluribus: posts small blind 50
Eddie: posts big blind 100
*** HOLE CARDS ***
Dealt to Pluribus [Kd 3c]
Dealt to Eddie [Kc 2c]
Dealt to MrPink [9s 2d]
Dealt to MrOrange [7s 5s]
Dealt to MrBrown [9c 4s]
Dealt to MrBlue [7h Ac]
MrPink: folds
MrOrange: folds
MrBrown: folds
MrBlue: raises 125 to 225
Pluribus: folds
Eddie: calls 125
*** FLOP *** [3h 8s 7d]
Eddie: checks
MrBlue: checks
*** TURN *** [3h 8s 7d] [5c]
Eddie: checks
MrBlue: checks
*** RIVER *** [3h 8s 7d] [5c] [5d]
Eddie: checks
MrBlue: bets 300
Eddie: folds
Uncalled bet (300) returned to MrBlue
MrBlue collected 500.0 from pot
*** SUMMARY ***
Total pot 500 | Rake 0
Board [3h 8s 7d 5c 5d]


PokerStars Hand #114150: Hold'em No Limit (50/100) - 2019/07/12 07:42:30 ET
Table 'Pluribus Session 114' 6-max (Play Money) Seat #6 is the button
Seat 1: Eddie (10000 in chips)
Seat 2: MrPink (10000 in chips)
Seat 3: MrOrange (10000 in chips)
Seat 4: MrBrown (10000 in chips)
Seat 5: MrBlue (10000 in chips)
Seat 6: Pluribus (10000 in chips)
Eddie: posts small blind 50
MrPink: posts big blind 100
*** HOLE CARDS ***
Dealt to Eddie [8d Ah]
Dealt to MrPink [5d Qs]
Dealt to MrOrange [7c 7h]
Dealt to MrBrown [2c 9c]
Dealt to MrBlue [Ad 8s]
Dealt to Pluribus [6s Qd]
MrOrange: raises 100 to 200
MrBrown: folds
MrBlue: folds
Pluribus: folds
Eddie: folds
MrPink: folds
Uncalled bet (100) returned to MrOrange
MrOrange collected 250.0 from pot
*** SUMMARY ***
Total pot 250 | Rake 0


PokerStars Hand #114151: Hold'em No Limit (50/100) - 2019/07/12 07:42:31 ET
Table 'Pluribus Session 114' 6-max (Play Money) Seat #6 is the button
Seat 1: MrPink (10000 in chips)
Seat 2: MrOrange (10000 in chips)
Seat 3: MrBrown (10000 in chips)
Seat 4: MrBlue (10000 in chips)
Seat 5: Pluribus (10000 in chips)
Seat 6: Eddie (10000 in chips)
MrPink: posts small blind 50
MrOrange: posts big blind 100
*** HOLE CARDS ***
Dealt to MrPink [2d Js]
Dealt to MrOrange [Ad Tc]
Dealt to MrBrown [9d Qh]
Dealt to MrBlue [5d 3d]
Dealt to Pluribus [8s 2c]
Dealt to Eddie [6s Qs]
MrBrown: folds
MrBlue: folds
Pluribus: folds
Eddie: raises 125 to 225
MrPink: folds
MrOrange: calls 125
*** FLOP *** [9c 2s 5c]
MrOrange: checks
Eddie: bets 550
MrOrange: folds
Uncalled bet (550) returned to Eddie
Eddie collected 500.0 from pot
*** SUMMARY ***
Total pot 500 | Rake 0
Board [9c 2s 5c]


PokerStars Hand #114152: Hold'em No Limit (50/100) - 2019/07/12 07:42:32 ET
Table 'Pluribus Session 114' 6-max (Play Money) Seat #6 is the button
Seat 1: MrOrange (10000 in chips)
Seat 2: MrBrown (10000 in chips)
Seat 3: MrBlue (10000 in chips)
Seat 4: Pluribus (10000 in chips)
Seat 5: Eddie (10000 in chips)
Seat 6: MrPink (10000 in chips)
MrOrange: posts small blind 50
MrBrown: posts big blind 100
*** HOLE CARDS ***
Dealt to MrOrange [4d Ts]
Dealt to MrBrown [3s 2s]
Dealt to MrBlue [2c 8d]
Dealt to Pluribus [Kc Qd]
Dealt to Eddie [Qh 6c]
Dealt to MrPink [Ad Ks]
MrBlue: folds
Pluribus: raises 100 to 200
Eddie: folds
MrPink: raises 450 to 650
MrOrange: folds
MrBrown: folds
Pluribus: folds
Uncalled bet (450) returned to MrPink
MrPink collected 550.0 from pot
*** SUMMARY ***
Total pot 550 | Rake 0


PokerStars Hand #114153: Hold'em No Limit (50/100) - 2019/07/12 07:42:33 ET
Table 'Pluribus Session 114' 6-max (Play Money) Seat #6 is the button
Seat 1: MrBrown (10000 in chips)
Seat 2: MrBlue (10000 in chips)
Seat 3: Pluribus (10000 in chips)
Seat 4: Eddie (10000 in chips)
Seat 5: MrPink (10000 in chips)
Seat 6: MrOrange (10000 in chips)
MrBrown: posts small blind 50
MrBlue: posts big blind 100
*** HOLE CARDS ***
Dealt to MrBrown [Qc 4s]
Dealt to MrBlue [Tc Js]
Dealt to Pluribus [Ad 6c]
Dealt to Eddie [5d 9h]
Dealt to MrPink [7s Qd]
Dealt to MrOrange [4c Jc]
Pluribus: folds
Eddie: folds
MrPink: folds
MrOrange: folds
MrBrown: folds
Uncalled bet (50) returned to MrBlue
MrBlue collected 100.0 from pot
*** SUMMARY ***
Total pot 100 | Rake 0


PokerStars Hand #114154: Hold'em No Limit (50/100) - 2019/07/12 07:42:34 ET
Table 'Pluribus Session 114' 6-max (Play Money) Seat #6 is the button
Seat 1: MrBlue (10000 in chips)
Seat 2: Pluribus (10000 in chips)
Seat 3: Eddie (10000 in chips)
Seat 4: MrPink (10000 in chips)
Seat 5: MrOrange (10000 in chips)
Seat 6: MrBrown (10000 in chips)
MrBlue: posts small blind 50
Pluribus: posts big blind 100
*** HOLE CARDS ***
Dealt to MrBlue [5h 6h]
Dealt to Pluribus [Kc 7s]
Dealt to Eddie [9h Qh]
Dealt to MrPink [3d Kd]
Dealt to MrOrange [Ks 7h]
Dealt to MrBrown [Jh 3s]
Eddie: raises 100 to 200
MrPink: folds
MrOrange: folds
MrBrown: folds
MrBlue: calls 150
Pluribus: folds
*** FLOP *** [2c 5s Qd]
MrBlue: checks
Eddie: bets 350
MrBlue: calls 350
*** TURN *** [2c 5s Qd] [Ad]
MrBlue: checks
Eddie: checks
*** RIVER *** [2c 5s Qd] [Ad] [Jc]
MrBlue: checks
Eddie: checks
*** SHOWDOWN ***
Eddie: shows [9h Qh]
Eddie collected 1200.0 from pot
*** SUMMARY ***
Total pot 1200 | Rake 0
Board [2c 5s Qd Ad Jc]
Seat 1: MrBlue showed [5h 6h] and lost
Seat 3: Eddie showed [9h Qh] and won (1200.0)


PokerStars Hand #114155: Hold'em No Limit (50/100) - 2019/07/12 07:42:35 ET
Table 'Pluribus Session 114' 6-max (Play Money) Seat #6 is the button
Seat 1: Pluribus (10000 in chips)
Seat 2: Eddie (10000 in chips)
Seat 3: MrPink (10000 in chips)
Seat 4: MrOrange (10000 in chips)
Seat 5: MrBrown (10000 in chips)
Seat 6: MrBlue (10000 in chips)
Pluribus: posts small blind 50
Eddie: posts big blind 100
*** HOLE CARDS ***
Dealt to Pluribus [3c 8h]
Dealt to Eddie [Jh 8c]
Dealt to MrPink [Ah 6d]
Dealt to MrOrange [5d 5c]
Dealt to MrBrown [4c 9h]
Dealt to MrBlue [Kc 7s]
MrPink: folds
MrOrange: raises 105 to 205
MrBrown: folds
MrBlue: folds
Pluribus: folds
Eddie: calls 105
*** FLOP *** [2c Kh Kd]
Eddie: checks
MrOrange: bets 150
Eddie: folds
Uncalled bet (150) returned to MrOrange
MrOrange collected 460.0 from pot
*** SUMMARY ***
Total pot 460 | Rake 0
Board [2c Kh Kd]


PokerStars Hand #114156: Hold'em No Limit (50/100) - 2019/07/12 07:42:36 ET
Table 'Pluribus Session 114' 6-max (Play Money) Seat #6 is the button
Seat 1: Eddie (10000 in chips)
Seat 2: MrPink (10000 in chips)
Seat 3: MrOrange (10000 in chips)
Seat 4: MrBrown (10000 in chips)
Seat 5: MrBlue (10000 in chips)
Seat 6: Pluribus (10000 in chips)
Eddie: posts small blind 50
MrPink: posts big blind 100
*** HOLE CARDS ***
Dealt to Eddie [3h 2c]
Dealt to MrPink [5s Kd]
Dealt to MrOrange [6c 3c]
Dealt to MrBrown [Ks 8c]
Dealt to MrBlue [Ac 7c]
Dealt to Pluribus [5h 4s]
MrOrange: folds
MrBrown: folds
MrBlue: raises 125 to 225
Pluribus: folds
Eddie: folds
MrPink: folds
Uncalled bet (125) returned to MrBlue
MrBlue collected 250.0 from pot
*** SUMMARY ***
Total pot 250 | Rake 0


PokerStars Hand #114157: Hold'em No Limit (50/100) - 2019/07/12 07:42:37 ET
Table 'Pluribus Session 114' 6-max (Play Money) Seat #6 is the button
Seat 1: MrPink (10000 in chips)
Seat 2: MrOrange (10000 in chips)
Seat 3: MrBrown (10000 in chips)
Seat 4: MrBlue (10000 in chips)
Seat 5: Pluribus (10000 in chips)
Seat 6: Eddie (10000 in chips)
MrPink: posts small blind 50
MrOrange: posts big blind 100
*** HOLE CARDS ***
Dealt to MrPink [9c Td]
Dealt to MrOrange [4c 6d]
Dealt to MrBrown [Jh Kh]
Dealt to MrBlue [Ac 6h]
Dealt to Pluribus [6s Js]
Dealt to Eddie [8h 8d]
MrBrown: raises 125 to 225
MrBlue: folds
Pluribus: folds
Eddie: calls 225
MrPink: folds
MrOrange: folds
*** FLOP *** [3s Jc Qd]
MrBrown: checks
Eddie: checks
*** TURN *** [3s Jc Qd] [7c]
MrBrown: checks
Eddie: checks
*** RIVER *** [3s Jc Qd] [7c] [Qh]
MrBrown: bets 300
Eddie: folds
Uncalled bet (300) returned to MrBrown
MrBrown collected 600.0 from pot
*** SUMMARY ***
Total pot 600 | Rake 0
Board [3s Jc Qd 7c Qh]


PokerStars Hand #114158: Hold'em No Limit (50/100) - 2019/07/12 07:42:38 ET
Table 'Pluribus Session 114' 6-max (Play Money) Seat #6 is the button
Seat 1: MrOrange (10000 in chips)
Seat 2: MrBrown (10000 in chips)
Seat 3: MrBlue (10000 in chips)
Seat 4: Pluribus (10000 in chips)
Seat 5: Eddie (10000 in chips)
Seat 6: MrPink (10000 in chips)
MrOrange: posts small blind 50
MrBrown: posts big blind 100
*** HOLE CARDS ***
Dealt to MrOrange [2d Ks]
Dealt to MrBrown [3d 3h]
Dealt to MrBlue [7d 5c]
Dealt to Pluribus [As 7h]
Dealt to Eddie [Jd 8s]
Dealt to MrPink [Js 6s]
MrBlue: folds
Pluribus: folds
Eddie: folds
MrPink: raises 150 to 250
MrOrange: folds
MrBrown: calls 150
*** FLOP *** [3c Qd Ah]
MrBrown: checks
MrPink: bets 600
MrBrown: calls 600
*** TURN *** [3c Qd Ah] [5d]
MrBrown: checks
MrPink: checks
*** RIVER *** [3c Qd Ah] [5d] [4s]
MrBrown: bets 1312
MrPink: folds
Uncalled bet (1312) returned to MrBrown
MrBrown collected 1750.0 from pot
*** SUMMARY ***
Total pot 1750 | Rake 0
Board [3c Qd Ah 5d 4s]


PokerStars Hand #114159: Hold'em No Limit (50/100) - 2019/07/12 07:42:39 ET
Table 'Pluribus Session 114' 6-max (Play Money) Seat #6 is the button
Seat 1: MrBrown (10000 in chips)
Seat 2: MrBlue (10000 in chips)
Seat 3: Pluribus (10000 in chips)
Seat 4: Eddie (10000 in chips)
Seat 5: MrPink (10000 in chips)
Seat 6: MrOrange (10000 in chips)
MrBrown: posts small blind 50
MrBlue: posts big blind 100
*** HOLE CARDS ***
Dealt to MrBrown [4h Jh]
Dealt to MrBlue [8h 4c]
Dealt to Pluribus [9s 4d]
Dealt to Eddie [Jd 3s]
Dealt to MrPink [9c 8s]
Dealt to MrOrange [3d 3c]
Pluribus: folds
Eddie: folds
MrPink: folds
MrOrange: raises 125 to 225
MrBrown: folds
MrBlue: folds
Uncalled bet (125) returned to MrOrange
MrOrange collected 250.0 from pot
*** SUMMARY ***
Total pot 250 | Rake 0


PokerStars Hand #114160: Hold'em No Limit (50/100) - 2019/07/12 07:42:40 ET
Table 'Pluribus Session 114' 6-max (Play Money) Seat #6 is the button
Seat 1: MrBlue (10000 in chips)
Seat 2: Pluribus (10000 in chips)
Seat 3: Eddie (10000 in chips)
Seat 4: MrPink (10000 in chips)
Seat 5: MrOrange (10000 in chips)
Seat 6: MrBrown (10000 in chips)
MrBlue: posts small blind 50
Pluribus: posts big blind 100
*** HOLE CARDS ***
Dealt to MrBlue [Qc Js]
Dealt to Pluribus [Jc 8d]
Dealt to Eddie [9c 6d]
Dealt to MrPink [Ad 5s]
Dealt to MrOrange [2s 3s]
Dealt to MrBrown [4d 2d]
Eddie: folds
MrPink: folds
MrOrange: folds
MrBrown: folds
MrBlue: raises 200 to 300
Pluribus: calls 200
*** FLOP *** [Th Jh Td]
MrBlue: checks
Pluribus: checks
*** TURN *** [Th Jh Td] [9h]
MrBlue: checks
Pluribus: checks
*** RIVER *** [Th Jh Td] [9h] [6c]
MrBlue: bets 450
Pluribus: calls 450
*** SHOWDOWN ***
MrBlue: shows [Qc Js]
MrBlue collected 1500.0 from pot
*** SUMMARY ***
Total pot 1500 | Rake 0
Board [Th Jh Td 9h 6c]
Seat 1: MrBlue showed [Qc Js] and won (1500.0)
Seat 2: Pluribus showed [Jc 8d] and lost


PokerStars Hand #114161: Hold'em No Limit (50/100) - 2019/07/12 07:42:41 ET
Table 'Pluribus Session 114' 6-max (Play Money) Seat #6 is the button
Seat 1: Pluribus (10000 in chips)
Seat 2: Eddie (10000 in chips)
Seat 3: MrPink (10000 in chips)
Seat 4: MrOrange (10000 in chips)
Seat 5: MrBrown (10000 in chips)
Seat 6: MrBlue (10000 in chips)
Pluribus: posts small blind 50
Eddie: posts big blind 100
*** HOLE CARDS ***
Dealt to Pluribus [Kd Qd]
Dealt to Eddie [2d Ts]
Dealt to MrPink [3c 9s]
Dealt to MrOrange [7c 2h]
Dealt to MrBrown [As 3h]
Dealt to MrBlue [2c Kh]
MrPink: folds
MrOrange: folds
MrBrown: folds
MrBlue: folds
Pluribus: raises 175 to 275
Eddie: folds
Uncalled bet (175) returned to Pluribus
Pluribus collected 200.0 from pot
*** SUMMARY ***
Total pot 200 | Rake 0


PokerStars Hand #114162: Hold'em No Limit (50/100) - 2019/07/12 07:42:42 ET
Table 'Pluribus Session 114' 6-max (Play Money) Seat #6 is the button
Seat 1: Eddie (10000 in chips)
Seat 2: MrPink (10000 in chips)
Seat 3: MrOrange (10000 in chips)
Seat 4: MrBrown (10000 in chips)
Seat 5: MrBlue (10000 in chips)
Seat 6: Pluribus (10000 in chips)
Eddie: posts small blind 50
MrPink: posts big blind 100
*** HOLE CARDS ***
Dealt to Eddie [4s 5d]
Dealt to MrPink [8h Jh]
Dealt to MrOrange [2h 4d]
Dealt to MrBrown [3c 6c]
Dealt to MrBlue [3d 6s]
Dealt to Pluribus [2s 7s]
MrOrange: folds
MrBrown: folds
MrBlue: folds
Pluribus: folds
Eddie: folds
Uncalled bet (50) returned to MrPink
MrPink collected 100.0 from pot
*** SUMMARY ***
Total pot 100 | Rake 0


PokerStars Hand #114163: Hold'em No Limit (50/100) - 2019/07/12 07:42:43 ET
Table 'Pluribus Session 114' 6-max (Play Money) Seat #6 is the button
Seat 1: MrPink (10000 in chips)
Seat 2: MrOrange (10000 in chips)
Seat 3: MrBrown (10000 in chips)
Seat 4: MrBlue (10000 in chips)
Seat 5: Pluribus (10000 in chips)
Seat 6: Eddie (10000 in chips)
MrPink: posts small blind 50
MrOrange: posts big blind 100
*** HOLE CARDS ***
Dealt to MrPink [8d 6d]
Dealt to MrOrange [Ah 7c]
Dealt to MrBrown [7d 3s]
Dealt to MrBlue [2s 7h]
Dealt to Pluribus [4c 2h]
Dealt to Eddie [6h 2d]
MrBrown: folds
MrBlue: folds
Pluribus: folds
Eddie: folds
MrPink: calls 50
MrOrange: checks
*** FLOP *** [3c 6c 8h]
MrPink: checks
MrOrange: checks
*** TURN *** [3c 6c 8h] [3d]
MrPink: checks
MrOrange: checks
*** RIVER *** [3c 6c 8h] [3d] [4s]
MrPink: bets 100
MrOrange: calls 100
*** SHOWDOWN ***
MrPink: shows [8d 6d]
MrPink collected 400.0 from pot
*** SUMMARY ***
Total pot 400 | Rake 0
Board [3c 6c 8h 3d 4s]
Seat 1: MrPink showed [8d 6d] and won (400.0)
Seat 2: MrOrange showed [Ah 7c] and lost


PokerStars Hand #114164: Hold'em No Limit (50/100) - 2019/07/12 07:42:44 ET
Table 'Pluribus Session 114' 6-max (Play Money) Seat #6 is the button
Seat 1: MrOrange (10000 in chips)
Seat 2: MrBrown (10000 in chips)
Seat 3: MrBlue (10000 in chips)
Seat 4: Pluribus (10000 in chips)
Seat 5: Eddie (10000 in chips)
Seat 6: MrPink (10000 in chips)
MrOrange: posts small blind 50
MrBrown: posts big blind 100
*** HOLE CARDS ***
Dealt to MrOrange [9h 4s]
Dealt to MrBrown [7d 7h]
Dealt to MrBlue [2h Kd]
Dealt to Pluribus [Th 3s]
Dealt to Eddie [9s Jc]
Dealt to MrPink [Qd 6h]
MrBlue: folds
Pluribus: folds
Eddie: folds
MrPink: folds
MrOrange: folds
Uncalled bet (50) returned to MrBrown
MrBrown collected 100.0 from pot
*** SUMMARY ***
Total pot 100 | Rake 0


PokerStars Hand #114165: Hold'em No Limit (50/100) - 2019/07/12 07:42:45 ET
Table 'Pluribus Session 114' 6-max (Play Money) Seat #6 is the button
Seat 1: MrBrown (10000 in chips)
Seat 2: MrBlue (10000 in chips)
Seat 3: Pluribus (10000 in chips)
Seat 4: Eddie (10000 in chips)
Seat 5: MrPink (10000 in chips)
Seat 6: MrOrange (10000 in chips)
MrBrown: posts small blind 50
MrBlue: posts big blind 100
*** HOLE CARDS ***
Dealt to MrBrown [2h 8c]
Dealt to MrBlue [3d 8h]
Dealt to Pluribus [4s 3c]
Dealt to Eddie [6c Ks]
Dealt to MrPink [Td As]
Dealt to MrOrange [6d 7c]
Pluribus: folds
Eddie: folds
MrPink: raises 110 to 210
MrOrange: folds
MrBrown: folds
MrBlue: folds
Uncalled bet (110) returned to MrPink
MrPink collected 250.0 from pot
*** SUMMARY ***
Total pot 250 | Rake 0


PokerStars Hand #114166: Hold'em No Limit (50/100) - 2019/07/12 07:42:46 ET
Table 'Pluribus Session 114' 6-max (Play Money) Seat #6 is the button
Seat 1: MrBlue (10000 in chips)
Seat 2: Pluribus (10000 in chips)
Seat 3: Eddie (10000 in chips)
Seat 4: MrPink (10000 in chips)
Seat 5: MrOrange (10000 in chips)
Seat 6: MrBrown (10000 in chips)
MrBlue: posts small blind 50
Pluribus: posts big blind 100
*** HOLE CARDS ***
Dealt to MrBlue [Qc 8s]
Dealt to Pluribus [9d 7s]
Dealt to Eddie [8h 4s]
Dealt to MrPink [6s 9c]
Dealt to MrOrange [8d 5s]
Dealt to MrBrown [3c 7d]
Eddie: folds
MrPink: folds
MrOrange: folds
MrBrown: folds
MrBlue: calls 50
Pluribus: raises 150 to 250
MrBlue: calls 150
*** FLOP *** [Qh 7c Ks]
MrBlue: checks
Pluribus: checks
*** TURN *** [Qh 7c Ks] [Kh]
MrBlue: checks
Pluribus: checks
*** RIVER *** [Qh 7c Ks] [Kh] [3h]
MrBlue: bets 375
Pluribus: calls 375
*** SHOWDOWN ***
MrBlue: shows [Qc 8s]
MrBlue collected 1250.0 from pot
*** SUMMARY ***
Total pot 1250 | Rake 0
Board [Qh 7c Ks Kh 3h]
Seat 1: MrBlue showed [Qc 8s] and won (1250.0)
Seat 2: Pluribus showed [9d 7s] and lost


PokerStars Hand #114167: Hold'em No Limit (50/100) - 2019/07/12 07:42:47 ET
Table 'Pluribus Session 114' 6-max (Play Money) Seat #6 is the button
Seat 1: Pluribus (10000 in chips)
Seat 2: Eddie (10000 in chips)
Seat 3: MrPink (10000 in chips)
Seat 4: MrOrange (10000 in chips)
Seat 5: MrBrown (10000 in chips)
Seat 6: MrBlue (10000 in chips)
Pluribus: posts small blind 50
Eddie: posts big blind 100
*** HOLE CARDS ***
Dealt to Pluribus [Ks 4s]
Dealt to Eddie [2d 9c]
Dealt to MrPink [9h 9s]
Dealt to MrOrange [5c Jc]
Dealt to MrBrown [4c 5s]
Dealt to MrBlue [Th Ad]
MrPink: raises 110 to 210
MrOrange: folds
MrBrown: folds
MrBlue: folds
Pluribus: folds
Eddie: folds
Uncalled bet (110) returned to MrPink
MrPink collected 250.0 from pot
*** SUMMARY ***
Total pot 250 | Rake 0


PokerStars Hand #114168: Hold'em No Limit (50/100) - 2019/07/12 07:42:48 ET
Table 'Pluribus Session 114' 6-max (Play Money) Seat #6 is the button
Seat 1: Eddie (10000 in chips)
Seat 2: MrPink (10000 in chips)
Seat 3: MrOrange (10000 in chips)
Seat 4: MrBrown (10000 in chips)
Seat 5: MrBlue (10000 in chips)
Seat 6: Pluribus (10000 in chips)
Eddie: posts small blind 50
MrPink: posts big blind 100
*** HOLE CARDS ***
Dealt to Eddie [8h Ah]
Dealt to MrPink [Qh 8s]
Dealt to MrOrange [7c 5s]
Dealt to MrBrown [3d 9s]
Dealt to MrBlue [2c 4h]
Dealt to Pluribus [Td 5h]
MrOrange: folds
MrBrown: folds
MrBlue: folds
Pluribus: folds
Eddie: raises 135 to 235
MrPink: calls 135
*** FLOP *** [3s Jh Ts]
Eddie: bets 285
MrPink: calls 285
*** TURN *** [3s Jh Ts] [6d]
Eddie: checks
MrPink: checks
*** RIVER *** [3s Jh Ts] [6d] [9c]
Eddie: checks
MrPink: bets 650
Eddie: folds
Uncalled bet (650) returned to MrPink
MrPink collected 1040.0 from pot
*** SUMMARY ***
Total pot 1040 | Rake 0
Board [3s Jh Ts 6d 9c]


PokerStars Hand #114169: Hold'em No Limit (50/100) - 2019/07/12 07:42:49 ET
Table 'Pluribus Session 114' 6-max (Play Money) Seat #6 is the button
Seat 1: MrPink (10000 in chips)
Seat 2: MrOrange (10000 in chips)
Seat 3: MrBrown (10000 in chips)
Seat 4: MrBlue (10000 in chips)
Seat 5: Pluribus (10000 in chips)
Seat 6: Eddie (10000 in chips)
MrPink: posts small blind 50
MrOrange: posts big blind 100
*** HOLE CARDS ***
Dealt to MrPink [2c As]
Dealt to MrOrange [7d Jh]
Dealt to MrBrown [2h Tc]
Dealt to MrBlue [Td 9s]
Dealt to Pluribus [9c 3d]
Dealt to Eddie [7c 4h]
MrBrown: folds
MrBlue: folds
Pluribus: folds
Eddie: folds
MrPink: calls 50
MrOrange: checks
*** FLOP *** [8c Qc 6s]
MrPink: checks
MrOrange: checks
*** TURN *** [8c Qc 6s] [3h]
MrPink: checks
MrOrange: checks
*** RIVER *** [8c Qc 6s] [3h] [Qs]
MrPink: checks
MrOrange: checks
*** SHOWDOWN ***
MrPink: shows [2c As]
MrPink collected 200.0 from pot
*** SUMMARY ***
Total pot 200 | Rake 0
Board [8c Qc 6s 3h Qs]
Seat 1: MrPink showed [2c As] and won (200.0)
Seat 2: MrOrange showed [7d Jh] and lost


PokerStars Hand #114170: Hold'em No Limit (50/100) - 2019/07/12 07:42:50 ET
Table 'Pluribus Session 114' 6-max (Play Money) Seat #6 is the button
Seat 1: MrOrange (10000 in chips)
Seat 2: MrBrown (10000 in chips)
Seat 3: MrBlue (10000 in chips)
Seat 4: Pluribus (10000 in chips)
Seat 5: Eddie (10000 in chips)
Seat 6: MrPink (10000 in chips)
MrOrange: posts small blind 50
MrBrown: posts big blind 100
*** HOLE CARDS ***
Dealt to MrOrange [4c Js]
Dealt to MrBrown [Kd Td]
Dealt to MrBlue [Jc 8h]
Dealt to Pluribus [Jh 4s]
Dealt to Eddie [Ts 6c]
Dealt to MrPink [7h Tc]
MrBlue: folds
Pluribus: folds
Eddie: folds
MrPink: folds
MrOrange: folds
Uncalled bet (50) returned to MrBrown
MrBrown collected 100.0 from pot
*** SUMMARY ***
Total pot 100 | Rake 0


PokerStars Hand #114171: Hold'em No Limit (50/100) - 2019/07/12 07:42:51 ET
Table 'Pluribus Session 114' 6-max (Play Money) Seat #6 is the button
Seat 1: MrBrown (10000 in chips)
Seat 2: MrBlue (10000 in chips)
Seat 3: Pluribus (10000 in chips)
Seat 4: Eddie (10000 in chips)
Seat 5: MrPink (10000 in chips)
Seat 6: MrOrange (10000 in chips)
MrBrown: posts small blind 50
MrBlue: posts big blind 100
*** HOLE CARDS ***
Dealt to MrBrown [9s Js]
Dealt to MrBlue [7c Ad]
Dealt to Pluribus [3s Ts]
Dealt to Eddie [8h 3h]
Dealt to MrPink [8s 5h]
Dealt to MrOrange [3d 5c]
Pluribus: folds
Eddie: folds
MrPink: folds
MrOrange: folds
MrBrown: raises 200 to 300
MrBlue: calls 200
*** FLOP *** [2c Kc Th]
MrBrown: bets 400
MrBlue: folds
Uncalled bet (400) returned to MrBrown
MrBrown collected 600.0 from pot
*** SUMMARY ***
Total pot 600 | Rake 0
Board [2c Kc Th]


PokerStars Hand #114172: Hold'em No Limit (50/100) - 2019/07/12 07:42:52 ET
Table 'Pluribus Session 114' 6-max (Play Money) Seat #6 is the button
Seat 1: MrBlue (10000 in chips)
Seat 2: Pluribus (10000 in chips)
Seat 3: Eddie (10000 in chips)
Seat 4: MrPink (10000 in chips)
Seat 5: MrOrange (10000 in chips)
Seat 6: MrBrown (10000 in chips)
MrBlue: posts small blind 50
Pluribus: posts big blind 100
*** HOLE CARDS ***
Dealt to MrBlue [7h 9h]
Dealt to Pluribus [Qd 2s]
Dealt to Eddie [4h Ah]
Dealt to MrPink [Td Kc]
Dealt to MrOrange [4c 9s]
Dealt to MrBrown [5s 3d]
Eddie: raises 100 to 200
MrPink: folds
MrOrange: folds
MrBrown: folds
MrBlue: calls 150
Pluribus: folds
*** FLOP *** [Kh 8h Jd]
MrBlue: checks
Eddie: bets 150
MrBlue: calls 150
*** TURN *** [Kh 8h Jd] [3s]
MrBlue: checks
Eddie: bets 1500
MrBlue: folds
Uncalled bet (1500) returned to Eddie
Eddie collected 800.0 from pot
*** SUMMARY ***
Total pot 800 | Rake 0
Board [Kh 8h Jd 3s]


PokerStars Hand #114173: Hold'em No Limit (50/100) - 2019/07/12 07:42:53 ET
Table 'Pluribus Session 114' 6-max (Play Money) Seat #6 is the button
Seat 1: Pluribus (10000 in chips)
Seat 2: Eddie (10000 in chips)
Seat 3: MrPink (10000 in chips)
Seat 4: MrOrange (10000 in chips)
Seat 5: MrBrown (10000 in chips)
Seat 6: MrBlue (10000 in chips)
Pluribus: posts small blind 50
Eddie: posts big blind 100
*** HOLE CARDS ***
Dealt to Pluribus [9d Jh]
Dealt to Eddie [4d 3c]
Dealt to MrPink [Td As]
Dealt to MrOrange [6h 7d]
Dealt to MrBrown [Tc Jc]
Dealt to MrBlue [6s 8c]
MrPink: raises 110 to 210
MrOrange: folds
MrBrown: calls 210
MrBlue: folds
Pluribus: folds
Eddie: folds
*** FLOP *** [3h Js Ac]
MrPink: checks
MrBrown: checks
*** TURN *** [3h Js Ac] [7c]
MrPink: checks
MrBrown: checks
*** RIVER *** [3h Js Ac] [7c] [2c]
MrPink: bets 350
MrBrown: raises 952 to 1302
MrPink: calls 952
*** SHOWDOWN ***
MrBrown: shows [Tc Jc]
MrBrown collected 3174.0 from pot
*** SUMMARY ***
Total pot 3174 | Rake 0
Board [3h Js Ac 7c 2c]
Seat 3: MrPink showed [Td As] and lost
Seat 5: MrBrown showed [Tc Jc] and won (3174.0)


PokerStars Hand #114174: Hold'em No Limit (50/100) - 2019/07/12 07:42:54 ET
Table 'Pluribus Session 114' 6-max (Play Money) Seat #6 is the button
Seat 1: Eddie (10000 in chips)
Seat 2: MrPink (10000 in chips)
Seat 3: MrOrange (10000 in chips)
Seat 4: MrBrown (10000 in chips)
Seat 5: MrBlue (10000 in chips)
Seat 6: Pluribus (10000 in chips)
Eddie: posts small blind 50
MrPink: posts big blind 100
*** HOLE CARDS ***
Dealt to Eddie [8s Jc]
Dealt to MrPink [7c 6d]
Dealt to MrOrange [5s 7d]
Dealt to MrBrown [Td 6s]
Dealt to MrBlue [Js Ks]
Dealt to Pluribus [7h Kd]
MrOrange: folds
MrBrown: folds
MrBlue: raises 125 to 225
Pluribus: folds
Eddie: folds
MrPink: calls 125
*** FLOP *** [As Ac 2s]
MrPink: checks
MrBlue: bets 250
MrPink: folds
Uncalled bet (250) returned to MrBlue
MrBlue collected 500.0 from pot
*** SUMMARY ***
Total pot 500 | Rake 0
Board [As Ac 2s]


PokerStars Hand #114175: Hold'em No Limit (50/100) - 2019/07/12 07:42:55 ET
Table 'Pluribus Session 114' 6-max (Play Money) Seat #6 is the button
Seat 1: MrPink (10000 in chips)
Seat 2: MrOrange (10000 in chips)
Seat 3: MrBrown (10000 in chips)
Seat 4: MrBlue (10000 in chips)
Seat 5: Pluribus (10000 in chips)
Seat 6: Eddie (10000 in chips)
MrPink: posts small blind 50
MrOrange: posts big blind 100
*** HOLE CARDS ***
Dealt to MrPink [Jd Ks]
Dealt to MrOrange [4d Ac]
Dealt to MrBrown [3h 8h]
Dealt to MrBlue [Ah 3s]
Dealt to Pluribus [Qs 4h]
Dealt to Eddie [2c As]
MrBrown: folds
MrBlue: folds
Pluribus: folds
Eddie: folds
MrPink: calls 50
MrOrange: raises 275 to 375
MrPink: calls 275
*** FLOP *** [5d 9d Jh]
MrPink: checks
MrOrange: checks
*** TURN *** [5d 9d Jh] [Ad]
MrPink: checks
MrOrange: checks
*** RIVER *** [5d 9d Jh] [Ad] [9h]
MrPink: checks
MrOrange: bets 420
MrPink: calls 420
*** SHOWDOWN ***
MrOrange: shows [4d Ac]
MrOrange collected 1590.0 from pot
*** SUMMARY ***
Total pot 1590 | Rake 0
Board [5d 9d Jh Ad 9h]
Seat 1: MrPink showed [Jd Ks] and lost
Seat 2: MrOrange showed [4d Ac] and won (1590.0)


PokerStars Hand #114176: Hold'em No Limit (50/100) - 2019/07/12 07:42:56 ET
Table 'Pluribus Session 114' 6-max (Play Money) Seat #6 is the button
Seat 1: MrOrange (10000 in chips)
Seat 2: MrBrown (10000 in chips)
Seat 3: MrBlue (10000 in chips)
Seat 4: Pluribus (10000 in chips)
Seat 5: Eddie (10000 in chips)
Seat 6: MrPink (10000 in chips)
MrOrange: posts small blind 50
MrBrown: posts big blind 100
*** HOLE CARDS ***
Dealt to MrOrange [5d 4s]
Dealt to MrBrown [Th 3c]
Dealt to MrBlue [7h 9s]
Dealt to Pluribus [9d 5c]
Dealt to Eddie [Ad 8d]
Dealt to MrPink [7d Jh]
MrBlue: folds
Pluribus: folds
Eddie: raises 110 to 210
MrPink: folds
MrOrange: folds
MrBrown: folds
Uncalled bet (110) returned to Eddie
Eddie collected 250.0 from pot
*** SUMMARY ***
Total pot 250 | Rake 0


PokerStars Hand #114177: Hold'em No Limit (50/100) - 2019/07/12 07:42:57 ET
Table 'Pluribus Session 114' 6-max (Play Money) Seat #6 is the button
Seat 1: MrBrown (10000 in chips)
Seat 2: MrBlue (10000 in chips)
Seat 3: Pluribus (10000 in chips)
Seat 4: Eddie (10000 in chips)
Seat 5: MrPink (10000 in chips)
Seat 6: MrOrange (10000 in chips)
MrBrown: posts small blind 50
MrBlue: posts big blind 100
*** HOLE CARDS ***
Dealt to MrBrown [7c 7h]
Dealt to MrBlue [Ks Js]
Dealt to Pluribus [Kd Tc]
Dealt to Eddie [5h Ac]
Dealt to MrPink [Kh 8h]
Dealt to MrOrange [Qc Jd]
Pluribus: folds
Eddie: folds
MrPink: raises 110 to 210
MrOrange: folds
MrBrown: calls 160
MrBlue: calls 110
*** FLOP *** [9s 8d 7s]
MrBrown: checks
MrBlue: checks
MrPink: checks
*** TURN *** [9s 8d 7s] [3h]
MrBrown: bets 472
MrBlue: raises 1068 to 1540
MrPink: folds
MrBrown: calls 1068
*** RIVER *** [9s 8d 7s] [3h] [4s]
MrBrown: checks
MrBlue: bets 3150
MrBrown: folds
Uncalled bet (3150) returned to MrBlue
MrBlue collected 3710.0 from pot
*** SUMMARY ***
Total pot 3710 | Rake 0
Board [9s 8d 7s 3h 4s]


PokerStars Hand #114178: Hold'em No Limit (50/100) - 2019/07/12 07:42:58 ET
Table 'Pluribus Session 114' 6-max (Play Money) Seat #6 is the button
Seat 1: MrBlue (10000 in chips)
Seat 2: Pluribus (10000 in chips)
Seat 3: Eddie (10000 in chips)
Seat 4: MrPink (10000 in chips)
Seat 5: MrOrange (10000 in chips)
Seat 6: MrBrown (10000 in chips)
MrBlue: posts small blind 50
Pluribus: posts big blind 100
*** HOLE CARDS ***
Dealt to MrBlue [2c 7s]
Dealt to Pluribus [6c 8h]
Dealt to Eddie [6d 3s]
Dealt to MrPink [7h Ac]
Dealt to MrOrange [3h 7d]
Dealt to MrBrown [Jh Kd]
Eddie: folds
MrPink: folds
MrOrange: folds
MrBrown: raises 150 to 250
MrBlue: folds
Pluribus: folds
Uncalled bet (150) returned to MrBrown
MrBrown collected 250.0 from pot
*** SUMMARY ***
Total pot 250 | Rake 0


PokerStars Hand #114179: Hold'em No Limit (50/100) - 2019/07/12 07:42:59 ET
Table 'Pluribus Session 114' 6-max (Play Money) Seat #6 is the button
Seat 1: Pluribus (10000 in chips)
Seat 2: Eddie (10000 in chips)
Seat 3: MrPink (10000 in chips)
Seat 4: MrOrange (10000 in chips)
Seat 5: MrBrown (10000 in chips)
Seat 6: MrBlue (10000 in chips)
Pluribus: posts small blind 50
Eddie: posts big blind 100
*** HOLE CARDS ***
Dealt to Pluribus [7c 8d]
Dealt to Eddie [4h Js]
Dealt to MrPink [4d 8c]
Dealt to MrOrange [8h Ts]
Dealt to MrBrown [9d Ad]
Dealt to MrBlue [8s 9s]
MrPink: folds
MrOrange: folds
MrBrown: raises 150 to 250
MrBlue: raises 550 to 800
Pluribus: folds
Eddie: folds
MrBrown: folds
Uncalled bet (550) returned to MrBlue
MrBlue collected 650.0 from pot
*** SUMMARY ***
Total pot 650 | Rake 0


PokerStars Hand #114180: Hold'em No Limit (50/100) - 2019/07/12 07:43:00 ET
Table 'Pluribus Session 114' 6-max (Play Money) Seat #6 is the button
Seat 1: Eddie (10000 in chips)
Seat 2: MrPink (10000 in chips)
Seat 3: MrOrange (10000 in chips)
Seat 4: MrBrown (10000 in chips)
Seat 5: MrBlue (10000 in chips)
Seat 6: Pluribus (10000 in chips)
Eddie: posts small blind 50
MrPink: posts big blind 100
*** HOLE CARDS ***
Dealt to Eddie [Kc Jc]
Dealt to MrPink [Jh 3h]
Dealt to MrOrange [Js Kh]
Dealt to MrBrown [Ts 5c]
Dealt to MrBlue [9c 9h]
Dealt to Pluribus [3s Th]
MrOrange: folds
MrBrown: folds
MrBlue: raises 125 to 225
Pluribus: folds
Eddie: raises 1025 to 1250
MrPink: folds
MrBlue: calls 1025
*** FLOP *** [5s 8c 8s]
Eddie: bets 1850
MrBlue: calls 1850
*** TURN *** [5s 8c 8s] [9s]
Eddie: checks
MrBlue: checks
*** RIVER *** [5s 8c 8s] [9s] [Ad]
Eddie: bets 1550
MrBlue: raises 5350 to 6900 and is all-in
Eddie: folds
Uncalled bet (5350) returned to MrBlue
MrBlue collected 9400.0 from pot
*** SUMMARY ***
Total pot 9400 | Rake 0
Board [5s 8c 8s 9s Ad]


PokerStars Hand #114181: Hold'em No Limit (50/100) - 2019/07/12 07:43:01 ET
Table 'Pluribus Session 114' 6-max (Play Money) Seat #6 is the button
Seat 1: MrPink (10000 in chips)
Seat 2: MrOrange (10000 in chips)
Seat 3: MrBrown (10000 in chips)
Seat 4: MrBlue (10000 in chips)
Seat 5: Pluribus (10000 in chips)
Seat 6: Eddie (10000 in chips)
MrPink: posts small blind 50
MrOrange: posts big blind 100
*** HOLE CARDS ***
Dealt to MrPink [5d 3d]
Dealt to MrOrange [2c Ad]
Dealt to MrBrown [Kd Js]
Dealt to MrBlue [6c 8c]
Dealt to Pluribus [3h Th]
Dealt to Eddie [6s 9s]
MrBrown: folds
MrBlue: folds
Pluribus: folds
Eddie: raises 125 to 225
MrPink: folds
MrOrange: calls 125
*** FLOP *** [Ah 7s Kc]
MrOrange: checks
Eddie: bets 100
MrOrange: calls 100
*** TURN *** [Ah 7s Kc] [4s]
MrOrange: checks
Eddie: bets 1400
MrOrange: folds
Uncalled bet (1400) returned to Eddie
Eddie collected 700.0 from pot
*** SUMMARY ***
Total pot 700 | Rake 0
Board [Ah 7s Kc 4s]


PokerStars Hand #114182: Hold'em No Limit (50/100) - 2019/07/12 07:43:02 ET
Table 'Pluribus Session 114' 6-max (Play Money) Seat #6 is the button
Seat 1: MrOrange (10000 in chips)
Seat 2: MrBrown (10000 in chips)
Seat 3: MrBlue (10000 in chips)
Seat 4: Pluribus (10000 in chips)
Seat 5: Eddie (10000 in chips)
Seat 6: MrPink (10000 in chips)
MrOrange: posts small blind 50
MrBrown: posts big blind 100
*** HOLE CARDS ***
Dealt to MrOrange [7h Ah]
Dealt to MrBrown [8s 2d]
Dealt to MrBlue [3s Td]
Dealt to Pluribus [3h Ks]
Dealt to Eddie [6d 5c]
Dealt to MrPink [Kc 5h]
MrBlue: folds
Pluribus: folds
Eddie: folds
MrPink: folds
MrOrange: raises 150 to 250
MrBrown: folds
Uncalled bet (150) returned to MrOrange
MrOrange collected 200.0 from pot
*** SUMMARY ***
Total pot 200 | Rake 0


PokerStars Hand #114183: Hold'em No Limit (50/100) - 2019/07/12 07:43:03 ET
Table 'Pluribus Session 114' 6-max (Play Money) Seat #6 is the button
Seat 1: MrBrown (10000 in chips)
Seat 2: MrBlue (10000 in chips)
Seat 3: Pluribus (10000 in chips)
Seat 4: Eddie (10000 in chips)
Seat 5: MrPink (10000 in chips)
Seat 6: MrOrange (10000 in chips)
MrBrown: posts small blind 50
MrBlue: posts big blind 100
*** HOLE CARDS ***
Dealt to MrBrown [Ts 6c]
Dealt to MrBlue [8d 2h]
Dealt to Pluribus [7c 5s]
Dealt to Eddie [Jd Th]
Dealt to MrPink [Kh 7h]
Dealt to MrOrange [Ah 2s]
Pluribus: folds
Eddie: raises 100 to 200
MrPink: folds
MrOrange: folds
MrBrown: folds
MrBlue: folds
Uncalled bet (100) returned to Eddie
Eddie collected 250.0 from pot
*** SUMMARY ***
Total pot 250 | Rake 0


PokerStars Hand #114184: Hold'em No Limit (50/100) - 2019/07/12 07:43:04 ET
Table 'Pluribus Session 114' 6-max (Play Money) Seat #6 is the button
Seat 1: MrBlue (10000 in chips)
Seat 2: Pluribus (10000 in chips)
Seat 3: Eddie (10000 in chips)
Seat 4: MrPink (10000 in chips)
Seat 5: MrOrange (10000 in chips)
Seat 6: MrBrown (10000 in chips)
MrBlue: posts small blind 50
Pluribus: posts big blind 100
*** HOLE CARDS ***
Dealt to MrBlue [3s Qd]
Dealt to Pluribus [7h Kh]
Dealt to Eddie [6s 5s]
Dealt to MrPink [6c 8s]
Dealt to MrOrange [5d Ks]
Dealt to MrBrown [8h 8c]
Eddie: raises 100 to 200
MrPink: folds
MrOrange: folds
MrBrown: calls 200
MrBlue: folds
Pluribus: raises 1300 to 1500
Eddie: calls 1300
MrBrown: folds
*** FLOP *** [Tc Jh 2d]
Pluribus: checks
Eddie: bets 1200
Pluribus: folds
Uncalled bet (1200) returned to Eddie
Eddie collected 3250.0 from pot
*** SUMMARY ***
Total pot 3250 | Rake 0
Board [Tc Jh 2d]


PokerStars Hand #114185: Hold'em No Limit (50/100) - 2019/07/12 07:43:05 ET
Table 'Pluribus Session 114' 6-max (Play Money) Seat #6 is the button
Seat 1: Pluribus (10000 in chips)
Seat 2: Eddie (10000 in chips)
Seat 3: MrPink (10000 in chips)
Seat 4: MrOrange (10000 in chips)
Seat 5: MrBrown (10000 in chips)
Seat 6: MrBlue (10000 in chips)
Pluribus: posts small blind 50
Eddie: posts big blind 100
*** HOLE CARDS ***
Dealt to Pluribus [7c Jc]
Dealt to Eddie [3c Td]
Dealt to MrPink [Ts 4c]
Dealt to MrOrange [Js Tc]
Dealt to MrBrown [2d 6s]
Dealt to MrBlue [Kh 6c]
MrPink: folds
MrOrange: folds
MrBrown: folds
MrBlue: folds
Pluribus: calls 50
Eddie: checks
*** FLOP *** [3d 2s 3h]
Pluribus: checks
Eddie: bets 100
Pluribus: folds
Uncalled bet (100) returned to Eddie
Eddie collected 200.0 from pot
*** SUMMARY ***
Total pot 200 | Rake 0
Board [3d 2s 3h]


PokerStars Hand #114186: Hold'em No Limit (50/100) - 2019/07/12 07:43:06 ET
Table 'Pluribus Session 114' 6-max (Play Money) Seat #6 is the button
Seat 1: Eddie (10000 in chips)
Seat 2: MrPink (10000 in chips)
Seat 3: MrOrange (10000 in chips)
Seat 4: MrBrown (10000 in chips)
Seat 5: MrBlue (10000 in chips)
Seat 6: Pluribus (10000 in chips)
Eddie: posts small blind 50
MrPink: posts big blind 100
*** HOLE CARDS ***
Dealt to Eddie [7d Kd]
Dealt to MrPink [3d Ad]
Dealt to MrOrange [Th Qs]
Dealt to MrBrown [3h Qc]
Dealt to MrBlue [2s Kc]
Dealt to Pluribus [9d 7c]
MrOrange: folds
MrBrown: folds
MrBlue: folds
Pluribus: folds
Eddie: raises 135 to 235
MrPink: calls 135
*** FLOP *** [Ks 6h Qd]
Eddie: checks
MrPink: checks
*** TURN *** [Ks 6h Qd] [As]
Eddie: checks
MrPink: checks
*** RIVER *** [Ks 6h Qd] [As] [Tc]
Eddie: checks
MrPink: bets 235
Eddie: folds
Uncalled bet (235) returned to MrPink
MrPink collected 470.0 from pot
*** SUMMARY ***
Total pot 470 | Rake 0
Board [Ks 6h Qd As Tc]


PokerStars Hand #114187: Hold'em No Limit (50/100) - 2019/07/12 07:43:07 ET
Table 'Pluribus Session 114' 6-max (Play Money) Seat #6 is the button
Seat 1: MrPink (10000 in chips)
Seat 2: MrOrange (10000 in chips)
Seat 3: MrBrown (10000 in chips)
Seat 4: MrBlue (10000 in chips)
Seat 5: Pluribus (10000 in chips)
Seat 6: Eddie (10000 in chips)
MrPink: posts small blind 50
MrOrange: posts big blind 100
*** HOLE CARDS ***
Dealt to MrPink [8c 7c]
Dealt to MrOrange [6s 3c]
Dealt to MrBrown [5s 9h]
Dealt to MrBlue [Kd 3d]
Dealt to Pluribus [Kc Kh]
Dealt to Eddie [3h 5c]
MrBrown: folds
MrBlue: folds
Pluribus: raises 187 to 287
Eddie: folds
MrPink: folds
MrOrange: folds
Uncalled bet (187) returned to Pluribus
Pluribus collected 250.0 from pot
*** SUMMARY ***
Total pot 250 | Rake 0


PokerStars Hand #114188: Hold'em No Limit (50/100) - 2019/07/12 07:43:08 ET
Table 'Pluribus Session 114' 6-max (Play Money) Seat #6 is the button
Seat 1: MrOrange (10000 in chips)
Seat 2: MrBrown (10000 in chips)
Seat 3: MrBlue (10000 in chips)
Seat 4: Pluribus (10000 in chips)
Seat 5: Eddie (10000 in chips)
Seat 6: MrPink (10000 in chips)
MrOrange: posts small blind 50
MrBrown: posts big blind 100
*** HOLE CARDS ***
Dealt to MrOrange [4c Ah]
Dealt to MrBrown [4d Jd]
Dealt to MrBlue [2s 3d]
Dealt to Pluribus [6d Qh]
Dealt to Eddie [As Qc]
Dealt to MrPink [2c Kd]
MrBlue: folds
Pluribus: folds
Eddie: raises 110 to 210
MrPink: folds
MrOrange: folds
MrBrown: calls 110
*** FLOP *** [Js 6s 3s]
MrBrown: checks
Eddie: checks
*** TURN *** [Js 6s 3s] [5d]
MrBrown: checks
Eddie: bets 200
MrBrown: calls 200
*** RIVER *** [Js 6s 3s] [5d] [Kh]
MrBrown: checks
Eddie: checks
*** SHOWDOWN ***
MrBrown: shows [4d Jd]
MrBrown collected 870.0 from pot
*** SUMMARY ***
Total pot 870 | Rake 0
Board [Js 6s 3s 5d Kh]
Seat 2: MrBrown showed [4d Jd] and won (870.0)
Seat 5: Eddie showed [As Qc] and lost


PokerStars Hand #114189: Hold'em No Limit (50/100) - 2019/07/12 07:43:09 ET
Table 'Pluribus Session 114' 6-max (Play Money) Seat #6 is the button
Seat 1: MrBrown (10000 in chips)
Seat 2: MrBlue (10000 in chips)
Seat 3: Pluribus (10000 in chips)
Seat 4: Eddie (10000 in chips)
Seat 5: MrPink (10000 in chips)
Seat 6: MrOrange (10000 in chips)
MrBrown: posts small blind 50
MrBlue: posts big blind 100
*** HOLE CARDS ***
Dealt to MrBrown [2c 9h]
Dealt to MrBlue [Kd 4s]
Dealt to Pluribus [4h 6c]
Dealt to Eddie [Js 7c]
Dealt to MrPink [8c As]
Dealt to MrOrange [Jc Kc]
Pluribus: folds
Eddie: folds
MrPink: raises 110 to 210
MrOrange: raises 490 to 700
MrBrown: folds
MrBlue: folds
MrPink: folds
Uncalled bet (490) returned to MrOrange
MrOrange collected 570.0 from pot
*** SUMMARY ***
Total pot 570 | Rake 0


PokerStars Hand #114190: Hold'em No Limit (50/100) - 2019/07/12 07:43:10 ET
Table 'Pluribus Session 114' 6-max (Play Money) Seat #6 is the button
Seat 1: MrBlue (10000 in chips)
Seat 2: Pluribus (10000 in chips)
Seat 3: Eddie (10000 in chips)
Seat 4: MrPink (10000 in chips)
Seat 5: MrOrange (10000 in chips)
Seat 6: MrBrown (10000 in chips)
MrBlue: posts small blind 50
Pluribus: posts big blind 100
*** HOLE CARDS ***
Dealt to MrBlue [Qd 4c]
Dealt to Pluribus [6h 9d]
Dealt to Eddie [7s 5c]
Dealt to MrPink [2d 6d]
Dealt to MrOrange [6s Kc]
Dealt to MrBrown [9s 5s]
Eddie: folds
MrPink: folds
MrOrange: folds
MrBrown: raises 150 to 250
MrBlue: folds
Pluribus: folds
Uncalled bet (150) returned to MrBrown
MrBrown collected 250.0 from pot
*** SUMMARY ***
Total pot 250 | Rake 0


PokerStars Hand #114191: Hold'em No Limit (50/100) - 2019/07/12 07:43:11 ET
Table 'Pluribus Session 114' 6-max (Play Money) Seat #6 is the button
Seat 1: Pluribus (10000 in chips)
Seat 2: Eddie (10000 in chips)
Seat 3: MrPink (10000 in chips)
Seat 4: MrOrange (10000 in chips)
Seat 5: MrBrown (10000 in chips)
Seat 6: MrBlue (10000 in chips)
Pluribus: posts small blind 50
Eddie: posts big blind 100
*** HOLE CARDS ***
Dealt to Pluribus [4h Th]
Dealt to Eddie [Qc 3h]
Dealt to MrPink [7h 9s]
Dealt to MrOrange [7c Jh]
Dealt to MrBrown [Kd Kh]
Dealt to MrBlue [2d Kc]
MrPink: folds
MrOrange: folds
MrBrown: raises 150 to 250
MrBlue: folds
Pluribus: folds
Eddie: folds
Uncalled bet (150) returned to MrBrown
MrBrown collected 250.0 from pot
*** SUMMARY ***
Total pot 250 | Rake 0


PokerStars Hand #114192: Hold'em No Limit (50/100) - 2019/07/12 07:43:12 ET
Table 'Pluribus Session 114' 6-max (Play Money) Seat #6 is the button
Seat 1: Eddie (10000 in chips)
Seat 2: MrPink (10000 in chips)
Seat 3: MrOrange (10000 in chips)
Seat 4: MrBrown (10000 in chips)
Seat 5: MrBlue (10000 in chips)
Seat 6: Pluribus (10000 in chips)
Eddie: posts small blind 50
MrPink: posts big blind 100
*** HOLE CARDS ***
Dealt to Eddie [Jc Ah]
Dealt to MrPink [3s 7d]
Dealt to MrOrange [2s 5c]
Dealt to MrBrown [Qs Js]
Dealt to MrBlue [Jh 4h]
Dealt to Pluribus [8c 2c]
MrOrange: folds
MrBrown: raises 150 to 250
MrBlue: folds
Pluribus: folds
Eddie: calls 200
MrPink: folds
*** FLOP *** [Kc 7h 2h]
Eddie: checks
MrBrown: bets 300
Eddie: raises 800 to 1100
MrBrown: folds
Uncalled bet (800) returned to Eddie
Eddie collected 1200.0 from pot
*** SUMMARY ***
Total pot 1200 | Rake 0
Board [Kc 7h 2h]


PokerStars Hand #114193: Hold'em No Limit (50/100) - 2019/07/12 07:43:13 ET
Table 'Pluribus Session 114' 6-max (Play Money) Seat #6 is the button
Seat 1: MrPink (10000 in chips)
Seat 2: MrOrange (10000 in chips)
Seat 3: MrBrown (10000 in chips)
Seat 4: MrBlue (10000 in chips)
Seat 5: Pluribus (10000 in chips)
Seat 6: Eddie (10000 in chips)
MrPink: posts small blind 50
MrOrange: posts big blind 100
*** HOLE CARDS ***
Dealt to MrPink [6h 5c]
Dealt to MrOrange [8d 3c]
Dealt to MrBrown [Td Jd]
Dealt to MrBlue [Kh 4h]
Dealt to Pluribus [3h 4s]
Dealt to Eddie [Qh 2s]
MrBrown: raises 150 to 250
MrBlue: folds
Pluribus: folds
Eddie: folds
MrPink: folds
MrOrange: folds
Uncalled bet (150) returned to MrBrown
MrBrown collected 250.0 from pot
*** SUMMARY ***
Total pot 250 | Rake 0


PokerStars Hand #114194: Hold'em No Limit (50/100) - 2019/07/12 07:43:14 ET
Table 'Pluribus Session 114' 6-max (Play Money) Seat #6 is the button
Seat 1: MrOrange (10000 in chips)
Seat 2: MrBrown (10000 in chips)
Seat 3: MrBlue (10000 in chips)
Seat 4: Pluribus (10000 in chips)
Seat 5: Eddie (10000 in chips)
Seat 6: MrPink (10000 in chips)
MrOrange: posts small blind 50
MrBrown: posts big blind 100
*** HOLE CARDS ***
Dealt to MrOrange [5d Th]
Dealt to MrBrown [Ts Ah]
Dealt to MrBlue [7h Ad]
Dealt to Pluribus [7d 6c]
Dealt to Eddie [9h Qc]
Dealt to MrPink [Kc 2s]
MrBlue: folds
Pluribus: folds
Eddie: folds
MrPink: folds
MrOrange: folds
Uncalled bet (50) returned to MrBrown
MrBrown collected 100.0 from pot
*** SUMMARY ***
Total pot 100 | Rake 0


PokerStars Hand #114195: Hold'em No Limit (50/100) - 2019/07/12 07:43:15 ET
Table 'Pluribus Session 114' 6-max (Play Money) Seat #6 is the button
Seat 1: MrBrown (10000 in chips)
Seat 2: MrBlue (10000 in chips)
Seat 3: Pluribus (10000 in chips)
Seat 4: Eddie (10000 in chips)
Seat 5: MrPink (10000 in chips)
Seat 6: MrOrange (10000 in chips)
MrBrown: posts small blind 50
MrBlue: posts big blind 100
*** HOLE CARDS ***
Dealt to MrBrown [3c Jc]
Dealt to MrBlue [9d 3s]
Dealt to Pluribus [Qd 7s]
Dealt to Eddie [Qc 8h]
Dealt to MrPink [Jd Jh]
Dealt to MrOrange [7h Kd]
Pluribus: folds
Eddie: folds
MrPink: raises 110 to 210
MrOrange: folds
MrBrown: folds
MrBlue: folds
Uncalled bet (110) returned to MrPink
MrPink collected 250.0 from pot
*** SUMMARY ***
Total pot 250 | Rake 0


PokerStars Hand #114196: Hold'em No Limit (50/100) - 2019/07/12 07:43:16 ET
Table 'Pluribus Session 114' 6-max (Play Money) Seat #6 is the button
Seat 1: MrBlue (10000 in chips)
Seat 2: Pluribus (10000 in chips)
Seat 3: Eddie (10000 in chips)
Seat 4: MrPink (10000 in chips)
Seat 5: MrOrange (10000 in chips)
Seat 6: MrBrown (10000 in chips)
MrBlue: posts small blind 50
Pluribus: posts big blind 100
*** HOLE CARDS ***
Dealt to MrBlue [4s Ks]
Dealt to Pluribus [7s Qs]
Dealt to Eddie [5h Jd]
Dealt to MrPink [3h 6c]
Dealt to MrOrange [Td 8d]
Dealt to MrBrown [Ac 2d]
Eddie: folds
MrPink: folds
MrOrange: folds
MrBrown: raises 150 to 250
MrBlue: folds
Pluribus: calls 150
*** FLOP *** [8c 5d Js]
Pluribus: checks
MrBrown: checks
*** TURN *** [8c 5d Js] [Th]
Pluribus: bets 137
MrBrown: folds
Uncalled bet (137) returned to Pluribus
Pluribus collected 550.0 from pot
*** SUMMARY ***
Total pot 550 | Rake 0
Board [8c 5d Js Th]


PokerStars Hand #114197: Hold'em No Limit (50/100) - 2019/07/12 07:43:17 ET
Table 'Pluribus Session 114' 6-max (Play Money) Seat #6 is the button
Seat 1: Pluribus (10000 in chips)
Seat 2: Eddie (10000 in chips)
Seat 3: MrPink (10000 in chips)
Seat 4: MrOrange (10000 in chips)
Seat 5: MrBrown (10000 in chips)
Seat 6: MrBlue (10000 in chips)
Pluribus: posts small blind 50
Eddie: posts big blind 100
*** HOLE CARDS ***
Dealt to Pluribus [2d Qd]
Dealt to Eddie [8h 5s]
Dealt to MrPink [7s 9s]
Dealt to MrOrange [Kh 5d]
Dealt to MrBrown [8d 3s]
Dealt to MrBlue [6c Qc]
MrPink: folds
MrOrange: folds
MrBrown: folds
MrBlue: raises 125 to 225
Pluribus: folds
Eddie: folds
Uncalled bet (125) returned to MrBlue
MrBlue collected 250.0 from pot
*** SUMMARY ***
Total pot 250 | Rake 0


PokerStars Hand #114198: Hold'em No Limit (50/100) - 2019/07/12 07:43:18 ET
Table 'Pluribus Session 114' 6-max (Play Money) Seat #6 is the button
Seat 1: Eddie (10000 in chips)
Seat 2: MrPink (10000 in chips)
Seat 3: MrOrange (10000 in chips)
Seat 4: MrBrown (10000 in chips)
Seat 5: MrBlue (10000 in chips)
Seat 6: Pluribus (10000 in chips)
Eddie: posts small blind 50
MrPink: posts big blind 100
*** HOLE CARDS ***
Dealt to Eddie [Jd 2c]
Dealt to MrPink [2h 6c]
Dealt to MrOrange [Tc 9h]
Dealt to MrBrown [Qh 6d]
Dealt to MrBlue [Qc Jh]
Dealt to Pluribus [5h Qs]
MrOrange: folds
MrBrown: folds
MrBlue: raises 125 to 225
Pluribus: folds
Eddie: folds
MrPink: folds
Uncalled bet (125) returned to MrBlue
MrBlue collected 250.0 from pot
*** SUMMARY ***
Total pot 250 | Rake 0


PokerStars Hand #114199: Hold'em No Limit (50/100) - 2019/07/12 07:43:19 ET
Table 'Pluribus Session 114' 6-max (Play Money) Seat #6 is the button
Seat 1: MrPink (10000 in chips)
Seat 2: MrOrange (10000 in chips)
Seat 3: MrBrown (10000 in chips)
Seat 4: MrBlue (10000 in chips)
Seat 5: Pluribus (10000 in chips)
Seat 6: Eddie (10000 in chips)
MrPink: posts small blind 50
MrOrange: posts big blind 100
*** HOLE CARDS ***
Dealt to MrPink [7s 8d]
Dealt to MrOrange [Tc Qs]
Dealt to MrBrown [8c Qd]
Dealt to MrBlue [Qc 7d]
Dealt to Pluribus [4d 3d]
Dealt to Eddie [Js 2d]
MrBrown: folds
MrBlue: folds
Pluribus: folds
Eddie: folds
MrPink: calls 50
MrOrange: checks
*** FLOP *** [2c 5s Kd]
MrPink: bets 100
MrOrange: calls 100
*** TURN *** [2c 5s Kd] [Kc]
MrPink: bets 200
MrOrange: calls 200
*** RIVER *** [2c 5s Kd] [Kc] [Ks]
MrPink: checks
MrOrange: checks
*** SHOWDOWN ***
MrOrange: shows [Tc Qs]
MrOrange collected 800.0 from pot
*** SUMMARY ***
Total pot 800 | Rake 0
Board [2c 5s Kd Kc Ks]
Seat 1: MrPink showed [7s 8d] and lost
Seat 2: MrOrange showed [Tc Qs] and won (800.0)


PokerStars Hand #114200: Hold'em No Limit (50/100) - 2019/07/12 07:43:20 ET
Table 'Pluribus Session 114' 6-max (Play Money) Seat #6 is the button
Seat 1: MrOrange (10000 in chips)
Seat 2: MrBrown (10000 in chips)
Seat 3: MrBlue (10000 in chips)
Seat 4: Pluribus (10000 in chips)
Seat 5: Eddie (10000 in chips)
Seat 6: MrPink (10000 in chips)
MrOrange: posts small blind 50
MrBrown: posts big blind 100
*** HOLE CARDS ***
Dealt to MrOrange [Ks 8c]
Dealt to MrBrown [3h 8d]
Dealt to MrBlue [3c Ad]
Dealt to Pluribus [Kd 4d]
Dealt to Eddie [Kc Qh]
Dealt to MrPink [9c 5h]
MrBlue: folds
Pluribus: folds
Eddie: raises 110 to 210
MrPink: folds
MrOrange: folds
MrBrown: folds
Uncalled bet (110) returned to Eddie
Eddie collected 250.0 from pot
*** SUMMARY ***
Total pot 250 | Rake 0


PokerStars Hand #114201: Hold'em No Limit (50/100) - 2019/07/12 07:43:21 ET
Table 'Pluribus Session 114' 6-max (Play Money) Seat #6 is the button
Seat 1: MrBrown (10000 in chips)
Seat 2: MrBlue (10000 in chips)
Seat 3: Pluribus (10000 in chips)
Seat 4: Eddie (10000 in chips)
Seat 5: MrPink (10000 in chips)
Seat 6: MrOrange (10000 in chips)
MrBrown: posts small blind 50
MrBlue: posts big blind 100
*** HOLE CARDS ***
Dealt to MrBrown [Td Js]
Dealt to MrBlue [8s 7s]
Dealt to Pluribus [5c 4c]
Dealt to Eddie [6h Tc]
Dealt to MrPink [Kh 5h]
Dealt to MrOrange [5s 3h]
Pluribus: folds
Eddie: folds
MrPink: raises 110 to 210
MrOrange: folds
MrBrown: folds
MrBlue: raises 840 to 1050
MrPink: folds
Uncalled bet (840) returned to MrBlue
MrBlue collected 470.0 from pot
*** SUMMARY ***
Total pot 470 | Rake 0


PokerStars Hand #114202: Hold'em No Limit (50/100) - 2019/07/12 07:43:22 ET
Table 'Pluribus Session 114' 6-max (Play Money) Seat #6 is the button
Seat 1: MrBlue (10000 in chips)
Seat 2: Pluribus (10000 in chips)
Seat 3: Eddie (10000 in chips)
Seat 4: MrPink (10000 in chips)
Seat 5: MrOrange (10000 in chips)
Seat 6: MrBrown (10000 in chips)
MrBlue: posts small blind 50
Pluribus: posts big blind 100
*** HOLE CARDS ***
Dealt to MrBlue [Kh 4h]
Dealt to Pluribus [7d 6c]
Dealt to Eddie [4d 2c]
Dealt to MrPink [Ts Js]
Dealt to MrOrange [3d 9s]
Dealt to MrBrown [As Tc]
Eddie: folds
MrPink: raises 110 to 210
MrOrange: folds
MrBrown: raises 440 to 650
MrBlue: folds
Pluribus: folds
MrPink: calls 440
*** FLOP *** [8s 3c 5h]
MrPink: checks
MrBrown: bets 600
MrPink: folds
Uncalled bet (600) returned to MrBrown
MrBrown collected 1450.0 from pot
*** SUMMARY ***
Total pot 1450 | Rake 0
Board [8s 3c 5h]


PokerStars Hand #114203: Hold'em No Limit (50/100) - 2019/07/12 07:43:23 ET
Table 'Pluribus Session 114' 6-max (Play Money) Seat #6 is the button
Seat 1: Pluribus (10000 in chips)
Seat 2: Eddie (10000 in chips)
Seat 3: MrPink (10000 in chips)
Seat 4: MrOrange (10000 in chips)
Seat 5: MrBrown (10000 in chips)
Seat 6: MrBlue (10000 in chips)
Pluribus: posts small blind 50
Eddie: posts big blind 100
*** HOLE CARDS ***
Dealt to Pluribus [7s 8c]
Dealt to Eddie [As Tc]
Dealt to MrPink [9h Qs]
Dealt to MrOrange [5c Qh]
Dealt to MrBrown [5h Th]
Dealt to MrBlue [Jd 7c]
MrPink: folds
MrOrange: folds
MrBrown: folds
MrBlue: folds
Pluribus: raises 100 to 200
Eddie: calls 100
*** FLOP *** [9s 6h 2d]
Pluribus: bets 800
Eddie: folds
Uncalled bet (800) returned to Pluribus
Pluribus collected 400.0 from pot
*** SUMMARY ***
Total pot 400 | Rake 0
Board [9s 6h 2d]


PokerStars Hand #114204: Hold'em No Limit (50/100) - 2019/07/12 07:43:24 ET
Table 'Pluribus Session 114' 6-max (Play Money) Seat #6 is the button
Seat 1: Eddie (10000 in chips)
Seat 2: MrPink (10000 in chips)
Seat 3: MrOrange (10000 in chips)
Seat 4: MrBrown (10000 in chips)
Seat 5: MrBlue (10000 in chips)
Seat 6: Pluribus (10000 in chips)
Eddie: posts small blind 50
MrPink: posts big blind 100
*** HOLE CARDS ***
Dealt to Eddie [4c 8d]
Dealt to MrPink [Tc 8h]
Dealt to MrOrange [2s 9c]
Dealt to MrBrown [Qd 8c]
Dealt to MrBlue [6c 5s]
Dealt to Pluribus [9s Kd]
MrOrange: folds
MrBrown: folds
MrBlue: folds
Pluribus: raises 125 to 225
Eddie: folds
MrPink: calls 125
*** FLOP *** [Qs 9h 6s]
MrPink: checks
Pluribus: checks
*** TURN *** [Qs 9h 6s] [Ac]
MrPink: checks
Pluribus: bets 125
MrPink: calls 125
*** RIVER *** [Qs 9h 6s] [Ac] [Jh]
MrPink: checks
Pluribus: checks
*** SHOWDOWN ***
MrPink: shows [Tc 8h]
MrPink collected 750.0 from pot
*** SUMMARY ***
Total pot 750 | Rake 0
Board [Qs 9h 6s Ac Jh]
Seat 2: MrPink showed [Tc 8h] and won (750.0)
Seat 6: Pluribus showed [9s Kd] and lost


PokerStars Hand #114205: Hold'em No Limit (50/100) - 2019/07/12 07:43:25 ET
Table 'Pluribus Session 114' 6-max (Play Money) Seat #6 is the button
Seat 1: MrPink (10000 in chips)
Seat 2: MrOrange (10000 in chips)
Seat 3: MrBrown (10000 in chips)
Seat 4: MrBlue (10000 in chips)
Seat 5: Pluribus (10000 in chips)
Seat 6: Eddie (10000 in chips)
MrPink: posts small blind 50
MrOrange: posts big blind 100
*** HOLE CARDS ***
Dealt to MrPink [6h 4c]
Dealt to MrOrange [7c 2h]
Dealt to MrBrown [Qh 7d]
Dealt to MrBlue [Ac 8h]
Dealt to Pluribus [Jc 4s]
Dealt to Eddie [5h 3c]
MrBrown: folds
MrBlue: folds
Pluribus: folds
Eddie: folds
MrPink: folds
Uncalled bet (50) returned to MrOrange
MrOrange collected 100.0 from pot
*** SUMMARY ***
Total pot 100 | Rake 0


PokerStars Hand #114206: Hold'em No Limit (50/100) - 2019/07/12 07:43:26 ET
Table 'Pluribus Session 114' 6-max (Play Money) Seat #6 is the button
Seat 1: MrOrange (10000 in chips)
Seat 2: MrBrown (10000 in chips)
Seat 3: MrBlue (10000 in chips)
Seat 4: Pluribus (10000 in chips)
Seat 5: Eddie (10000 in chips)
Seat 6: MrPink (10000 in chips)
MrOrange: posts small blind 50
MrBrown: posts big blind 100
*** HOLE CARDS ***
Dealt to MrOrange [Jh 3c]
Dealt to MrBrown [Jd 3s]
Dealt to MrBlue [2c 5c]
Dealt to Pluribus [9d 7h]
Dealt to Eddie [9c 6s]
Dealt to MrPink [Qd As]
MrBlue: folds
Pluribus: folds
Eddie: folds
MrPink: raises 150 to 250
MrOrange: folds
MrBrown: folds
Uncalled bet (150) returned to MrPink
MrPink collected 250.0 from pot
*** SUMMARY ***
Total pot 250 | Rake 0


PokerStars Hand #114207: Hold'em No Limit (50/100) - 2019/07/12 07:43:27 ET
Table 'Pluribus Session 114' 6-max (Play Money) Seat #6 is the button
Seat 1: MrBrown (10000 in chips)
Seat 2: MrBlue (10000 in chips)
Seat 3: Pluribus (10000 in chips)
Seat 4: Eddie (10000 in chips)
Seat 5: MrPink (10000 in chips)
Seat 6: MrOrange (10000 in chips)
MrBrown: posts small blind 50
MrBlue: posts big blind 100
*** HOLE CARDS ***
Dealt to MrBrown [2d 3h]
Dealt to MrBlue [4s 8s]
Dealt to Pluribus [7d 3d]
Dealt to Eddie [Ks 5s]
Dealt to MrPink [5c Jd]
Dealt to MrOrange [Tc Qc]
Pluribus: folds
Eddie: raises 100 to 200
MrPink: folds
MrOrange: folds
MrBrown: folds
MrBlue: calls 100
*** FLOP *** [5h 5d 9s]
MrBlue: checks
Eddie: bets 135
MrBlue: folds
Uncalled bet (135) returned to Eddie
Eddie collected 450.0 from pot
*** SUMMARY ***
Total pot 450 | Rake 0
Board [5h 5d 9s]


PokerStars Hand #114208: Hold'em No Limit (50/100) - 2019/07/12 07:43:28 ET
Table 'Pluribus Session 114' 6-max (Play Money) Seat #6 is the button
Seat 1: MrBlue (10000 in chips)
Seat 2: Pluribus (10000 in chips)
Seat 3: Eddie (10000 in chips)
Seat 4: MrPink (10000 in chips)
Seat 5: MrOrange (10000 in chips)
Seat 6: MrBrown (10000 in chips)
MrBlue: posts small blind 50
Pluribus: posts big blind 100
*** HOLE CARDS ***
Dealt to MrBlue [9c 9s]
Dealt to Pluribus [2d Qd]
Dealt to Eddie [Qh 2h]
Dealt to MrPink [2c 8s]
Dealt to MrOrange [Kh 3d]
Dealt to MrBrown [Kc Kd]
Eddie: folds
MrPink: folds
MrOrange: folds
MrBrown: raises 150 to 250
MrBlue: calls 200
Pluribus: calls 150
*** FLOP *** [5c Ks 5s]
MrBlue: checks
Pluribus: checks
MrBrown: bets 375
MrBlue: calls 375
Pluribus: folds
*** TURN *** [5c Ks 5s] [3h]
MrBlue: checks
MrBrown: checks
*** RIVER *** [5c Ks 5s] [3h] [7h]
MrBlue: checks
MrBrown: bets 500
MrBlue: folds
Uncalled bet (500) returned to MrBrown
MrBrown collected 1500.0 from pot
*** SUMMARY ***
Total pot 1500 | Rake 0
Board [5c Ks 5s 3h 7h]
