PokerStars Hand #43000: Hold'em No Limit (50/100) - 2019/07/11 11:56:40 ET
Table 'Pluribus Session 43' 6-max (Play Money) Seat #6 is the button
Seat 1: Eddie (10000 in chips)
Seat 2: MrBrown (10000 in chips)
Seat 3: MrBlue (10000 in chips)
Seat 4: Bill (10000 in chips)
Seat 5: MrPink (10000 in chips)
Seat 6: Pluribus (10000 in chips)
Eddie: posts small blind 50
MrBrown: posts big blind 100
*** HOLE CARDS ***
Dealt to Eddie [6c Ac]
Dealt to MrBrown [8s Ks]
Dealt to MrBlue [Kh 9h]
Dealt to Bill [7d Qh]
Dealt to MrPink [Td Th]
Dealt to Pluribus [Ts Qs]
MrBlue: raises 125 to 225
Bill: folds
MrPink: raises 475 to 700
Pluribus: folds
Eddie: folds
MrBrown: folds
MrBlue: folds
Uncalled bet (475) returned to MrPink
MrPink collected 600.0 from pot
*** SUMMARY ***
Total pot 600 | Rake 0


PokerStars Hand #43001: Hold'em No Limit (50/100) - 2019/07/11 11:56:41 ET
Table 'Pluribus Session 43' 6-max (Play Money) Seat #6 is the button
Seat 1: MrBrown (10000 in chips)
Seat 2: MrBlue (10000 in chips)
Seat 3: Bill (10000 in chips)
Seat 4: MrPink (10000 in chips)
Seat 5: Pluribus (10000 in chips)
Seat 6: Eddie (10000 in chips)
MrBrown: posts small blind 50
MrBlue: posts big blind 100
*** HOLE CARDS ***
Dealt to MrBrown [Qd 2c]
Dealt to MrBlue [6s 9h]
Dealt to Bill [4s Js]
Dealt to MrPink [Jh Kh]
Dealt to Pluribus [Kc Jc]
Dealt to Eddie [5c 4d]
Bill: folds
MrPink: raises 110 to 210
Pluribus: calls 210
Eddie: folds
MrBrown: folds
MrBlue: calls 110
*** FLOP *** [4h 8h 5d]
MrBlue: checks
MrPink: checks
Pluribus: checks
*** TURN *** [4h 8h 5d] [4c]
MrBlue: checks
MrPink: bets 340
Pluribus: folds
MrBlue: folds
Uncalled bet (340) returned to MrPink
MrPink collected 680.0 from pot
*** SUMMARY ***
Total pot 680 | Rake 0
Board [4h 8h 5d 4c]


PokerStars Hand #43002: Hold'em No Limit (50/100) - 2019/07/11 11:56:42 ET
Table 'Pluribus Session 43' 6-max (Play Money) Seat #6 is the button
Seat 1: MrBlue (10000 in chips)
Seat 2: Bill (10000 in chips)
Seat 3: MrPink (10000 in chips)
Seat 4: Pluribus (10000 in chips)
Seat 5: Eddie (10000 in chips)
Seat 6: MrBrown (10000 in chips)
MrBlue: posts small blind 50
Bill: posts big blind 100
*** HOLE CARDS ***
Dealt to MrBlue [5d 9c]
Dealt to Bill [4s 7s]
Dealt to MrPink [Qc Jc]
Dealt to Pluribus [Jd 8s]
Dealt to Eddie [Ah 5s]
Dealt to MrBrown [4c Tc]
MrPink: raises 110 to 210
Pluribus: folds
Eddie: folds
MrBrown: folds
MrBlue: folds
Bill: calls 110
*** FLOP *** [3s 7c 8d]
Bill: checks
MrPink: checks
*** TURN *** [3s 7c 8d] [3d]
Bill: bets 235
MrPink: folds
Uncalled bet (235) returned to Bill
Bill collected 470.0 from pot
*** SUMMARY ***
Total pot 470 | Rake 0
Board [3s 7c 8d 3d]


PokerStars Hand #43003: Hold'em No Limit (50/100) - 2019/07/11 11:56:43 ET
Table 'Pluribus Session 43' 6-max (Play Money) Seat #6 is the button
Seat 1: Bill (10000 in chips)
Seat 2: MrPink (10000 in chips)
Seat 3: Pluribus (10000 in chips)
Seat 4: Eddie (10000 in chips)
Seat 5: MrBrown (10000 in chips)
Seat 6: MrBlue (10000 in chips)
Bill: posts small blind 50
MrPink: posts big blind 100
*** HOLE CARDS ***
Dealt to Bill [2c 4h]
Dealt to MrPink [Js 4d]
Dealt to Pluribus [8h Th]
Dealt to Eddie [Tc 7d]
Dealt to MrBrown [6s Jh]
Dealt to MrBlue [8d 7s]
Pluribus: raises 100 to 200
Eddie: folds
MrBrown: folds
MrBlue: folds
Bill: folds
MrPink: folds
Uncalled bet (100) returned to Pluribus
Pluribus collected 250.0 from pot
*** SUMMARY ***
Total pot 250 | Rake 0


PokerStars Hand #43004: Hold'em No Limit (50/100) - 2019/07/11 11:56:44 ET
Table 'Pluribus Session 43' 6-max (Play Money) Seat #6 is the button
Seat 1: MrPink (10000 in chips)
Seat 2: Pluribus (10000 in chips)
Seat 3: Eddie (10000 in chips)
Seat 4: MrBrown (10000 in chips)
Seat 5: MrBlue (10000 in chips)
Seat 6: Bill (10000 in chips)
MrPink: posts small blind 50
Pluribus: posts big blind 100
*** HOLE CARDS ***
Dealt to MrPink [7c 5c]
Dealt to Pluribus [Qc 2d]
Dealt to Eddie [2h Ac]
Dealt to MrBrown [4d Kd]
Dealt to MrBlue [3h 9s]
Dealt to Bill [4s 6h]
Eddie: folds
MrBrown: folds
MrBlue: folds
Bill: folds
MrPink: raises 200 to 300
Pluribus: folds
Uncalled bet (200) returned to MrPink
MrPink collected 200.0 from pot
*** SUMMARY ***
Total pot 200 | Rake 0


PokerStars Hand #43005: Hold'em No Limit (50/100) - 2019/07/11 11:56:45 ET
Table 'Pluribus Session 43' 6-max (Play Money) Seat #6 is the button
Seat 1: Pluribus (10000 in chips)
Seat 2: Eddie (10000 in chips)
Seat 3: MrBrown (10000 in chips)
Seat 4: MrBlue (10000 in chips)
Seat 5: Bill (10000 in chips)
Seat 6: MrPink (10000 in chips)
Pluribus: posts small blind 50
Eddie: posts big blind 100
*** HOLE CARDS ***
Dealt to Pluribus [Kc As]
Dealt to Eddie [Tc 6c]
Dealt to MrBrown [8d 3h]
Dealt to MrBlue [Qd Ts]
Dealt to Bill [7s 8c]
Dealt to MrPink [8s 5s]
MrBrown: folds
MrBlue: folds
Bill: folds
MrPink: raises 150 to 250
Pluribus: raises 900 to 1150
Eddie: folds
MrPink: folds
Uncalled bet (900) returned to Pluribus
Pluribus collected 600.0 from pot
*** SUMMARY ***
Total pot 600 | Rake 0


PokerStars Hand #43006: Hold'em No Limit (50/100) - 2019/07/11 11:56:46 ET
Table 'Pluribus Session 43' 6-max (Play Money) Seat #6 is the button
Seat 1: Eddie (10000 in chips)
Seat 2: MrBrown (10000 in chips)
Seat 3: MrBlue (10000 in chips)
Seat 4: Bill (10000 in chips)
Seat 5: MrPink (10000 in chips)
Seat 6: Pluribus (10000 in chips)
Eddie: posts small blind 50
MrBrown: posts big blind 100
*** HOLE CARDS ***
Dealt to Eddie [Qc 5c]
Dealt to MrBrown [5h 6s]
Dealt to MrBlue [6d 4s]
Dealt to Bill [Ah Th]
Dealt to MrPink [Tc 6c]
Dealt to Pluribus [Ad Kc]
MrBlue: folds
Bill: raises 125 to 225
MrPink: folds
Pluribus: raises 600 to 825
Eddie: folds
MrBrown: folds
Bill: calls 600
*** FLOP *** [7h 5d Qd]
Bill: checks
Pluribus: bets 900
Bill: calls 900
*** TURN *** [7h 5d Qd] [7s]
Bill: checks
Pluribus: checks
*** RIVER *** [7h 5d Qd] [7s] [9h]
Bill: checks
Pluribus: checks
*** SHOWDOWN ***
Pluribus: shows [Ad Kc]
Pluribus collected 3600.0 from pot
*** SUMMARY ***
Total pot 3600 | Rake 0
Board [7h 5d Qd 7s 9h]
Seat 4: Bill showed [Ah Th] and lost
Seat 6: Pluribus showed [Ad Kc] and won (3600.0)


PokerStars Hand #43007: Hold'em No Limit (50/100) - 2019/07/11 11:56:47 ET
Table 'Pluribus Session 43' 6-max (Play Money) Seat #6 is the button
Seat 1: MrBrown (10000 in chips)
Seat 2: MrBlue (10000 in chips)
Seat 3: Bill (10000 in chips)
Seat 4: MrPink (10000 in chips)
Seat 5: Pluribus (10000 in chips)
Seat 6: Eddie (10000 in chips)
MrBrown: posts small blind 50
MrBlue: posts big blind 100
*** HOLE CARDS ***
Dealt to MrBrown [6s 7s]
Dealt to MrBlue [9c 5s]
Dealt to Bill [3s 9h]
Dealt to MrPink [Ad 3h]
Dealt to Pluribus [2d Ts]
Dealt to Eddie [Qc 2h]
Bill: folds
MrPink: folds
Pluribus: folds
Eddie: folds
MrBrown: calls 50
MrBlue: checks
*** FLOP *** [6c Jd 5h]
MrBrown: checks
MrBlue: checks
*** TURN *** [6c Jd 5h] [7c]
MrBrown: bets 200
MrBlue: folds
Uncalled bet (200) returned to MrBrown
MrBrown collected 200.0 from pot
*** SUMMARY ***
Total pot 200 | Rake 0
Board [6c Jd 5h 7c]


PokerStars Hand #43008: Hold'em No Limit (50/100) - 2019/07/11 11:56:48 ET
Table 'Pluribus Session 43' 6-max (Play Money) Seat #6 is the button
Seat 1: MrBlue (10000 in chips)
Seat 2: Bill (10000 in chips)
Seat 3: MrPink (10000 in chips)
Seat 4: Pluribus (10000 in chips)
Seat 5: Eddie (10000 in chips)
Seat 6: MrBrown (10000 in chips)
MrBlue: posts small blind 50
Bill: posts big blind 100
*** HOLE CARDS ***
Dealt to MrBlue [Ac 5h]
Dealt to Bill [9d 5s]
Dealt to MrPink [As Qs]
Dealt to Pluribus [Ah 7s]
Dealt to Eddie [Th 2h]
Dealt to MrBrown [2c 5c]
MrPink: raises 110 to 210
Pluribus: folds
Eddie: folds
MrBrown: folds
MrBlue: folds
Bill: folds
Uncalled bet (110) returned to MrPink
MrPink collected 250.0 from pot
*** SUMMARY ***
Total pot 250 | Rake 0


PokerStars Hand #43009: Hold'em No Limit (50/100) - 2019/07/11 11:56:49 ET
Table 'Pluribus Session 43' 6-max (Play Money) Seat #6 is the button
Seat 1: Bill (10000 in chips)
Seat 2: MrPink (10000 in chips)
Seat 3: Pluribus (10000 in chips)
Seat 4: Eddie (10000 in chips)
Seat 5: MrBrown (10000 in chips)
Seat 6: MrBlue (10000 in chips)
Bill: posts small blind 50
MrPink: posts big blind 100
*** HOLE CARDS ***
Dealt to Bill [6d 3s]
Dealt to MrPink [3d 5h]
Dealt to Pluribus [Kh 9c]
Dealt to Eddie [7c 7d]
Dealt to MrBrown [9d 2d]
Dealt to MrBlue [8c 5s]
Pluribus: folds
Eddie: raises 100 to 200
MrBrown: folds
MrBlue: folds
Bill: folds
MrPink: calls 100
*** FLOP *** [6s 2s 4s]
MrPink: checks
Eddie: checks
*** TURN *** [6s 2s 4s] [7h]
MrPink: bets 150
Eddie: raises 500 to 650
MrPink: calls 500
*** RIVER *** [6s 2s 4s] [7h] [8h]
MrPink: checks
Eddie: checks
*** SHOWDOWN ***
MrPink: shows [3d 5h]
MrPink collected 1750.0 from pot
*** SUMMARY ***
Total pot 1750 | Rake 0
Board [6s 2s 4s 7h 8h]
Seat 2: MrPink showed [3d 5h] and won (1750.0)
Seat 4: Eddie showed [7c 7d] and lost


PokerStars Hand #43010: Hold'em No Limit (50/100) - 2019/07/11 11:56:50 ET
Table 'Pluribus Session 43' 6-max (Play Money) Seat #6 is the button
Seat 1: MrPink (10000 in chips)
Seat 2: Pluribus (10000 in chips)
Seat 3: Eddie (10000 in chips)
Seat 4: MrBrown (10000 in chips)
Seat 5: MrBlue (10000 in chips)
Seat 6: Bill (10000 in chips)
MrPink: posts small blind 50
Pluribus: posts big blind 100
*** HOLE CARDS ***
Dealt to MrPink [Ts 4c]
Dealt to Pluribus [Js Td]
Dealt to Eddie [2h Ah]
Dealt to MrBrown [Qd Ac]
Dealt to MrBlue [Kh Tc]
Dealt to Bill [Qh Qc]
Eddie: raises 100 to 200
MrBrown: raises 400 to 600
MrBlue: folds
Bill: raises 775 to 1375
MrPink: folds
Pluribus: folds
Eddie: folds
MrBrown: folds
Uncalled bet (775) returned to Bill
Bill collected 1550.0 from pot
*** SUMMARY ***
Total pot 1550 | Rake 0


PokerStars Hand #43011: Hold'em No Limit (50/100) - 2019/07/11 11:56:51 ET
Table 'Pluribus Session 43' 6-max (Play Money) Seat #6 is the button
Seat 1: Pluribus (10000 in chips)
Seat 2: Eddie (10000 in chips)
Seat 3: MrBrown (10000 in chips)
Seat 4: MrBlue (10000 in chips)
Seat 5: Bill (10000 in chips)
Seat 6: MrPink (10000 in chips)
Pluribus: posts small blind 50
Eddie: posts big blind 100
*** HOLE CARDS ***
Dealt to Pluribus [7d Qs]
Dealt to Eddie [9c 9d]
Dealt to MrBrown [6d Jc]
Dealt to MrBlue [2h Jd]
Dealt to Bill [7h 3c]
Dealt to MrPink [Kc 8h]
MrBrown: folds
MrBlue: folds
Bill: folds
MrPink: raises 150 to 250
Pluribus: folds
Eddie: raises 1050 to 1300
MrPink: folds
Uncalled bet (1050) returned to Eddie
Eddie collected 550.0 from pot
*** SUMMARY ***
Total pot 550 | Rake 0


PokerStars Hand #43012: Hold'em No Limit (50/100) - 2019/07/11 11:56:52 ET
Table 'Pluribus Session 43' 6-max (Play Money) Seat #6 is the button
Seat 1: Eddie (10000 in chips)
Seat 2: MrBrown (10000 in chips)
Seat 3: MrBlue (10000 in chips)
Seat 4: Bill (10000 in chips)
Seat 5: MrPink (10000 in chips)
Seat 6: Pluribus (10000 in chips)
Eddie: posts small blind 50
MrBrown: posts big blind 100
*** HOLE CARDS ***
Dealt to Eddie [4s Ts]
Dealt to MrBrown [8d 4h]
Dealt to MrBlue [2d 9d]
Dealt to Bill [2c Jd]
Dealt to MrPink [7c 4c]
Dealt to Pluribus [7d 8s]
MrBlue: folds
Bill: folds
MrPink: folds
Pluribus: folds
Eddie: raises 200 to 300
MrBrown: folds
Uncalled bet (200) returned to Eddie
Eddie collected 200.0 from pot
*** SUMMARY ***
Total pot 200 | Rake 0


PokerStars Hand #43013: Hold'em No Limit (50/100) - 2019/07/11 11:56:53 ET
Table 'Pluribus Session 43' 6-max (Play Money) Seat #6 is the button
Seat 1: MrBrown (10000 in chips)
Seat 2: MrBlue (10000 in chips)
Seat 3: Bill (10000 in chips)
Seat 4: MrPink (10000 in chips)
Seat 5: Pluribus (10000 in chips)
Seat 6: Eddie (10000 in chips)
MrBrown: posts small blind 50
MrBlue: posts big blind 100
*** HOLE CARDS ***
Dealt to MrBrown [Th Qh]
Dealt to MrBlue [Js Ac]
Dealt to Bill [3s 5c]
Dealt to MrPink [2c Jd]
Dealt to Pluribus [Jh 7s]
Dealt to Eddie [4d Qc]
Bill: folds
MrPink: folds
Pluribus: folds
Eddie: folds
MrBrown: raises 200 to 300
MrBlue: calls 200
*** FLOP *** [Jc Tc Kh]
MrBrown: checks
MrBlue: checks
*** TURN *** [Jc Tc Kh] [6s]
MrBrown: checks
MrBlue: checks
*** RIVER *** [Jc Tc Kh] [6s] [As]
MrBrown: checks
MrBlue: bets 425
MrBrown: raises 425 to 850
MrBlue: folds
Uncalled bet (425) returned to MrBrown
MrBrown collected 1450.0 from pot
*** SUMMARY ***
Total pot 1450 | Rake 0
Board [Jc Tc Kh 6s As]


PokerStars Hand #43014: Hold'em No Limit (50/100) - 2019/07/11 11:56:54 ET
Table 'Pluribus Session 43' 6-max (Play Money) Seat #6 is the button
Seat 1: MrBlue (10000 in chips)
Seat 2: Bill (10000 in chips)
Seat 3: MrPink (10000 in chips)
Seat 4: Pluribus (10000 in chips)
Seat 5: Eddie (10000 in chips)
Seat 6: MrBrown (10000 in chips)
MrBlue: posts small blind 50
Bill: posts big blind 100
*** HOLE CARDS ***
Dealt to MrBlue [Qd 6d]
Dealt to Bill [3h 5d]
Dealt to MrPink [Kc Jc]
Dealt to Pluribus [Ts 4s]
Dealt to Eddie [3s 5c]
Dealt to MrBrown [Qs 9d]
MrPink: raises 110 to 210
Pluribus: folds
Eddie: folds
MrBrown: folds
MrBlue: folds
Bill: folds
Uncalled bet (110) returned to MrPink
MrPink collected 250.0 from pot
*** SUMMARY ***
Total pot 250 | Rake 0


PokerStars Hand #43015: Hold'em No Limit (50/100) - 2019/07/11 11:56:55 ET
Table 'Pluribus Session 43' 6-max (Play Money) Seat #6 is the button
Seat 1: Bill (10000 in chips)
Seat 2: MrPink (10000 in chips)
Seat 3: Pluribus (10000 in chips)
Seat 4: Eddie (10000 in chips)
Seat 5: MrBrown (10000 in chips)
Seat 6: MrBlue (10000 in chips)
Bill: posts small blind 50
MrPink: posts big blind 100
*** HOLE CARDS ***
Dealt to Bill [9s 8s]
Dealt to MrPink [5s 2h]
Dealt to Pluribus [Ah 7c]
Dealt to Eddie [Js Kd]
Dealt to MrBrown [8h 9h]
Dealt to MrBlue [6h 2c]
Pluribus: folds
Eddie: raises 100 to 200
MrBrown: raises 400 to 600
MrBlue: folds
Bill: folds
MrPink: folds
Eddie: folds
Uncalled bet (400) returned to MrBrown
MrBrown collected 550.0 from pot
*** SUMMARY ***
Total pot 550 | Rake 0


PokerStars Hand #43016: Hold'em No Limit (50/100) - 2019/07/11 11:56:56 ET
Table 'Pluribus Session 43' 6-max (Play Money) Seat #6 is the button
Seat 1: MrPink (10000 in chips)
Seat 2: Pluribus (10000 in chips)
Seat 3: Eddie (10000 in chips)
Seat 4: MrBrown (10000 in chips)
Seat 5: MrBlue (10000 in chips)
Seat 6: Bill (10000 in chips)
MrPink: posts small blind 50
Pluribus: posts big blind 100
*** HOLE CARDS ***
Dealt to MrPink [8h Kh]
Dealt to Pluribus [Th Ac]
Dealt to Eddie [8d Jd]
Dealt to MrBrown [Qs 9d]
Dealt to MrBlue [2c Qh]
Dealt to Bill [9s Qc]
Eddie: folds
MrBrown: folds
MrBlue: folds
Bill: raises 187 to 287
MrPink: folds
Pluribus: calls 187
*** FLOP *** [7c As 9h]
Pluribus: checks
Bill: bets 312
Pluribus: calls 312
*** TURN *** [7c As 9h] [2h]
Pluribus: checks
Bill: checks
*** RIVER *** [7c As 9h] [2h] [Tc]
Pluribus: bets 624
Bill: folds
Uncalled bet (624) returned to Pluribus
Pluribus collected 1248.0 from pot
*** SUMMARY ***
Total pot 1248 | Rake 0
Board [7c As 9h 2h Tc]


PokerStars Hand #43017: Hold'em No Limit (50/100) - 2019/07/11 11:56:57 ET
Table 'Pluribus Session 43' 6-max (Play Money) Seat #6 is the button
Seat 1: Pluribus (10000 in chips)
Seat 2: Eddie (10000 in chips)
Seat 3: MrBrown (10000 in chips)
Seat 4: MrBlue (10000 in chips)
Seat 5: Bill (10000 in chips)
Seat 6: MrPink (10000 in chips)
Pluribus: posts small blind 50
Eddie: posts big blind 100
*** HOLE CARDS ***
Dealt to Pluribus [7s Ah]
Dealt to Eddie [Ac Qh]
Dealt to MrBrown [Qd 9s]
Dealt to MrBlue [8d 6s]
Dealt to Bill [6d Jc]
Dealt to MrPink [Kd Ad]
MrBrown: folds
MrBlue: folds
Bill: folds
MrPink: raises 150 to 250
Pluribus: folds
Eddie: raises 1050 to 1300
MrPink: raises 1350 to 2650
Eddie: calls 1350
*** FLOP *** [Ks 6c 5h]
Eddie: checks
MrPink: bets 1350
Eddie: folds
Uncalled bet (1350) returned to MrPink
MrPink collected 5350.0 from pot
*** SUMMARY ***
Total pot 5350 | Rake 0
Board [Ks 6c 5h]


PokerStars Hand #43018: Hold'em No Limit (50/100) - 2019/07/11 11:56:58 ET
Table 'Pluribus Session 43' 6-max (Play Money) Seat #6 is the button
Seat 1: Eddie (10000 in chips)
Seat 2: MrBrown (10000 in chips)
Seat 3: MrBlue (10000 in chips)
Seat 4: Bill (10000 in chips)
Seat 5: MrPink (10000 in chips)
Seat 6: Pluribus (10000 in chips)
Eddie: posts small blind 50
MrBrown: posts big blind 100
*** HOLE CARDS ***
Dealt to Eddie [3s 7d]
Dealt to MrBrown [8c Qd]
Dealt to MrBlue [6d 6h]
Dealt to Bill [4d Js]
Dealt to MrPink [6c 3c]
Dealt to Pluribus [6s Qc]
MrBlue: raises 125 to 225
Bill: folds
MrPink: folds
Pluribus: folds
Eddie: folds
MrBrown: calls 125
*** FLOP *** [Kh 7c Jc]
MrBrown: checks
MrBlue: bets 250
MrBrown: folds
Uncalled bet (250) returned to MrBlue
MrBlue collected 500.0 from pot
*** SUMMARY ***
Total pot 500 | Rake 0
Board [Kh 7c Jc]


PokerStars Hand #43019: Hold'em No Limit (50/100) - 2019/07/11 11:56:59 ET
Table 'Pluribus Session 43' 6-max (Play Money) Seat #6 is the button
Seat 1: MrBrown (10000 in chips)
Seat 2: MrBlue (10000 in chips)
Seat 3: Bill (10000 in chips)
Seat 4: MrPink (10000 in chips)
Seat 5: Pluribus (10000 in chips)
Seat 6: Eddie (10000 in chips)
MrBrown: posts small blind 50
MrBlue: posts big blind 100
*** HOLE CARDS ***
Dealt to MrBrown [9d Qd]
Dealt to MrBlue [Tc Th]
Dealt to Bill [Jc 8s]
Dealt to MrPink [6c 3s]
Dealt to Pluribus [Jd 9s]
Dealt to Eddie [Qh Qs]
Bill: folds
MrPink: folds
Pluribus: folds
Eddie: raises 122 to 222
MrBrown: folds
MrBlue: raises 828 to 1050
Eddie: raises 1300 to 2350
MrBlue: raises 7650 to 10000 and is all-in
Eddie: calls 7650 and is all-in
*** FLOP *** [Kh As 3c]
*** TURN *** [Kh As 3c] [5h]
*** RIVER *** [Kh As 3c] [5h] [Ad]
*** SHOWDOWN ***
Eddie: shows [Qh Qs]
Eddie collected 20050.0 from pot
*** SUMMARY ***
Total pot 20050 | Rake 0
Board [Kh As 3c 5h Ad]
Seat 2: MrBlue showed [Tc Th] and lost
Seat 6: Eddie showed [Qh Qs] and won (20050.0)


PokerStars Hand #43020: Hold'em No Limit (50/100) - 2019/07/11 11:57:00 ET
Table 'Pluribus Session 43' 6-max (Play Money) Seat #6 is the button
Seat 1: MrBlue (10000 in chips)
Seat 2: Bill (10000 in chips)
Seat 3: MrPink (10000 in chips)
Seat 4: Pluribus (10000 in chips)
Seat 5: Eddie (10000 in chips)
Seat 6: MrBrown (10000 in chips)
MrBlue: posts small blind 50
Bill: posts big blind 100
*** HOLE CARDS ***
Dealt to MrBlue [9c Qd]
Dealt to Bill [3s 5h]
Dealt to MrPink [6s 9s]
Dealt to Pluribus [4d Kc]
Dealt to Eddie [2s 8c]
Dealt to MrBrown [3c Ad]
MrPink: folds
Pluribus: folds
Eddie: folds
MrBrown: raises 150 to 250
MrBlue: folds
Bill: folds
Uncalled bet (150) returned to MrBrown
MrBrown collected 250.0 from pot
*** SUMMARY ***
Total pot 250 | Rake 0


PokerStars Hand #43021: Hold'em No Limit (50/100) - 2019/07/11 11:57:01 ET
Table 'Pluribus Session 43' 6-max (Play Money) Seat #6 is the button
Seat 1: Bill (10000 in chips)
Seat 2: MrPink (10000 in chips)
Seat 3: Pluribus (10000 in chips)
Seat 4: Eddie (10000 in chips)
Seat 5: MrBrown (10000 in chips)
Seat 6: MrBlue (10000 in chips)
Bill: posts small blind 50
MrPink: posts big blind 100
*** HOLE CARDS ***
Dealt to Bill [7c Kd]
Dealt to MrPink [Qs Th]
Dealt to Pluribus [Kh 6s]
Dealt to Eddie [4h 7d]
Dealt to MrBrown [Jc Jd]
Dealt to MrBlue [4d 9s]
Pluribus: folds
Eddie: folds
MrBrown: raises 150 to 250
MrBlue: folds
Bill: folds
MrPink: calls 150
*** FLOP *** [7s 4c 8d]
MrPink: checks
MrBrown: bets 412
MrPink: folds
Uncalled bet (412) returned to MrBrown
MrBrown collected 550.0 from pot
*** SUMMARY ***
Total pot 550 | Rake 0
Board [7s 4c 8d]


PokerStars Hand #43022: Hold'em No Limit (50/100) - 2019/07/11 11:57:02 ET
Table 'Pluribus Session 43' 6-max (Play Money) Seat #6 is the button
Seat 1: MrPink (10000 in chips)
Seat 2: Pluribus (10000 in chips)
Seat 3: Eddie (10000 in chips)
Seat 4: MrBrown (10000 in chips)
Seat 5: MrBlue (10000 in chips)
Seat 6: Bill (10000 in chips)
MrPink: posts small blind 50
Pluribus: posts big blind 100
*** HOLE CARDS ***
Dealt to MrPink [5s 8d]
Dealt to Pluribus [Kd Ad]
Dealt to Eddie [5c 3d]
Dealt to MrBrown [Kc 8c]
Dealt to MrBlue [As 6s]
Dealt to Bill [Jd 2s]
Eddie: folds
MrBrown: folds
MrBlue: raises 125 to 225
Bill: folds
MrPink: folds
Pluribus: raises 1000 to 1225
MrBlue: calls 1000
*** FLOP *** [4d 9d 7h]
Pluribus: checks
MrBlue: checks
*** TURN *** [4d 9d 7h] [9s]
Pluribus: checks
MrBlue: checks
*** RIVER *** [4d 9d 7h] [9s] [6c]
Pluribus: checks
MrBlue: bets 1000
Pluribus: raises 4500 to 5500
MrBlue: calls 4500
*** SHOWDOWN ***
MrBlue: shows [As 6s]
MrBlue collected 13500.0 from pot
*** SUMMARY ***
Total pot 13500 | Rake 0
Board [4d 9d 7h 9s 6c]
Seat 2: Pluribus showed [Kd Ad] and lost
Seat 5: MrBlue showed [As 6s] and won (13500.0)


PokerStars Hand #43023: Hold'em No Limit (50/100) - 2019/07/11 11:57:03 ET
Table 'Pluribus Session 43' 6-max (Play Money) Seat #6 is the button
Seat 1: Pluribus (10000 in chips)
Seat 2: Eddie (10000 in chips)
Seat 3: MrBrown (10000 in chips)
Seat 4: MrBlue (10000 in chips)
Seat 5: Bill (10000 in chips)
Seat 6: MrPink (10000 in chips)
Pluribus: posts small blind 50
Eddie: posts big blind 100
*** HOLE CARDS ***
Dealt to Pluribus [Qh 9d]
Dealt to Eddie [6d 6h]
Dealt to MrBrown [5s Ac]
Dealt to MrBlue [8d 7s]
Dealt to Bill [4h Td]
Dealt to MrPink [7d 5h]
MrBrown: folds
MrBlue: folds
Bill: folds
MrPink: folds
Pluribus: raises 200 to 300
Eddie: calls 200
*** FLOP *** [3c 4d 3h]
Pluribus: checks
Eddie: bets 480
Pluribus: folds
Uncalled bet (480) returned to Eddie
Eddie collected 600.0 from pot
*** SUMMARY ***
Total pot 600 | Rake 0
Board [3c 4d 3h]


PokerStars Hand #43024: Hold'em No Limit (50/100) - 2019/07/11 11:57:04 ET
Table 'Pluribus Session 43' 6-max (Play Money) Seat #6 is the button
Seat 1: Eddie (10000 in chips)
Seat 2: MrBrown (10000 in chips)
Seat 3: MrBlue (10000 in chips)
Seat 4: Bill (10000 in chips)
Seat 5: MrPink (10000 in chips)
Seat 6: Pluribus (10000 in chips)
Eddie: posts small blind 50
MrBrown: posts big blind 100
*** HOLE CARDS ***
Dealt to Eddie [5d 3s]
Dealt to MrBrown [Jc 3h]
Dealt to MrBlue [9d Qh]
Dealt to Bill [Kh Ac]
Dealt to MrPink [2h 5s]
Dealt to Pluribus [6c Ts]
MrBlue: folds
Bill: raises 125 to 225
MrPink: folds
Pluribus: folds
Eddie: folds
MrBrown: folds
Uncalled bet (125) returned to Bill
Bill collected 250.0 from pot
*** SUMMARY ***
Total pot 250 | Rake 0


PokerStars Hand #43025: Hold'em No Limit (50/100) - 2019/07/11 11:57:05 ET
Table 'Pluribus Session 43' 6-max (Play Money) Seat #6 is the button
Seat 1: MrBrown (10000 in chips)
Seat 2: MrBlue (10000 in chips)
Seat 3: Bill (10000 in chips)
Seat 4: MrPink (10000 in chips)
Seat 5: Pluribus (10000 in chips)
Seat 6: Eddie (10000 in chips)
MrBrown: posts small blind 50
MrBlue: posts big blind 100
*** HOLE CARDS ***
Dealt to MrBrown [7c 6c]
Dealt to MrBlue [Kd 7s]
Dealt to Bill [9s 3s]
Dealt to MrPink [3h 2h]
Dealt to Pluribus [Jc Qd]
Dealt to Eddie [Jh 5c]
Bill: folds
MrPink: folds
Pluribus: raises 125 to 225
Eddie: folds
MrBrown: raises 525 to 750
MrBlue: folds
Pluribus: folds
Uncalled bet (525) returned to MrBrown
MrBrown collected 550.0 from pot
*** SUMMARY ***
Total pot 550 | Rake 0


PokerStars Hand #43026: Hold'em No Limit (50/100) - 2019/07/11 11:57:06 ET
Table 'Pluribus Session 43' 6-max (Play Money) Seat #6 is the button
Seat 1: MrBlue (10000 in chips)
Seat 2: Bill (10000 in chips)
Seat 3: MrPink (10000 in chips)
Seat 4: Pluribus (10000 in chips)
Seat 5: Eddie (10000 in chips)
Seat 6: MrBrown (10000 in chips)
MrBlue: posts small blind 50
Bill: posts big blind 100
*** HOLE CARDS ***
Dealt to MrBlue [Kh 4h]
Dealt to Bill [Th 6c]
Dealt to MrPink [5d 8d]
Dealt to Pluribus [Qh Ah]
Dealt to Eddie [5h 8s]
Dealt to MrBrown [3s 9c]
MrPink: folds
Pluribus: raises 150 to 250
Eddie: folds
MrBrown: folds
MrBlue: folds
Bill: folds
Uncalled bet (150) returned to Pluribus
Pluribus collected 250.0 from pot
*** SUMMARY ***
Total pot 250 | Rake 0


PokerStars Hand #43027: Hold'em No Limit (50/100) - 2019/07/11 11:57:07 ET
Table 'Pluribus Session 43' 6-max (Play Money) Seat #6 is the button
Seat 1: Bill (10000 in chips)
Seat 2: MrPink (10000 in chips)
Seat 3: Pluribus (10000 in chips)
Seat 4: Eddie (10000 in chips)
Seat 5: MrBrown (10000 in chips)
Seat 6: MrBlue (10000 in chips)
Bill: posts small blind 50
MrPink: posts big blind 100
*** HOLE CARDS ***
Dealt to Bill [7d 2s]
Dealt to MrPink [Kc 9s]
Dealt to Pluribus [6h Js]
Dealt to Eddie [4h 5d]
Dealt to MrBrown [2c 6d]
Dealt to MrBlue [Ts Ad]
Pluribus: folds
Eddie: folds
MrBrown: folds
MrBlue: raises 125 to 225
Bill: folds
MrPink: calls 125
*** FLOP *** [Ah 4d Jh]
MrPink: checks
MrBlue: bets 250
MrPink: folds
Uncalled bet (250) returned to MrBlue
MrBlue collected 500.0 from pot
*** SUMMARY ***
Total pot 500 | Rake 0
Board [Ah 4d Jh]


PokerStars Hand #43028: Hold'em No Limit (50/100) - 2019/07/11 11:57:08 ET
Table 'Pluribus Session 43' 6-max (Play Money) Seat #6 is the button
Seat 1: MrPink (10000 in chips)
Seat 2: Pluribus (10000 in chips)
Seat 3: Eddie (10000 in chips)
Seat 4: MrBrown (10000 in chips)
Seat 5: MrBlue (10000 in chips)
Seat 6: Bill (10000 in chips)
MrPink: posts small blind 50
Pluribus: posts big blind 100
*** HOLE CARDS ***
Dealt to MrPink [Td 9c]
Dealt to Pluribus [2d 7d]
Dealt to Eddie [4c Qd]
Dealt to MrBrown [Kh Qs]
Dealt to MrBlue [Jh 3s]
Dealt to Bill [5h Th]
Eddie: folds
MrBrown: raises 125 to 225
MrBlue: folds
Bill: folds
MrPink: folds
Pluribus: folds
Uncalled bet (125) returned to MrBrown
MrBrown collected 250.0 from pot
*** SUMMARY ***
Total pot 250 | Rake 0


PokerStars Hand #43029: Hold'em No Limit (50/100) - 2019/07/11 11:57:09 ET
Table 'Pluribus Session 43' 6-max (Play Money) Seat #6 is the button
Seat 1: Pluribus (10000 in chips)
Seat 2: Eddie (10000 in chips)
Seat 3: MrBrown (10000 in chips)
Seat 4: MrBlue (10000 in chips)
Seat 5: Bill (10000 in chips)
Seat 6: MrPink (10000 in chips)
Pluribus: posts small blind 50
Eddie: posts big blind 100
*** HOLE CARDS ***
Dealt to Pluribus [Js Qs]
Dealt to Eddie [3c Td]
Dealt to MrBrown [5h 6d]
Dealt to MrBlue [3s 4c]
Dealt to Bill [6s 8d]
Dealt to MrPink [Qh 7s]
MrBrown: folds
MrBlue: folds
Bill: folds
MrPink: folds
Pluribus: raises 150 to 250
Eddie: folds
Uncalled bet (150) returned to Pluribus
Pluribus collected 200.0 from pot
*** SUMMARY ***
Total pot 200 | Rake 0


PokerStars Hand #43030: Hold'em No Limit (50/100) - 2019/07/11 11:57:10 ET
Table 'Pluribus Session 43' 6-max (Play Money) Seat #6 is the button
Seat 1: Eddie (10000 in chips)
Seat 2: MrBrown (10000 in chips)
Seat 3: MrBlue (10000 in chips)
Seat 4: Bill (10000 in chips)
Seat 5: MrPink (10000 in chips)
Seat 6: Pluribus (10000 in chips)
Eddie: posts small blind 50
MrBrown: posts big blind 100
*** HOLE CARDS ***
Dealt to Eddie [5c Ks]
Dealt to MrBrown [4c Ac]
Dealt to MrBlue [6d 8c]
Dealt to Bill [6c 2h]
Dealt to MrPink [2s 8d]
Dealt to Pluribus [8h Th]
MrBlue: folds
Bill: folds
MrPink: folds
Pluribus: raises 125 to 225
Eddie: folds
MrBrown: calls 125
*** FLOP *** [5s Ts 7d]
MrBrown: checks
Pluribus: checks
*** TURN *** [5s Ts 7d] [2c]
MrBrown: checks
Pluribus: bets 125
MrBrown: raises 750 to 875
Pluribus: calls 750
*** RIVER *** [5s Ts 7d] [2c] [4h]
MrBrown: checks
Pluribus: checks
*** SHOWDOWN ***
Pluribus: shows [8h Th]
Pluribus collected 2250.0 from pot
*** SUMMARY ***
Total pot 2250 | Rake 0
Board [5s Ts 7d 2c 4h]
Seat 2: MrBrown showed [4c Ac] and lost
Seat 6: Pluribus showed [8h Th] and won (2250.0)


PokerStars Hand #43031: Hold'em No Limit (50/100) - 2019/07/11 11:57:11 ET
Table 'Pluribus Session 43' 6-max (Play Money) Seat #6 is the button
Seat 1: MrBrown (10000 in chips)
Seat 2: MrBlue (10000 in chips)
Seat 3: Bill (10000 in chips)
Seat 4: MrPink (10000 in chips)
Seat 5: Pluribus (10000 in chips)
Seat 6: Eddie (10000 in chips)
MrBrown: posts small blind 50
MrBlue: posts big blind 100
*** HOLE CARDS ***
Dealt to MrBrown [9h 8c]
Dealt to MrBlue [5h Js]
Dealt to Bill [Th Qh]
Dealt to MrPink [8d 7s]
Dealt to Pluribus [9d 2h]
Dealt to Eddie [2d Ts]
Bill: raises 125 to 225
MrPink: folds
Pluribus: folds
Eddie: folds
MrBrown: folds
MrBlue: folds
Uncalled bet (125) returned to Bill
Bill collected 250.0 from pot
*** SUMMARY ***
Total pot 250 | Rake 0


PokerStars Hand #43032: Hold'em No Limit (50/100) - 2019/07/11 11:57:12 ET
Table 'Pluribus Session 43' 6-max (Play Money) Seat #6 is the button
Seat 1: MrBlue (10000 in chips)
Seat 2: Bill (10000 in chips)
Seat 3: MrPink (10000 in chips)
Seat 4: Pluribus (10000 in chips)
Seat 5: Eddie (10000 in chips)
Seat 6: MrBrown (10000 in chips)
MrBlue: posts small blind 50
Bill: posts big blind 100
*** HOLE CARDS ***
Dealt to MrBlue [5c 2h]
Dealt to Bill [6s 5s]
Dealt to MrPink [7d Tc]
Dealt to Pluribus [Ks Th]
Dealt to Eddie [7c Kd]
Dealt to MrBrown [Ah 8s]
MrPink: folds
Pluribus: raises 100 to 200
Eddie: folds
MrBrown: folds
MrBlue: folds
Bill: raises 700 to 900
Pluribus: folds
Uncalled bet (700) returned to Bill
Bill collected 450.0 from pot
*** SUMMARY ***
Total pot 450 | Rake 0


PokerStars Hand #43033: Hold'em No Limit (50/100) - 2019/07/11 11:57:13 ET
Table 'Pluribus Session 43' 6-max (Play Money) Seat #6 is the button
Seat 1: Bill (10000 in chips)
Seat 2: MrPink (10000 in chips)
Seat 3: Pluribus (10000 in chips)
Seat 4: Eddie (10000 in chips)
Seat 5: MrBrown (10000 in chips)
Seat 6: MrBlue (10000 in chips)
Bill: posts small blind 50
MrPink: posts big blind 100
*** HOLE CARDS ***
Dealt to Bill [6d 4h]
Dealt to MrPink [As 8d]
Dealt to Pluribus [Ah 8s]
Dealt to Eddie [5s Kc]
Dealt to MrBrown [2s 7c]
Dealt to MrBlue [Jc Kd]
Pluribus: folds
Eddie: folds
MrBrown: folds
MrBlue: raises 125 to 225
Bill: folds
MrPink: raises 925 to 1150
MrBlue: raises 1325 to 2475
MrPink: folds
Uncalled bet (1325) returned to MrBlue
MrBlue collected 2350.0 from pot
*** SUMMARY ***
Total pot 2350 | Rake 0


PokerStars Hand #43034: Hold'em No Limit (50/100) - 2019/07/11 11:57:14 ET
Table 'Pluribus Session 43' 6-max (Play Money) Seat #6 is the button
Seat 1: MrPink (10000 in chips)
Seat 2: Pluribus (10000 in chips)
Seat 3: Eddie (10000 in chips)
Seat 4: MrBrown (10000 in chips)
Seat 5: MrBlue (10000 in chips)
Seat 6: Bill (10000 in chips)
MrPink: posts small blind 50
Pluribus: posts big blind 100
*** HOLE CARDS ***
Dealt to MrPink [5h 9c]
Dealt to Pluribus [Jd Qd]
Dealt to Eddie [9h Qc]
Dealt to MrBrown [3s 6d]
Dealt to MrBlue [Ks 4c]
Dealt to Bill [Qh 6h]
Eddie: folds
MrBrown: folds
MrBlue: folds
Bill: raises 187 to 287
MrPink: folds
Pluribus: calls 187
*** FLOP *** [Kd 8s 2d]
Pluribus: checks
Bill: checks
*** TURN *** [Kd 8s 2d] [Kc]
Pluribus: checks
Bill: checks
*** RIVER *** [Kd 8s 2d] [Kc] [9s]
Pluribus: checks
Bill: checks
*** SHOWDOWN ***
Pluribus: shows [Jd Qd]
Pluribus collected 624.0 from pot
*** SUMMARY ***
Total pot 624 | Rake 0
Board [Kd 8s 2d Kc 9s]
Seat 2: Pluribus showed [Jd Qd] and won (624.0)
Seat 6: Bill showed [Qh 6h] and lost


PokerStars Hand #43035: Hold'em No Limit (50/100) - 2019/07/11 11:57:15 ET
Table 'Pluribus Session 43' 6-max (Play Money) Seat #6 is the button
Seat 1: Pluribus (10000 in chips)
Seat 2: Eddie (10000 in chips)
Seat 3: MrBrown (10000 in chips)
Seat 4: MrBlue (10000 in chips)
Seat 5: Bill (10000 in chips)
Seat 6: MrPink (10000 in chips)
Pluribus: posts small blind 50
Eddie: posts big blind 100
*** HOLE CARDS ***
Dealt to Pluribus [Kh Kc]
Dealt to Eddie [8c Ah]
Dealt to MrBrown [3d Jc]
Dealt to MrBlue [2c Td]
Dealt to Bill [7d 2d]
Dealt to MrPink [7c 6s]
MrBrown: folds
MrBlue: folds
Bill: folds
MrPink: folds
Pluribus: raises 100 to 200
Eddie: folds
Uncalled bet (100) returned to Pluribus
Pluribus collected 200.0 from pot
*** SUMMARY ***
Total pot 200 | Rake 0


PokerStars Hand #43036: Hold'em No Limit (50/100) - 2019/07/11 11:57:16 ET
Table 'Pluribus Session 43' 6-max (Play Money) Seat #6 is the button
Seat 1: Eddie (10000 in chips)
Seat 2: MrBrown (10000 in chips)
Seat 3: MrBlue (10000 in chips)
Seat 4: Bill (10000 in chips)
Seat 5: MrPink (10000 in chips)
Seat 6: Pluribus (10000 in chips)
Eddie: posts small blind 50
MrBrown: posts big blind 100
*** HOLE CARDS ***
Dealt to Eddie [8c 6c]
Dealt to MrBrown [Td 6s]
Dealt to MrBlue [8s 3c]
Dealt to Bill [Ts As]
Dealt to MrPink [Ah 9c]
Dealt to Pluribus [Qc 3h]
MrBlue: folds
Bill: raises 125 to 225
MrPink: folds
Pluribus: folds
Eddie: folds
MrBrown: folds
Uncalled bet (125) returned to Bill
Bill collected 250.0 from pot
*** SUMMARY ***
Total pot 250 | Rake 0


PokerStars Hand #43037: Hold'em No Limit (50/100) - 2019/07/11 11:57:17 ET
Table 'Pluribus Session 43' 6-max (Play Money) Seat #6 is the button
Seat 1: MrBrown (10000 in chips)
Seat 2: MrBlue (10000 in chips)
Seat 3: Bill (10000 in chips)
Seat 4: MrPink (10000 in chips)
Seat 5: Pluribus (10000 in chips)
Seat 6: Eddie (10000 in chips)
MrBrown: posts small blind 50
MrBlue: posts big blind 100
*** HOLE CARDS ***
Dealt to MrBrown [5c 7c]
Dealt to MrBlue [Kc 2d]
Dealt to Bill [6s 8d]
Dealt to MrPink [Td 4d]
Dealt to Pluribus [Ks 4c]
Dealt to Eddie [Ah 6c]
Bill: folds
MrPink: folds
Pluribus: folds
Eddie: raises 122 to 222
MrBrown: folds
MrBlue: folds
Uncalled bet (122) returned to Eddie
Eddie collected 250.0 from pot
*** SUMMARY ***
Total pot 250 | Rake 0


PokerStars Hand #43038: Hold'em No Limit (50/100) - 2019/07/11 11:57:18 ET
Table 'Pluribus Session 43' 6-max (Play Money) Seat #6 is the button
Seat 1: MrBlue (10000 in chips)
Seat 2: Bill (10000 in chips)
Seat 3: MrPink (10000 in chips)
Seat 4: Pluribus (10000 in chips)
Seat 5: Eddie (10000 in chips)
Seat 6: MrBrown (10000 in chips)
MrBlue: posts small blind 50
Bill: posts big blind 100
*** HOLE CARDS ***
Dealt to MrBlue [4h 4c]
Dealt to Bill [Jd 6h]
Dealt to MrPink [2h 8s]
Dealt to Pluribus [7d 9d]
Dealt to Eddie [8c 6d]
Dealt to MrBrown [3s 4s]
MrPink: folds
Pluribus: folds
Eddie: folds
MrBrown: raises 150 to 250
MrBlue: calls 200
Bill: folds
*** FLOP *** [9s Th As]
MrBlue: checks
MrBrown: bets 300
MrBlue: folds
Uncalled bet (300) returned to MrBrown
MrBrown collected 600.0 from pot
*** SUMMARY ***
Total pot 600 | Rake 0
Board [9s Th As]


PokerStars Hand #43039: Hold'em No Limit (50/100) - 2019/07/11 11:57:19 ET
Table 'Pluribus Session 43' 6-max (Play Money) Seat #6 is the button
Seat 1: Bill (10000 in chips)
Seat 2: MrPink (10000 in chips)
Seat 3: Pluribus (10000 in chips)
Seat 4: Eddie (10000 in chips)
Seat 5: MrBrown (10000 in chips)
Seat 6: MrBlue (10000 in chips)
Bill: posts small blind 50
MrPink: posts big blind 100
*** HOLE CARDS ***
Dealt to Bill [2s 6d]
Dealt to MrPink [Jh 9h]
Dealt to Pluribus [Td 7d]
Dealt to Eddie [Ts Ad]
Dealt to MrBrown [8c Qd]
Dealt to MrBlue [2c 2h]
Pluribus: folds
Eddie: raises 100 to 200
MrBrown: folds
MrBlue: calls 200
Bill: folds
MrPink: calls 100
*** FLOP *** [Kc Tc Qh]
MrPink: checks
Eddie: checks
MrBlue: checks
*** TURN *** [Kc Tc Qh] [6s]
MrPink: checks
Eddie: checks
MrBlue: checks
*** RIVER *** [Kc Tc Qh] [6s] [4c]
MrPink: checks
Eddie: checks
MrBlue: bets 505
MrPink: raises 1660 to 2165
Eddie: folds
MrBlue: folds
Uncalled bet (1660) returned to MrPink
MrPink collected 1660.0 from pot
*** SUMMARY ***
Total pot 1660 | Rake 0
Board [Kc Tc Qh 6s 4c]


PokerStars Hand #43040: Hold'em No Limit (50/100) - 2019/07/11 11:57:20 ET
Table 'Pluribus Session 43' 6-max (Play Money) Seat #6 is the button
Seat 1: MrPink (10000 in chips)
Seat 2: Pluribus (10000 in chips)
Seat 3: Eddie (10000 in chips)
Seat 4: MrBrown (10000 in chips)
Seat 5: MrBlue (10000 in chips)
Seat 6: Bill (10000 in chips)
MrPink: posts small blind 50
Pluribus: posts big blind 100
*** HOLE CARDS ***
Dealt to MrPink [Kh Th]
Dealt to Pluribus [3c Qh]
Dealt to Eddie [7c 2d]
Dealt to MrBrown [Jh 3h]
Dealt to MrBlue [Kc Kd]
Dealt to Bill [2s Jc]
Eddie: folds
MrBrown: folds
MrBlue: raises 125 to 225
Bill: folds
MrPink: raises 825 to 1050
Pluribus: folds
MrBlue: raises 1625 to 2675
MrPink: folds
Uncalled bet (1625) returned to MrBlue
MrBlue collected 2200.0 from pot
*** SUMMARY ***
Total pot 2200 | Rake 0


PokerStars Hand #43041: Hold'em No Limit (50/100) - 2019/07/11 11:57:21 ET
Table 'Pluribus Session 43' 6-max (Play Money) Seat #6 is the button
Seat 1: Pluribus (10000 in chips)
Seat 2: Eddie (10000 in chips)
Seat 3: MrBrown (10000 in chips)
Seat 4: MrBlue (10000 in chips)
Seat 5: Bill (10000 in chips)
Seat 6: MrPink (10000 in chips)
Pluribus: posts small blind 50
Eddie: posts big blind 100
*** HOLE CARDS ***
Dealt to Pluribus [4h Qs]
Dealt to Eddie [3h Qd]
Dealt to MrBrown [2d 8s]
Dealt to MrBlue [7h 3c]
Dealt to Bill [Jc Js]
Dealt to MrPink [9h Kd]
MrBrown: folds
MrBlue: folds
Bill: raises 125 to 225
MrPink: folds
Pluribus: folds
Eddie: folds
Uncalled bet (125) returned to Bill
Bill collected 250.0 from pot
*** SUMMARY ***
Total pot 250 | Rake 0


PokerStars Hand #43042: Hold'em No Limit (50/100) - 2019/07/11 11:57:22 ET
Table 'Pluribus Session 43' 6-max (Play Money) Seat #6 is the button
Seat 1: Eddie (10000 in chips)
Seat 2: MrBrown (10000 in chips)
Seat 3: MrBlue (10000 in chips)
Seat 4: Bill (10000 in chips)
Seat 5: MrPink (10000 in chips)
Seat 6: Pluribus (10000 in chips)
Eddie: posts small blind 50
MrBrown: posts big blind 100
*** HOLE CARDS ***
Dealt to Eddie [Th Jc]
Dealt to MrBrown [Kc 7h]
Dealt to MrBlue [3c Tc]
Dealt to Bill [2c Qs]
Dealt to MrPink [Kd Jh]
Dealt to Pluribus [Qh 6d]
MrBlue: folds
Bill: folds
MrPink: raises 110 to 210
Pluribus: folds
Eddie: folds
MrBrown: calls 110
*** FLOP *** [As Kh 2s]
MrBrown: checks
MrPink: checks
*** TURN *** [As Kh 2s] [4c]
MrBrown: checks
MrPink: checks
*** RIVER *** [As Kh 2s] [4c] [7d]
MrBrown: bets 470
MrPink: calls 470
*** SHOWDOWN ***
MrBrown: shows [Kc 7h]
MrBrown collected 1410.0 from pot
*** SUMMARY ***
Total pot 1410 | Rake 0
Board [As Kh 2s 4c 7d]
Seat 2: MrBrown showed [Kc 7h] and won (1410.0)
Seat 5: MrPink showed [Kd Jh] and lost


PokerStars Hand #43043: Hold'em No Limit (50/100) - 2019/07/11 11:57:23 ET
Table 'Pluribus Session 43' 6-max (Play Money) Seat #6 is the button
Seat 1: MrBrown (10000 in chips)
Seat 2: MrBlue (10000 in chips)
Seat 3: Bill (10000 in chips)
Seat 4: MrPink (10000 in chips)
Seat 5: Pluribus (10000 in chips)
Seat 6: Eddie (10000 in chips)
MrBrown: posts small blind 50
MrBlue: posts big blind 100
*** HOLE CARDS ***
Dealt to MrBrown [Ad 9d]
Dealt to MrBlue [6s Th]
Dealt to Bill [Jd 4d]
Dealt to MrPink [2s Ts]
Dealt to Pluribus [Qc 7s]
Dealt to Eddie [Tc 9h]
Bill: folds
MrPink: folds
Pluribus: folds
Eddie: raises 122 to 222
MrBrown: calls 172
MrBlue: folds
*** FLOP *** [6d Jc 8h]
MrBrown: checks
Eddie: bets 300
MrBrown: folds
Uncalled bet (300) returned to Eddie
Eddie collected 544.0 from pot
*** SUMMARY ***
Total pot 544 | Rake 0
Board [6d Jc 8h]


PokerStars Hand #43044: Hold'em No Limit (50/100) - 2019/07/11 11:57:24 ET
Table 'Pluribus Session 43' 6-max (Play Money) Seat #6 is the button
Seat 1: MrBlue (10000 in chips)
Seat 2: Bill (10000 in chips)
Seat 3: MrPink (10000 in chips)
Seat 4: Pluribus (10000 in chips)
Seat 5: Eddie (10000 in chips)
Seat 6: MrBrown (10000 in chips)
MrBlue: posts small blind 50
Bill: posts big blind 100
*** HOLE CARDS ***
Dealt to MrBlue [Ad 4s]
Dealt to Bill [Ah Ks]
Dealt to MrPink [Qh 8s]
Dealt to Pluribus [7s 3s]
Dealt to Eddie [Qd 5c]
Dealt to MrBrown [4c 2c]
MrPink: folds
Pluribus: folds
Eddie: folds
MrBrown: raises 150 to 250
MrBlue: folds
Bill: raises 850 to 1100
MrBrown: folds
Uncalled bet (850) returned to Bill
Bill collected 550.0 from pot
*** SUMMARY ***
Total pot 550 | Rake 0


PokerStars Hand #43045: Hold'em No Limit (50/100) - 2019/07/11 11:57:25 ET
Table 'Pluribus Session 43' 6-max (Play Money) Seat #6 is the button
Seat 1: Bill (10000 in chips)
Seat 2: MrPink (10000 in chips)
Seat 3: Pluribus (10000 in chips)
Seat 4: Eddie (10000 in chips)
Seat 5: MrBrown (10000 in chips)
Seat 6: MrBlue (10000 in chips)
Bill: posts small blind 50
MrPink: posts big blind 100
*** HOLE CARDS ***
Dealt to Bill [6c Ts]
Dealt to MrPink [2h 4h]
Dealt to Pluribus [4c 8d]
Dealt to Eddie [2c Js]
Dealt to MrBrown [3c Kd]
Dealt to MrBlue [As 3s]
Pluribus: folds
Eddie: folds
MrBrown: folds
MrBlue: raises 125 to 225
Bill: folds
MrPink: calls 125
*** FLOP *** [2d Qd 4d]
MrPink: checks
MrBlue: bets 250
MrPink: calls 250
*** TURN *** [2d Qd 4d] [Qc]
MrPink: checks
MrBlue: checks
*** RIVER *** [2d Qd 4d] [Qc] [Ac]
MrPink: checks
MrBlue: checks
*** SHOWDOWN ***
MrBlue: shows [As 3s]
MrBlue collected 1000.0 from pot
*** SUMMARY ***
Total pot 1000 | Rake 0
Board [2d Qd 4d Qc Ac]
Seat 2: MrPink showed [2h 4h] and lost
Seat 6: MrBlue showed [As 3s] and won (1000.0)


PokerStars Hand #43046: Hold'em No Limit (50/100) - 2019/07/11 11:57:26 ET
Table 'Pluribus Session 43' 6-max (Play Money) Seat #6 is the button
Seat 1: MrPink (10000 in chips)
Seat 2: Pluribus (10000 in chips)
Seat 3: Eddie (10000 in chips)
Seat 4: MrBrown (10000 in chips)
Seat 5: MrBlue (10000 in chips)
Seat 6: Bill (10000 in chips)
MrPink: posts small blind 50
Pluribus: posts big blind 100
*** HOLE CARDS ***
Dealt to MrPink [5d 7c]
Dealt to Pluribus [Td Js]
Dealt to Eddie [6h 4s]
Dealt to MrBrown [Jc 2s]
Dealt to MrBlue [3s 3c]
Dealt to Bill [7s 3d]
Eddie: folds
MrBrown: folds
MrBlue: raises 125 to 225
Bill: folds
MrPink: folds
Pluribus: calls 125
*** FLOP *** [2d 7d Qs]
Pluribus: checks
MrBlue: bets 250
Pluribus: raises 500 to 750
MrBlue: folds
Uncalled bet (500) returned to Pluribus
Pluribus collected 1000.0 from pot
*** SUMMARY ***
Total pot 1000 | Rake 0
Board [2d 7d Qs]


PokerStars Hand #43047: Hold'em No Limit (50/100) - 2019/07/11 11:57:27 ET
Table 'Pluribus Session 43' 6-max (Play Money) Seat #6 is the button
Seat 1: Pluribus (10000 in chips)
Seat 2: Eddie (10000 in chips)
Seat 3: MrBrown (10000 in chips)
Seat 4: MrBlue (10000 in chips)
Seat 5: Bill (10000 in chips)
Seat 6: MrPink (10000 in chips)
Pluribus: posts small blind 50
Eddie: posts big blind 100
*** HOLE CARDS ***
Dealt to Pluribus [Ad 8c]
Dealt to Eddie [9s 7s]
Dealt to MrBrown [Jc Kc]
Dealt to MrBlue [2c 3h]
Dealt to Bill [4c 8h]
Dealt to MrPink [9h Qh]
MrBrown: raises 125 to 225
MrBlue: folds
Bill: folds
MrPink: folds
Pluribus: folds
Eddie: calls 125
*** FLOP *** [4d Ac 3s]
Eddie: checks
MrBrown: checks
*** TURN *** [4d Ac 3s] [7c]
Eddie: checks
MrBrown: checks
*** RIVER *** [4d Ac 3s] [7c] [5d]
Eddie: checks
MrBrown: checks
*** SHOWDOWN ***
Eddie: shows [9s 7s]
Eddie collected 500.0 from pot
*** SUMMARY ***
Total pot 500 | Rake 0
Board [4d Ac 3s 7c 5d]
Seat 2: Eddie showed [9s 7s] and won (500.0)
Seat 3: MrBrown showed [Jc Kc] and lost


PokerStars Hand #43048: Hold'em No Limit (50/100) - 2019/07/11 11:57:28 ET
Table 'Pluribus Session 43' 6-max (Play Money) Seat #6 is the button
Seat 1: Eddie (10000 in chips)
Seat 2: MrBrown (10000 in chips)
Seat 3: MrBlue (10000 in chips)
Seat 4: Bill (10000 in chips)
Seat 5: MrPink (10000 in chips)
Seat 6: Pluribus (10000 in chips)
Eddie: posts small blind 50
MrBrown: posts big blind 100
*** HOLE CARDS ***
Dealt to Eddie [6d Qs]
Dealt to MrBrown [5s 6s]
Dealt to MrBlue [Qc 8c]
Dealt to Bill [Td 9d]
Dealt to MrPink [2c 6h]
Dealt to Pluribus [Qd 9h]
MrBlue: folds
Bill: raises 125 to 225
MrPink: folds
Pluribus: folds
Eddie: folds
MrBrown: calls 125
*** FLOP *** [7h Qh 4h]
MrBrown: checks
Bill: bets 150
MrBrown: folds
Uncalled bet (150) returned to Bill
Bill collected 500.0 from pot
*** SUMMARY ***
Total pot 500 | Rake 0
Board [7h Qh 4h]


PokerStars Hand #43049: Hold'em No Limit (50/100) - 2019/07/11 11:57:29 ET
Table 'Pluribus Session 43' 6-max (Play Money) Seat #6 is the button
Seat 1: MrBrown (10000 in chips)
Seat 2: MrBlue (10000 in chips)
Seat 3: Bill (10000 in chips)
Seat 4: MrPink (10000 in chips)
Seat 5: Pluribus (10000 in chips)
Seat 6: Eddie (10000 in chips)
MrBrown: posts small blind 50
MrBlue: posts big blind 100
*** HOLE CARDS ***
Dealt to MrBrown [7h 2c]
Dealt to MrBlue [Td Kd]
Dealt to Bill [Qs Ts]
Dealt to MrPink [5h Ad]
Dealt to Pluribus [Ac Jd]
Dealt to Eddie [7s 3d]
Bill: raises 125 to 225
MrPink: folds
Pluribus: folds
Eddie: folds
MrBrown: folds
MrBlue: calls 125
*** FLOP *** [5d 4h Qd]
MrBlue: checks
Bill: checks
*** TURN *** [5d 4h Qd] [3s]
MrBlue: checks
Bill: bets 250
MrBlue: calls 250
*** RIVER *** [5d 4h Qd] [3s] [8h]
MrBlue: checks
Bill: bets 750
MrBlue: folds
Uncalled bet (750) returned to Bill
Bill collected 1000.0 from pot
*** SUMMARY ***
Total pot 1000 | Rake 0
Board [5d 4h Qd 3s 8h]


PokerStars Hand #43050: Hold'em No Limit (50/100) - 2019/07/11 11:57:30 ET
Table 'Pluribus Session 43' 6-max (Play Money) Seat #6 is the button
Seat 1: MrBlue (10000 in chips)
Seat 2: Bill (10000 in chips)
Seat 3: MrPink (10000 in chips)
Seat 4: Pluribus (10000 in chips)
Seat 5: Eddie (10000 in chips)
Seat 6: MrBrown (10000 in chips)
MrBlue: posts small blind 50
Bill: posts big blind 100
*** HOLE CARDS ***
Dealt to MrBlue [7d 2d]
Dealt to Bill [5s 4h]
Dealt to MrPink [4d 2c]
Dealt to Pluribus [Tc 8h]
Dealt to Eddie [5h 7h]
Dealt to MrBrown [Ts 5c]
MrPink: folds
Pluribus: folds
Eddie: raises 100 to 200
MrBrown: folds
MrBlue: folds
Bill: folds
Uncalled bet (100) returned to Eddie
Eddie collected 250.0 from pot
*** SUMMARY ***
Total pot 250 | Rake 0


PokerStars Hand #43051: Hold'em No Limit (50/100) - 2019/07/11 11:57:31 ET
Table 'Pluribus Session 43' 6-max (Play Money) Seat #6 is the button
Seat 1: Bill (10000 in chips)
Seat 2: MrPink (10000 in chips)
Seat 3: Pluribus (10000 in chips)
Seat 4: Eddie (10000 in chips)
Seat 5: MrBrown (10000 in chips)
Seat 6: MrBlue (10000 in chips)
Bill: posts small blind 50
MrPink: posts big blind 100
*** HOLE CARDS ***
Dealt to Bill [6h Qc]
Dealt to MrPink [9h Th]
Dealt to Pluribus [7h Qd]
Dealt to Eddie [3d Jc]
Dealt to MrBrown [Ac 6d]
Dealt to MrBlue [2d 8d]
Pluribus: folds
Eddie: folds
MrBrown: folds
MrBlue: folds
Bill: folds
Uncalled bet (50) returned to MrPink
MrPink collected 100.0 from pot
*** SUMMARY ***
Total pot 100 | Rake 0


PokerStars Hand #43052: Hold'em No Limit (50/100) - 2019/07/11 11:57:32 ET
Table 'Pluribus Session 43' 6-max (Play Money) Seat #6 is the button
Seat 1: MrPink (10000 in chips)
Seat 2: Pluribus (10000 in chips)
Seat 3: Eddie (10000 in chips)
Seat 4: MrBrown (10000 in chips)
Seat 5: MrBlue (10000 in chips)
Seat 6: Bill (10000 in chips)
MrPink: posts small blind 50
Pluribus: posts big blind 100
*** HOLE CARDS ***
Dealt to MrPink [3h 6d]
Dealt to Pluribus [7d 4h]
Dealt to Eddie [2s 3d]
Dealt to MrBrown [9d 7s]
Dealt to MrBlue [2c 5d]
Dealt to Bill [Ts Jc]
Eddie: folds
MrBrown: folds
MrBlue: folds
Bill: raises 187 to 287
MrPink: folds
Pluribus: folds
Uncalled bet (187) returned to Bill
Bill collected 250.0 from pot
*** SUMMARY ***
Total pot 250 | Rake 0


PokerStars Hand #43053: Hold'em No Limit (50/100) - 2019/07/11 11:57:33 ET
Table 'Pluribus Session 43' 6-max (Play Money) Seat #6 is the button
Seat 1: Pluribus (10000 in chips)
Seat 2: Eddie (10000 in chips)
Seat 3: MrBrown (10000 in chips)
Seat 4: MrBlue (10000 in chips)
Seat 5: Bill (10000 in chips)
Seat 6: MrPink (10000 in chips)
Pluribus: posts small blind 50
Eddie: posts big blind 100
*** HOLE CARDS ***
Dealt to Pluribus [2d 3h]
Dealt to Eddie [2s 8d]
Dealt to MrBrown [9h Jh]
Dealt to MrBlue [Js 6h]
Dealt to Bill [Tc Qc]
Dealt to MrPink [Ad 3d]
MrBrown: folds
MrBlue: folds
Bill: raises 125 to 225
MrPink: raises 475 to 700
Pluribus: folds
Eddie: folds
Bill: calls 475
*** FLOP *** [9d 8s 2c]
Bill: checks
MrPink: bets 500
Bill: raises 1000 to 1500
MrPink: folds
Uncalled bet (1000) returned to Bill
Bill collected 2550.0 from pot
*** SUMMARY ***
Total pot 2550 | Rake 0
Board [9d 8s 2c]


PokerStars Hand #43054: Hold'em No Limit (50/100) - 2019/07/11 11:57:34 ET
Table 'Pluribus Session 43' 6-max (Play Money) Seat #6 is the button
Seat 1: Eddie (10000 in chips)
Seat 2: MrBrown (10000 in chips)
Seat 3: MrBlue (10000 in chips)
Seat 4: Bill (10000 in chips)
Seat 5: MrPink (10000 in chips)
Seat 6: Pluribus (10000 in chips)
Eddie: posts small blind 50
MrBrown: posts big blind 100
*** HOLE CARDS ***
Dealt to Eddie [4h Js]
Dealt to MrBrown [Qc Ac]
Dealt to MrBlue [8h 5s]
Dealt to Bill [7h Kh]
Dealt to MrPink [7s 5d]
Dealt to Pluribus [Ks 6d]
MrBlue: folds
Bill: folds
MrPink: folds
Pluribus: folds
Eddie: folds
Uncalled bet (50) returned to MrBrown
MrBrown collected 100.0 from pot
*** SUMMARY ***
Total pot 100 | Rake 0


PokerStars Hand #43055: Hold'em No Limit (50/100) - 2019/07/11 11:57:35 ET
Table 'Pluribus Session 43' 6-max (Play Money) Seat #6 is the button
Seat 1: MrBrown (10000 in chips)
Seat 2: MrBlue (10000 in chips)
Seat 3: Bill (10000 in chips)
Seat 4: MrPink (10000 in chips)
Seat 5: Pluribus (10000 in chips)
Seat 6: Eddie (10000 in chips)
MrBrown: posts small blind 50
MrBlue: posts big blind 100
*** HOLE CARDS ***
Dealt to MrBrown [Td 9s]
Dealt to MrBlue [Qs 9c]
Dealt to Bill [9d Qc]
Dealt to MrPink [8s Ac]
Dealt to Pluribus [6s 4s]
Dealt to Eddie [Th 7s]
Bill: folds
MrPink: folds
Pluribus: folds
Eddie: folds
MrBrown: calls 50
MrBlue: checks
*** FLOP *** [3d 6h Kh]
MrBrown: checks
MrBlue: checks
*** TURN *** [3d 6h Kh] [2d]
MrBrown: checks
MrBlue: bets 150
MrBrown: folds
Uncalled bet (150) returned to MrBlue
MrBlue collected 200.0 from pot
*** SUMMARY ***
Total pot 200 | Rake 0
Board [3d 6h Kh 2d]


PokerStars Hand #43056: Hold'em No Limit (50/100) - 2019/07/11 11:57:36 ET
Table 'Pluribus Session 43' 6-max (Play Money) Seat #6 is the button
Seat 1: MrBlue (10000 in chips)
Seat 2: Bill (10000 in chips)
Seat 3: MrPink (10000 in chips)
Seat 4: Pluribus (10000 in chips)
Seat 5: Eddie (10000 in chips)
Seat 6: MrBrown (10000 in chips)
MrBlue: posts small blind 50
Bill: posts big blind 100
*** HOLE CARDS ***
Dealt to MrBlue [9d 4c]
Dealt to Bill [Jc 3h]
Dealt to MrPink [3c 5s]
Dealt to Pluribus [Ks Kd]
Dealt to Eddie [8c Kh]
Dealt to MrBrown [Ac 5d]
MrPink: folds
Pluribus: raises 150 to 250
Eddie: folds
MrBrown: folds
MrBlue: folds
Bill: folds
Uncalled bet (150) returned to Pluribus
Pluribus collected 250.0 from pot
*** SUMMARY ***
Total pot 250 | Rake 0


PokerStars Hand #43057: Hold'em No Limit (50/100) - 2019/07/11 11:57:37 ET
Table 'Pluribus Session 43' 6-max (Play Money) Seat #6 is the button
Seat 1: Bill (10000 in chips)
Seat 2: MrPink (10000 in chips)
Seat 3: Pluribus (10000 in chips)
Seat 4: Eddie (10000 in chips)
Seat 5: MrBrown (10000 in chips)
Seat 6: MrBlue (10000 in chips)
Bill: posts small blind 50
MrPink: posts big blind 100
*** HOLE CARDS ***
Dealt to Bill [9s 3d]
Dealt to MrPink [7c Kh]
Dealt to Pluribus [Qd 6s]
Dealt to Eddie [4d 6h]
Dealt to MrBrown [Kd Qh]
Dealt to MrBlue [2d 2c]
Pluribus: folds
Eddie: folds
MrBrown: raises 125 to 225
MrBlue: raises 547 to 772
Bill: folds
MrPink: folds
MrBrown: raises 853 to 1625
MrBlue: calls 853
*** FLOP *** [Qc 9c Jd]
MrBrown: checks
MrBlue: checks
*** TURN *** [Qc 9c Jd] [Td]
MrBrown: checks
MrBlue: checks
*** RIVER *** [Qc 9c Jd] [Td] [2s]
MrBrown: bets 1500
MrBlue: calls 1500
*** SHOWDOWN ***
MrBrown: shows [Kd Qh]
MrBrown collected 6400.0 from pot
*** SUMMARY ***
Total pot 6400 | Rake 0
Board [Qc 9c Jd Td 2s]
Seat 5: MrBrown showed [Kd Qh] and won (6400.0)
Seat 6: MrBlue showed [2d 2c] and lost


PokerStars Hand #43058: Hold'em No Limit (50/100) - 2019/07/11 11:57:38 ET
Table 'Pluribus Session 43' 6-max (Play Money) Seat #6 is the button
Seat 1: MrPink (10000 in chips)
Seat 2: Pluribus (10000 in chips)
Seat 3: Eddie (10000 in chips)
Seat 4: MrBrown (10000 in chips)
Seat 5: MrBlue (10000 in chips)
Seat 6: Bill (10000 in chips)
MrPink: posts small blind 50
Pluribus: posts big blind 100
*** HOLE CARDS ***
Dealt to MrPink [6d 3d]
Dealt to Pluribus [9c 5d]
Dealt to Eddie [3s 5c]
Dealt to MrBrown [3c 4h]
Dealt to MrBlue [8d 2h]
Dealt to Bill [2d 7s]
Eddie: folds
MrBrown: folds
MrBlue: folds
Bill: folds
MrPink: calls 50
Pluribus: raises 175 to 275
MrPink: calls 175
*** FLOP *** [Ts 2c 6h]
MrPink: checks
Pluribus: bets 275
MrPink: calls 275
*** TURN *** [Ts 2c 6h] [Qd]
MrPink: checks
Pluribus: checks
*** RIVER *** [Ts 2c 6h] [Qd] [7d]
MrPink: checks
Pluribus: bets 550
MrPink: folds
Uncalled bet (550) returned to Pluribus
Pluribus collected 1100.0 from pot
*** SUMMARY ***
Total pot 1100 | Rake 0
Board [Ts 2c 6h Qd 7d]


PokerStars Hand #43059: Hold'em No Limit (50/100) - 2019/07/11 11:57:39 ET
Table 'Pluribus Session 43' 6-max (Play Money) Seat #6 is the button
Seat 1: Pluribus (10000 in chips)
Seat 2: Eddie (10000 in chips)
Seat 3: MrBrown (10000 in chips)
Seat 4: MrBlue (10000 in chips)
Seat 5: Bill (10000 in chips)
Seat 6: MrPink (10000 in chips)
Pluribus: posts small blind 50
Eddie: posts big blind 100
*** HOLE CARDS ***
Dealt to Pluribus [Td 3c]
Dealt to Eddie [9c 6s]
Dealt to MrBrown [5c 6h]
Dealt to MrBlue [3d Ah]
Dealt to Bill [4c 9h]
Dealt to MrPink [3h 8c]
MrBrown: folds
MrBlue: folds
Bill: folds
MrPink: folds
Pluribus: folds
Uncalled bet (50) returned to Eddie
Eddie collected 100.0 from pot
*** SUMMARY ***
Total pot 100 | Rake 0


PokerStars Hand #43060: Hold'em No Limit (50/100) - 2019/07/11 11:57:40 ET
Table 'Pluribus Session 43' 6-max (Play Money) Seat #6 is the button
Seat 1: Eddie (10000 in chips)
Seat 2: MrBrown (10000 in chips)
Seat 3: MrBlue (10000 in chips)
Seat 4: Bill (10000 in chips)
Seat 5: MrPink (10000 in chips)
Seat 6: Pluribus (10000 in chips)
Eddie: posts small blind 50
MrBrown: posts big blind 100
*** HOLE CARDS ***
Dealt to Eddie [3d 6d]
Dealt to MrBrown [Jd 4s]
Dealt to MrBlue [5c 4c]
Dealt to Bill [As 8s]
Dealt to MrPink [2c Qs]
Dealt to Pluribus [Ks 6h]
MrBlue: raises 125 to 225
Bill: raises 475 to 700
MrPink: folds
Pluribus: folds
Eddie: folds
MrBrown: folds
MrBlue: calls 475
*** FLOP *** [6c Tc 2d]
MrBlue: checks
Bill: checks
*** TURN *** [6c Tc 2d] [Td]
MrBlue: checks
Bill: checks
*** RIVER *** [6c Tc 2d] [Td] [9d]
MrBlue: bets 1135
Bill: folds
Uncalled bet (1135) returned to MrBlue
MrBlue collected 1550.0 from pot
*** SUMMARY ***
Total pot 1550 | Rake 0
Board [6c Tc 2d Td 9d]


PokerStars Hand #43061: Hold'em No Limit (50/100) - 2019/07/11 11:57:41 ET
Table 'Pluribus Session 43' 6-max (Play Money) Seat #6 is the button
Seat 1: MrBrown (10000 in chips)
Seat 2: MrBlue (10000 in chips)
Seat 3: Bill (10000 in chips)
Seat 4: MrPink (10000 in chips)
Seat 5: Pluribus (10000 in chips)
Seat 6: Eddie (10000 in chips)
MrBrown: posts small blind 50
MrBlue: posts big blind 100
*** HOLE CARDS ***
Dealt to MrBrown [2h 8d]
Dealt to MrBlue [Kc 5h]
Dealt to Bill [Ad 8h]
Dealt to MrPink [Ts 4c]
Dealt to Pluribus [7h 4s]
Dealt to Eddie [5d Qc]
Bill: folds
MrPink: folds
Pluribus: folds
Eddie: folds
MrBrown: folds
Uncalled bet (50) returned to MrBlue
MrBlue collected 100.0 from pot
*** SUMMARY ***
Total pot 100 | Rake 0


PokerStars Hand #43062: Hold'em No Limit (50/100) - 2019/07/11 11:57:42 ET
Table 'Pluribus Session 43' 6-max (Play Money) Seat #6 is the button
Seat 1: MrBlue (10000 in chips)
Seat 2: Bill (10000 in chips)
Seat 3: MrPink (10000 in chips)
Seat 4: Pluribus (10000 in chips)
Seat 5: Eddie (10000 in chips)
Seat 6: MrBrown (10000 in chips)
MrBlue: posts small blind 50
Bill: posts big blind 100
*** HOLE CARDS ***
Dealt to MrBlue [Js 3d]
Dealt to Bill [4d 5c]
Dealt to MrPink [4s Ks]
Dealt to Pluribus [5h Kc]
Dealt to Eddie [Jc 3h]
Dealt to MrBrown [Ad 2h]
MrPink: folds
Pluribus: folds
Eddie: folds
MrBrown: raises 150 to 250
MrBlue: folds
Bill: calls 150
*** FLOP *** [Ah 8c 7d]
Bill: checks
MrBrown: checks
*** TURN *** [Ah 8c 7d] [As]
Bill: bets 275
MrBrown: calls 275
*** RIVER *** [Ah 8c 7d] [As] [3c]
Bill: bets 1100
MrBrown: calls 1100
*** SHOWDOWN ***
MrBrown: shows [Ad 2h]
MrBrown collected 3300.0 from pot
*** SUMMARY ***
Total pot 3300 | Rake 0
Board [Ah 8c 7d As 3c]
Seat 2: Bill showed [4d 5c] and lost
Seat 6: MrBrown showed [Ad 2h] and won (3300.0)


PokerStars Hand #43063: Hold'em No Limit (50/100) - 2019/07/11 11:57:43 ET
Table 'Pluribus Session 43' 6-max (Play Money) Seat #6 is the button
Seat 1: Bill (10000 in chips)
Seat 2: MrPink (10000 in chips)
Seat 3: Pluribus (10000 in chips)
Seat 4: Eddie (10000 in chips)
Seat 5: MrBrown (10000 in chips)
Seat 6: MrBlue (10000 in chips)
Bill: posts small blind 50
MrPink: posts big blind 100
*** HOLE CARDS ***
Dealt to Bill [Kd Kh]
Dealt to MrPink [Ac 5s]
Dealt to Pluribus [Js 3d]
Dealt to Eddie [3h Qh]
Dealt to MrBrown [Ad 2h]
Dealt to MrBlue [7d 4s]
Pluribus: folds
Eddie: folds
MrBrown: folds
MrBlue: folds
Bill: raises 200 to 300
MrPink: calls 200
*** FLOP *** [8h 3s 9s]
Bill: bets 450
MrPink: folds
Uncalled bet (450) returned to Bill
Bill collected 600.0 from pot
*** SUMMARY ***
Total pot 600 | Rake 0
Board [8h 3s 9s]


PokerStars Hand #43064: Hold'em No Limit (50/100) - 2019/07/11 11:57:44 ET
Table 'Pluribus Session 43' 6-max (Play Money) Seat #6 is the button
Seat 1: MrPink (10000 in chips)
Seat 2: Pluribus (10000 in chips)
Seat 3: Eddie (10000 in chips)
Seat 4: MrBrown (10000 in chips)
Seat 5: MrBlue (10000 in chips)
Seat 6: Bill (10000 in chips)
MrPink: posts small blind 50
Pluribus: posts big blind 100
*** HOLE CARDS ***
Dealt to MrPink [Jh Td]
Dealt to Pluribus [3h 5d]
Dealt to Eddie [Ac 4c]
Dealt to MrBrown [4d Js]
Dealt to MrBlue [5s Ks]
Dealt to Bill [9d Jd]
Eddie: raises 100 to 200
MrBrown: folds
MrBlue: folds
Bill: calls 200
MrPink: folds
Pluribus: calls 100
*** FLOP *** [Qh 6d 8h]
Pluribus: checks
Eddie: checks
Bill: bets 325
Pluribus: folds
Eddie: folds
Uncalled bet (325) returned to Bill
Bill collected 650.0 from pot
*** SUMMARY ***
Total pot 650 | Rake 0
Board [Qh 6d 8h]


PokerStars Hand #43065: Hold'em No Limit (50/100) - 2019/07/11 11:57:45 ET
Table 'Pluribus Session 43' 6-max (Play Money) Seat #6 is the button
Seat 1: Pluribus (10000 in chips)
Seat 2: Eddie (10000 in chips)
Seat 3: MrBrown (10000 in chips)
Seat 4: MrBlue (10000 in chips)
Seat 5: Bill (10000 in chips)
Seat 6: MrPink (10000 in chips)
Pluribus: posts small blind 50
Eddie: posts big blind 100
*** HOLE CARDS ***
Dealt to Pluribus [4d Jc]
Dealt to Eddie [Ts 3h]
Dealt to MrBrown [3c 9c]
Dealt to MrBlue [Ah Tc]
Dealt to Bill [6h As]
Dealt to MrPink [Ac 5s]
MrBrown: folds
MrBlue: folds
Bill: folds
MrPink: raises 150 to 250
Pluribus: folds
Eddie: folds
Uncalled bet (150) returned to MrPink
MrPink collected 250.0 from pot
*** SUMMARY ***
Total pot 250 | Rake 0


PokerStars Hand #43066: Hold'em No Limit (50/100) - 2019/07/11 11:57:46 ET
Table 'Pluribus Session 43' 6-max (Play Money) Seat #6 is the button
Seat 1: Eddie (10000 in chips)
Seat 2: MrBrown (10000 in chips)
Seat 3: MrBlue (10000 in chips)
Seat 4: Bill (10000 in chips)
Seat 5: MrPink (10000 in chips)
Seat 6: Pluribus (10000 in chips)
Eddie: posts small blind 50
MrBrown: posts big blind 100
*** HOLE CARDS ***
Dealt to Eddie [2s 4s]
Dealt to MrBrown [Ts 3d]
Dealt to MrBlue [6s 5s]
Dealt to Bill [Kd 2c]
Dealt to MrPink [Jc Js]
Dealt to Pluribus [8s 7h]
MrBlue: raises 125 to 225
Bill: folds
MrPink: raises 475 to 700
Pluribus: folds
Eddie: folds
MrBrown: folds
MrBlue: calls 475
*** FLOP *** [Qh Jd 5h]
MrBlue: checks
MrPink: bets 500
MrBlue: calls 500
*** TURN *** [Qh Jd 5h] [Ah]
MrBlue: checks
MrPink: bets 1600
MrBlue: folds
Uncalled bet (1600) returned to MrPink
MrPink collected 2550.0 from pot
*** SUMMARY ***
Total pot 2550 | Rake 0
Board [Qh Jd 5h Ah]


PokerStars Hand #43067: Hold'em No Limit (50/100) - 2019/07/11 11:57:47 ET
Table 'Pluribus Session 43' 6-max (Play Money) Seat #6 is the button
Seat 1: MrBrown (10000 in chips)
Seat 2: MrBlue (10000 in chips)
Seat 3: Bill (10000 in chips)
Seat 4: MrPink (10000 in chips)
Seat 5: Pluribus (10000 in chips)
Seat 6: Eddie (10000 in chips)
MrBrown: posts small blind 50
MrBlue: posts big blind 100
*** HOLE CARDS ***
Dealt to MrBrown [8c 7s]
Dealt to MrBlue [8h 4h]
Dealt to Bill [5d Jc]
Dealt to MrPink [5c 3c]
Dealt to Pluribus [9d Qd]
Dealt to Eddie [6d 8s]
Bill: folds
MrPink: folds
Pluribus: raises 100 to 200
Eddie: folds
MrBrown: folds
MrBlue: calls 100
*** FLOP *** [7h Kc Jd]
MrBlue: checks
Pluribus: bets 450
MrBlue: folds
Uncalled bet (450) returned to Pluribus
Pluribus collected 450.0 from pot
*** SUMMARY ***
Total pot 450 | Rake 0
Board [7h Kc Jd]


PokerStars Hand #43068: Hold'em No Limit (50/100) - 2019/07/11 11:57:48 ET
Table 'Pluribus Session 43' 6-max (Play Money) Seat #6 is the button
Seat 1: MrBlue (10000 in chips)
Seat 2: Bill (10000 in chips)
Seat 3: MrPink (10000 in chips)
Seat 4: Pluribus (10000 in chips)
Seat 5: Eddie (10000 in chips)
Seat 6: MrBrown (10000 in chips)
MrBlue: posts small blind 50
Bill: posts big blind 100
*** HOLE CARDS ***
Dealt to MrBlue [3c 8c]
Dealt to Bill [Th 9d]
Dealt to MrPink [Ad Js]
Dealt to Pluribus [7d 4s]
Dealt to Eddie [7h Ah]
Dealt to MrBrown [6d Ac]
MrPink: raises 110 to 210
Pluribus: folds
Eddie: folds
MrBrown: folds
MrBlue: folds
Bill: calls 110
*** FLOP *** [8s 3d 9s]
Bill: checks
MrPink: bets 470
Bill: calls 470
*** TURN *** [8s 3d 9s] [5c]
Bill: checks
MrPink: checks
*** RIVER *** [8s 3d 9s] [5c] [5s]
Bill: checks
MrPink: checks
*** SHOWDOWN ***
Bill: shows [Th 9d]
Bill collected 1410.0 from pot
*** SUMMARY ***
Total pot 1410 | Rake 0
Board [8s 3d 9s 5c 5s]
Seat 2: Bill showed [Th 9d] and won (1410.0)
Seat 3: MrPink showed [Ad Js] and lost


PokerStars Hand #43069: Hold'em No Limit (50/100) - 2019/07/11 11:57:49 ET
Table 'Pluribus Session 43' 6-max (Play Money) Seat #6 is the button
Seat 1: Bill (10000 in chips)
Seat 2: MrPink (10000 in chips)
Seat 3: Pluribus (10000 in chips)
Seat 4: Eddie (10000 in chips)
Seat 5: MrBrown (10000 in chips)
Seat 6: MrBlue (10000 in chips)
Bill: posts small blind 50
MrPink: posts big blind 100
*** HOLE CARDS ***
Dealt to Bill [Ac As]
Dealt to MrPink [6d 9s]
Dealt to Pluribus [7c 9c]
Dealt to Eddie [4d Tc]
Dealt to MrBrown [Ad 2d]
Dealt to MrBlue [8s Qh]
Pluribus: folds
Eddie: folds
MrBrown: raises 125 to 225
MrBlue: folds
Bill: raises 725 to 950
MrPink: folds
MrBrown: folds
Uncalled bet (725) returned to Bill
Bill collected 550.0 from pot
*** SUMMARY ***
Total pot 550 | Rake 0


PokerStars Hand #43070: Hold'em No Limit (50/100) - 2019/07/11 11:57:50 ET
Table 'Pluribus Session 43' 6-max (Play Money) Seat #6 is the button
Seat 1: MrPink (10000 in chips)
Seat 2: Pluribus (10000 in chips)
Seat 3: Eddie (10000 in chips)
Seat 4: MrBrown (10000 in chips)
Seat 5: MrBlue (10000 in chips)
Seat 6: Bill (10000 in chips)
MrPink: posts small blind 50
Pluribus: posts big blind 100
*** HOLE CARDS ***
Dealt to MrPink [8s 3d]
Dealt to Pluribus [Jd 4h]
Dealt to Eddie [7d As]
Dealt to MrBrown [6h 9d]
Dealt to MrBlue [Js 3c]
Dealt to Bill [Ts 8h]
Eddie: folds
MrBrown: folds
MrBlue: folds
Bill: raises 187 to 287
MrPink: folds
Pluribus: folds
Uncalled bet (187) returned to Bill
Bill collected 250.0 from pot
*** SUMMARY ***
Total pot 250 | Rake 0


PokerStars Hand #43071: Hold'em No Limit (50/100) - 2019/07/11 11:57:51 ET
Table 'Pluribus Session 43' 6-max (Play Money) Seat #6 is the button
Seat 1: Pluribus (10000 in chips)
Seat 2: Eddie (10000 in chips)
Seat 3: MrBrown (10000 in chips)
Seat 4: MrBlue (10000 in chips)
Seat 5: Bill (10000 in chips)
Seat 6: MrPink (10000 in chips)
Pluribus: posts small blind 50
Eddie: posts big blind 100
*** HOLE CARDS ***
Dealt to Pluribus [9c Qs]
Dealt to Eddie [6s 9d]
Dealt to MrBrown [6d 5s]
Dealt to MrBlue [7h Tc]
Dealt to Bill [3h 8h]
Dealt to MrPink [2s Kh]
MrBrown: folds
MrBlue: folds
Bill: folds
MrPink: folds
Pluribus: raises 100 to 200
Eddie: calls 100
*** FLOP *** [4s 4d 5c]
Pluribus: checks
Eddie: bets 200
Pluribus: folds
Uncalled bet (200) returned to Eddie
Eddie collected 400.0 from pot
*** SUMMARY ***
Total pot 400 | Rake 0
Board [4s 4d 5c]


PokerStars Hand #43072: Hold'em No Limit (50/100) - 2019/07/11 11:57:52 ET
Table 'Pluribus Session 43' 6-max (Play Money) Seat #6 is the button
Seat 1: Eddie (10000 in chips)
Seat 2: MrBrown (10000 in chips)
Seat 3: MrBlue (10000 in chips)
Seat 4: Bill (10000 in chips)
Seat 5: MrPink (10000 in chips)
Seat 6: Pluribus (10000 in chips)
Eddie: posts small blind 50
MrBrown: posts big blind 100
*** HOLE CARDS ***
Dealt to Eddie [7c 7s]
Dealt to MrBrown [Ac 5d]
Dealt to MrBlue [5s 7d]
Dealt to Bill [Jh Td]
Dealt to MrPink [9d 4s]
Dealt to Pluribus [2d Qc]
MrBlue: folds
Bill: folds
MrPink: folds
Pluribus: folds
Eddie: raises 200 to 300
MrBrown: calls 200
*** FLOP *** [9h 3h As]
Eddie: checks
MrBrown: checks
*** TURN *** [9h 3h As] [6d]
Eddie: checks
MrBrown: bets 300
Eddie: calls 300
*** RIVER *** [9h 3h As] [6d] [6c]
Eddie: checks
MrBrown: checks
*** SHOWDOWN ***
MrBrown: shows [Ac 5d]
MrBrown collected 1200.0 from pot
*** SUMMARY ***
Total pot 1200 | Rake 0
Board [9h 3h As 6d 6c]
Seat 1: Eddie showed [7c 7s] and lost
Seat 2: MrBrown showed [Ac 5d] and won (1200.0)


PokerStars Hand #43073: Hold'em No Limit (50/100) - 2019/07/11 11:57:53 ET
Table 'Pluribus Session 43' 6-max (Play Money) Seat #6 is the button
Seat 1: MrBrown (10000 in chips)
Seat 2: MrBlue (10000 in chips)
Seat 3: Bill (10000 in chips)
Seat 4: MrPink (10000 in chips)
Seat 5: Pluribus (10000 in chips)
Seat 6: Eddie (10000 in chips)
MrBrown: posts small blind 50
MrBlue: posts big blind 100
*** HOLE CARDS ***
Dealt to MrBrown [2c 8s]
Dealt to MrBlue [5d 3h]
Dealt to Bill [3c 2h]
Dealt to MrPink [9h 6d]
Dealt to Pluribus [6s Jh]
Dealt to Eddie [Ah 3s]
Bill: folds
MrPink: folds
Pluribus: folds
Eddie: folds
MrBrown: folds
Uncalled bet (50) returned to MrBlue
MrBlue collected 100.0 from pot
*** SUMMARY ***
Total pot 100 | Rake 0


PokerStars Hand #43074: Hold'em No Limit (50/100) - 2019/07/11 11:57:54 ET
Table 'Pluribus Session 43' 6-max (Play Money) Seat #6 is the button
Seat 1: MrBlue (10000 in chips)
Seat 2: Bill (10000 in chips)
Seat 3: MrPink (10000 in chips)
Seat 4: Pluribus (10000 in chips)
Seat 5: Eddie (10000 in chips)
Seat 6: MrBrown (10000 in chips)
MrBlue: posts small blind 50
Bill: posts big blind 100
*** HOLE CARDS ***
Dealt to MrBlue [4d 2c]
Dealt to Bill [6s 6c]
Dealt to MrPink [2h 8h]
Dealt to Pluribus [Qd 8c]
Dealt to Eddie [3h Ts]
Dealt to MrBrown [Jd Th]
MrPink: folds
Pluribus: folds
Eddie: folds
MrBrown: raises 150 to 250
MrBlue: folds
Bill: calls 150
*** FLOP *** [Kc 7c Qc]
Bill: checks
MrBrown: checks
*** TURN *** [Kc 7c Qc] [9s]
Bill: checks
MrBrown: bets 412
Bill: folds
Uncalled bet (412) returned to MrBrown
MrBrown collected 550.0 from pot
*** SUMMARY ***
Total pot 550 | Rake 0
Board [Kc 7c Qc 9s]


PokerStars Hand #43075: Hold'em No Limit (50/100) - 2019/07/11 11:57:55 ET
Table 'Pluribus Session 43' 6-max (Play Money) Seat #6 is the button
Seat 1: Bill (10000 in chips)
Seat 2: MrPink (10000 in chips)
Seat 3: Pluribus (10000 in chips)
Seat 4: Eddie (10000 in chips)
Seat 5: MrBrown (10000 in chips)
Seat 6: MrBlue (10000 in chips)
Bill: posts small blind 50
MrPink: posts big blind 100
*** HOLE CARDS ***
Dealt to Bill [4h 6c]
Dealt to MrPink [2s Ad]
Dealt to Pluribus [9d Kc]
Dealt to Eddie [Jh Js]
Dealt to MrBrown [3h 5s]
Dealt to MrBlue [Tc 7h]
Pluribus: folds
Eddie: raises 100 to 200
MrBrown: folds
MrBlue: folds
Bill: folds
MrPink: calls 100
*** FLOP *** [2c 8c Jc]
MrPink: checks
Eddie: bets 100
MrPink: calls 100
*** TURN *** [2c 8c Jc] [2d]
MrPink: checks
Eddie: bets 520
MrPink: calls 520
*** RIVER *** [2c 8c Jc] [2d] [3c]
MrPink: checks
Eddie: bets 845
MrPink: folds
Uncalled bet (845) returned to Eddie
Eddie collected 1690.0 from pot
*** SUMMARY ***
Total pot 1690 | Rake 0
Board [2c 8c Jc 2d 3c]


PokerStars Hand #43076: Hold'em No Limit (50/100) - 2019/07/11 11:57:56 ET
Table 'Pluribus Session 43' 6-max (Play Money) Seat #6 is the button
Seat 1: MrPink (10000 in chips)
Seat 2: Pluribus (10000 in chips)
Seat 3: Eddie (10000 in chips)
Seat 4: MrBrown (10000 in chips)
Seat 5: MrBlue (10000 in chips)
Seat 6: Bill (10000 in chips)
MrPink: posts small blind 50
Pluribus: posts big blind 100
*** HOLE CARDS ***
Dealt to MrPink [8s Js]
Dealt to Pluribus [Kc 9h]
Dealt to Eddie [5c 4h]
Dealt to MrBrown [6s Qh]
Dealt to MrBlue [Tc Ah]
Dealt to Bill [Jd Jh]
Eddie: folds
MrBrown: folds
MrBlue: raises 125 to 225
Bill: raises 575 to 800
MrPink: folds
Pluribus: folds
MrBlue: folds
Uncalled bet (575) returned to Bill
Bill collected 600.0 from pot
*** SUMMARY ***
Total pot 600 | Rake 0


PokerStars Hand #43077: Hold'em No Limit (50/100) - 2019/07/11 11:57:57 ET
Table 'Pluribus Session 43' 6-max (Play Money) Seat #6 is the button
Seat 1: Pluribus (10000 in chips)
Seat 2: Eddie (10000 in chips)
Seat 3: MrBrown (10000 in chips)
Seat 4: MrBlue (10000 in chips)
Seat 5: Bill (10000 in chips)
Seat 6: MrPink (10000 in chips)
Pluribus: posts small blind 50
Eddie: posts big blind 100
*** HOLE CARDS ***
Dealt to Pluribus [3c 7d]
Dealt to Eddie [4d Ks]
Dealt to MrBrown [Qc 9s]
Dealt to MrBlue [2c Jh]
Dealt to Bill [6c 6d]
Dealt to MrPink [Tc 8h]
MrBrown: folds
MrBlue: folds
Bill: raises 125 to 225
MrPink: folds
Pluribus: folds
Eddie: folds
Uncalled bet (125) returned to Bill
Bill collected 250.0 from pot
*** SUMMARY ***
Total pot 250 | Rake 0


PokerStars Hand #43078: Hold'em No Limit (50/100) - 2019/07/11 11:57:58 ET
Table 'Pluribus Session 43' 6-max (Play Money) Seat #6 is the button
Seat 1: Eddie (10000 in chips)
Seat 2: MrBrown (10000 in chips)
Seat 3: MrBlue (10000 in chips)
Seat 4: Bill (10000 in chips)
Seat 5: MrPink (10000 in chips)
Seat 6: Pluribus (10000 in chips)
Eddie: posts small blind 50
MrBrown: posts big blind 100
*** HOLE CARDS ***
Dealt to Eddie [2d 7s]
Dealt to MrBrown [As 8h]
Dealt to MrBlue [Kh Ac]
Dealt to Bill [6h 6c]
Dealt to MrPink [8d 8s]
Dealt to Pluribus [9s Jh]
MrBlue: raises 125 to 225
Bill: folds
MrPink: raises 475 to 700
Pluribus: folds
Eddie: folds
MrBrown: folds
MrBlue: raises 2085 to 2785
MrPink: folds
Uncalled bet (2085) returned to MrBlue
MrBlue collected 1550.0 from pot
*** SUMMARY ***
Total pot 1550 | Rake 0


PokerStars Hand #43079: Hold'em No Limit (50/100) - 2019/07/11 11:57:59 ET
Table 'Pluribus Session 43' 6-max (Play Money) Seat #6 is the button
Seat 1: MrBrown (10000 in chips)
Seat 2: MrBlue (10000 in chips)
Seat 3: Bill (10000 in chips)
Seat 4: MrPink (10000 in chips)
Seat 5: Pluribus (10000 in chips)
Seat 6: Eddie (10000 in chips)
MrBrown: posts small blind 50
MrBlue: posts big blind 100
*** HOLE CARDS ***
Dealt to MrBrown [8c 4c]
Dealt to MrBlue [5h 6s]
Dealt to Bill [Js Jh]
Dealt to MrPink [3h 8s]
Dealt to Pluribus [7s Jc]
Dealt to Eddie [7h 3d]
Bill: raises 125 to 225
MrPink: folds
Pluribus: folds
Eddie: folds
MrBrown: folds
MrBlue: calls 125
*** FLOP *** [4s 7d 2s]
MrBlue: checks
Bill: bets 375
MrBlue: raises 937 to 1312
Bill: calls 937
*** TURN *** [4s 7d 2s] [8d]
MrBlue: bets 2415
Bill: folds
Uncalled bet (2415) returned to MrBlue
MrBlue collected 3124.0 from pot
*** SUMMARY ***
Total pot 3124 | Rake 0
Board [4s 7d 2s 8d]


PokerStars Hand #43080: Hold'em No Limit (50/100) - 2019/07/11 11:58:00 ET
Table 'Pluribus Session 43' 6-max (Play Money) Seat #6 is the button
Seat 1: MrBlue (10000 in chips)
Seat 2: Bill (10000 in chips)
Seat 3: MrPink (10000 in chips)
Seat 4: Pluribus (10000 in chips)
Seat 5: Eddie (10000 in chips)
Seat 6: MrBrown (10000 in chips)
MrBlue: posts small blind 50
Bill: posts big blind 100
*** HOLE CARDS ***
Dealt to MrBlue [Ac Qh]
Dealt to Bill [9h Jc]
Dealt to MrPink [8s 9s]
Dealt to Pluribus [6d Ah]
Dealt to Eddie [Qs Tc]
Dealt to MrBrown [Ts Td]
MrPink: raises 110 to 210
Pluribus: folds
Eddie: folds
MrBrown: calls 210
MrBlue: calls 160
Bill: folds
*** FLOP *** [5d Jh 4h]
MrBlue: checks
MrPink: checks
MrBrown: checks
*** TURN *** [5d Jh 4h] [7c]
MrBlue: checks
MrPink: bets 365
MrBrown: calls 365
MrBlue: folds
*** RIVER *** [5d Jh 4h] [7c] [5h]
MrPink: checks
MrBrown: checks
*** SHOWDOWN ***
MrBrown: shows [Ts Td]
MrBrown collected 1460.0 from pot
*** SUMMARY ***
Total pot 1460 | Rake 0
Board [5d Jh 4h 7c 5h]
Seat 3: MrPink showed [8s 9s] and lost
Seat 6: MrBrown showed [Ts Td] and won (1460.0)


PokerStars Hand #43081: Hold'em No Limit (50/100) - 2019/07/11 11:58:01 ET
Table 'Pluribus Session 43' 6-max (Play Money) Seat #6 is the button
Seat 1: Bill (10000 in chips)
Seat 2: MrPink (10000 in chips)
Seat 3: Pluribus (10000 in chips)
Seat 4: Eddie (10000 in chips)
Seat 5: MrBrown (10000 in chips)
Seat 6: MrBlue (10000 in chips)
Bill: posts small blind 50
MrPink: posts big blind 100
*** HOLE CARDS ***
Dealt to Bill [Qc Kc]
Dealt to MrPink [5c 6c]
Dealt to Pluribus [Ks 7d]
Dealt to Eddie [Td 8s]
Dealt to MrBrown [3c Tc]
Dealt to MrBlue [9d Qh]
Pluribus: folds
Eddie: folds
MrBrown: folds
MrBlue: raises 125 to 225
Bill: raises 725 to 950
MrPink: folds
MrBlue: folds
Uncalled bet (725) returned to Bill
Bill collected 550.0 from pot
*** SUMMARY ***
Total pot 550 | Rake 0


PokerStars Hand #43082: Hold'em No Limit (50/100) - 2019/07/11 11:58:02 ET
Table 'Pluribus Session 43' 6-max (Play Money) Seat #6 is the button
Seat 1: MrPink (10000 in chips)
Seat 2: Pluribus (10000 in chips)
Seat 3: Eddie (10000 in chips)
Seat 4: MrBrown (10000 in chips)
Seat 5: MrBlue (10000 in chips)
Seat 6: Bill (10000 in chips)
MrPink: posts small blind 50
Pluribus: posts big blind 100
*** HOLE CARDS ***
Dealt to MrPink [4h 4d]
Dealt to Pluribus [3d 9d]
Dealt to Eddie [8h As]
Dealt to MrBrown [9s Js]
Dealt to MrBlue [6s 2s]
Dealt to Bill [Jh Ks]
Eddie: folds
MrBrown: raises 125 to 225
MrBlue: folds
Bill: folds
MrPink: folds
Pluribus: folds
Uncalled bet (125) returned to MrBrown
MrBrown collected 250.0 from pot
*** SUMMARY ***
Total pot 250 | Rake 0


PokerStars Hand #43083: Hold'em No Limit (50/100) - 2019/07/11 11:58:03 ET
Table 'Pluribus Session 43' 6-max (Play Money) Seat #6 is the button
Seat 1: Pluribus (10000 in chips)
Seat 2: Eddie (10000 in chips)
Seat 3: MrBrown (10000 in chips)
Seat 4: MrBlue (10000 in chips)
Seat 5: Bill (10000 in chips)
Seat 6: MrPink (10000 in chips)
Pluribus: posts small blind 50
Eddie: posts big blind 100
*** HOLE CARDS ***
Dealt to Pluribus [5h 8d]
Dealt to Eddie [Qh 5c]
Dealt to MrBrown [Kh Ks]
Dealt to MrBlue [Ad 5s]
Dealt to Bill [9d 6s]
Dealt to MrPink [7c Qc]
MrBrown: raises 125 to 225
MrBlue: folds
Bill: folds
MrPink: folds
Pluribus: folds
Eddie: folds
Uncalled bet (125) returned to MrBrown
MrBrown collected 250.0 from pot
*** SUMMARY ***
Total pot 250 | Rake 0


PokerStars Hand #43084: Hold'em No Limit (50/100) - 2019/07/11 11:58:04 ET
Table 'Pluribus Session 43' 6-max (Play Money) Seat #6 is the button
Seat 1: Eddie (10000 in chips)
Seat 2: MrBrown (10000 in chips)
Seat 3: MrBlue (10000 in chips)
Seat 4: Bill (10000 in chips)
Seat 5: MrPink (10000 in chips)
Seat 6: Pluribus (10000 in chips)
Eddie: posts small blind 50
MrBrown: posts big blind 100
*** HOLE CARDS ***
Dealt to Eddie [4h 8s]
Dealt to MrBrown [2h 5d]
Dealt to MrBlue [7s Tc]
Dealt to Bill [Kc 9h]
Dealt to MrPink [4s 4c]
Dealt to Pluribus [6h Td]
MrBlue: folds
Bill: folds
MrPink: raises 110 to 210
Pluribus: folds
Eddie: folds
MrBrown: folds
Uncalled bet (110) returned to MrPink
MrPink collected 250.0 from pot
*** SUMMARY ***
Total pot 250 | Rake 0


PokerStars Hand #43085: Hold'em No Limit (50/100) - 2019/07/11 11:58:05 ET
Table 'Pluribus Session 43' 6-max (Play Money) Seat #6 is the button
Seat 1: MrBrown (10000 in chips)
Seat 2: MrBlue (10000 in chips)
Seat 3: Bill (10000 in chips)
Seat 4: MrPink (10000 in chips)
Seat 5: Pluribus (10000 in chips)
Seat 6: Eddie (10000 in chips)
MrBrown: posts small blind 50
MrBlue: posts big blind 100
*** HOLE CARDS ***
Dealt to MrBrown [As 2h]
Dealt to MrBlue [6h Ac]
Dealt to Bill [Qs 9h]
Dealt to MrPink [8c 3s]
Dealt to Pluribus [9c 5h]
Dealt to Eddie [Qd 7d]
Bill: folds
MrPink: folds
Pluribus: folds
Eddie: raises 122 to 222
MrBrown: folds
MrBlue: calls 122
*** FLOP *** [5s 4h Jd]
MrBlue: checks
Eddie: bets 150
MrBlue: folds
Uncalled bet (150) returned to Eddie
Eddie collected 494.0 from pot
*** SUMMARY ***
Total pot 494 | Rake 0
Board [5s 4h Jd]


PokerStars Hand #43086: Hold'em No Limit (50/100) - 2019/07/11 11:58:06 ET
Table 'Pluribus Session 43' 6-max (Play Money) Seat #6 is the button
Seat 1: MrBlue (10000 in chips)
Seat 2: Bill (10000 in chips)
Seat 3: MrPink (10000 in chips)
Seat 4: Pluribus (10000 in chips)
Seat 5: Eddie (10000 in chips)
Seat 6: MrBrown (10000 in chips)
MrBlue: posts small blind 50
Bill: posts big blind 100
*** HOLE CARDS ***
Dealt to MrBlue [4c Td]
Dealt to Bill [4h 5c]
Dealt to MrPink [Jh 4d]
Dealt to Pluribus [3c Js]
Dealt to Eddie [6s 9s]
Dealt to MrBrown [6c Qs]
MrPink: folds
Pluribus: folds
Eddie: folds
MrBrown: folds
MrBlue: folds
Uncalled bet (50) returned to Bill
Bill collected 100.0 from pot
*** SUMMARY ***
Total pot 100 | Rake 0


PokerStars Hand #43087: Hold'em No Limit (50/100) - 2019/07/11 11:58:07 ET
Table 'Pluribus Session 43' 6-max (Play Money) Seat #6 is the button
Seat 1: Bill (10000 in chips)
Seat 2: MrPink (10000 in chips)
Seat 3: Pluribus (10000 in chips)
Seat 4: Eddie (10000 in chips)
Seat 5: MrBrown (10000 in chips)
Seat 6: MrBlue (10000 in chips)
Bill: posts small blind 50
MrPink: posts big blind 100
*** HOLE CARDS ***
Dealt to Bill [Ad As]
Dealt to MrPink [6s Kc]
Dealt to Pluribus [6h Qh]
Dealt to Eddie [6d Ks]
Dealt to MrBrown [4h 3c]
Dealt to MrBlue [3s 2h]
Pluribus: folds
Eddie: folds
MrBrown: folds
MrBlue: folds
Bill: raises 200 to 300
MrPink: raises 600 to 900
Bill: raises 1475 to 2375
MrPink: folds
Uncalled bet (1475) returned to Bill
Bill collected 1800.0 from pot
*** SUMMARY ***
Total pot 1800 | Rake 0


PokerStars Hand #43088: Hold'em No Limit (50/100) - 2019/07/11 11:58:08 ET
Table 'Pluribus Session 43' 6-max (Play Money) Seat #6 is the button
Seat 1: MrPink (10000 in chips)
Seat 2: Pluribus (10000 in chips)
Seat 3: Eddie (10000 in chips)
Seat 4: MrBrown (10000 in chips)
Seat 5: MrBlue (10000 in chips)
Seat 6: Bill (10000 in chips)
MrPink: posts small blind 50
Pluribus: posts big blind 100
*** HOLE CARDS ***
Dealt to MrPink [7h 5h]
Dealt to Pluribus [Ks 2h]
Dealt to Eddie [9c Kc]
Dealt to MrBrown [2c 8s]
Dealt to MrBlue [8h Th]
Dealt to Bill [6s Qc]
Eddie: raises 100 to 200
MrBrown: folds
MrBlue: folds
Bill: folds
MrPink: folds
Pluribus: folds
Uncalled bet (100) returned to Eddie
Eddie collected 250.0 from pot
*** SUMMARY ***
Total pot 250 | Rake 0


PokerStars Hand #43089: Hold'em No Limit (50/100) - 2019/07/11 11:58:09 ET
Table 'Pluribus Session 43' 6-max (Play Money) Seat #6 is the button
Seat 1: Pluribus (10000 in chips)
Seat 2: Eddie (10000 in chips)
Seat 3: MrBrown (10000 in chips)
Seat 4: MrBlue (10000 in chips)
Seat 5: Bill (10000 in chips)
Seat 6: MrPink (10000 in chips)
Pluribus: posts small blind 50
Eddie: posts big blind 100
*** HOLE CARDS ***
Dealt to Pluribus [3d 6d]
Dealt to Eddie [Ac 7d]
Dealt to MrBrown [4s 4h]
Dealt to MrBlue [Ts 3s]
Dealt to Bill [As 5d]
Dealt to MrPink [Kc 7s]
MrBrown: folds
MrBlue: folds
Bill: folds
MrPink: folds
Pluribus: raises 150 to 250
Eddie: raises 550 to 800
Pluribus: folds
Uncalled bet (550) returned to Eddie
Eddie collected 500.0 from pot
*** SUMMARY ***
Total pot 500 | Rake 0


PokerStars Hand #43090: Hold'em No Limit (50/100) - 2019/07/11 11:58:10 ET
Table 'Pluribus Session 43' 6-max (Play Money) Seat #6 is the button
Seat 1: Eddie (10000 in chips)
Seat 2: MrBrown (10000 in chips)
Seat 3: MrBlue (10000 in chips)
Seat 4: Bill (10000 in chips)
Seat 5: MrPink (10000 in chips)
Seat 6: Pluribus (10000 in chips)
Eddie: posts small blind 50
MrBrown: posts big blind 100
*** HOLE CARDS ***
Dealt to Eddie [Tc Jd]
Dealt to MrBrown [6h Qc]
Dealt to MrBlue [Jc 3c]
Dealt to Bill [8s 5c]
Dealt to MrPink [Td 8c]
Dealt to Pluribus [Ks 7s]
MrBlue: folds
Bill: folds
MrPink: folds
Pluribus: raises 150 to 250
Eddie: folds
MrBrown: folds
Uncalled bet (150) returned to Pluribus
Pluribus collected 250.0 from pot
*** SUMMARY ***
Total pot 250 | Rake 0


PokerStars Hand #43091: Hold'em No Limit (50/100) - 2019/07/11 11:58:11 ET
Table 'Pluribus Session 43' 6-max (Play Money) Seat #6 is the button
Seat 1: MrBrown (10000 in chips)
Seat 2: MrBlue (10000 in chips)
Seat 3: Bill (10000 in chips)
Seat 4: MrPink (10000 in chips)
Seat 5: Pluribus (10000 in chips)
Seat 6: Eddie (10000 in chips)
MrBrown: posts small blind 50
MrBlue: posts big blind 100
*** HOLE CARDS ***
Dealt to MrBrown [Jc 8c]
Dealt to MrBlue [Qc 7s]
Dealt to Bill [2d 3h]
Dealt to MrPink [2h Kd]
Dealt to Pluribus [Qh 9c]
Dealt to Eddie [2c Kh]
Bill: folds
MrPink: folds
Pluribus: folds
Eddie: folds
MrBrown: raises 200 to 300
MrBlue: calls 200
*** FLOP *** [5c Th 6s]
MrBrown: bets 400
MrBlue: folds
Uncalled bet (400) returned to MrBrown
MrBrown collected 600.0 from pot
*** SUMMARY ***
Total pot 600 | Rake 0
Board [5c Th 6s]


PokerStars Hand #43092: Hold'em No Limit (50/100) - 2019/07/11 11:58:12 ET
Table 'Pluribus Session 43' 6-max (Play Money) Seat #6 is the button
Seat 1: MrBlue (10000 in chips)
Seat 2: Bill (10000 in chips)
Seat 3: MrPink (10000 in chips)
Seat 4: Pluribus (10000 in chips)
Seat 5: Eddie (10000 in chips)
Seat 6: MrBrown (10000 in chips)
MrBlue: posts small blind 50
Bill: posts big blind 100
*** HOLE CARDS ***
Dealt to MrBlue [Js Ts]
Dealt to Bill [Tc 7s]
Dealt to MrPink [Th 2s]
Dealt to Pluribus [Ah 2h]
Dealt to Eddie [3h 9c]
Dealt to MrBrown [2c 6s]
MrPink: folds
Pluribus: raises 125 to 225
Eddie: folds
MrBrown: folds
MrBlue: calls 175
Bill: folds
*** FLOP *** [8s 4c 9d]
MrBlue: checks
Pluribus: bets 550
MrBlue: calls 550
*** TURN *** [8s 4c 9d] [Qs]
MrBlue: checks
Pluribus: checks
*** RIVER *** [8s 4c 9d] [Qs] [2d]
MrBlue: checks
Pluribus: checks
*** SHOWDOWN ***
MrBlue: shows [Js Ts]
MrBlue collected 1650.0 from pot
*** SUMMARY ***
Total pot 1650 | Rake 0
Board [8s 4c 9d Qs 2d]
Seat 1: MrBlue showed [Js Ts] and won (1650.0)
Seat 4: Pluribus showed [Ah 2h] and lost


PokerStars Hand #43093: Hold'em No Limit (50/100) - 2019/07/11 11:58:13 ET
Table 'Pluribus Session 43' 6-max (Play Money) Seat #6 is the button
Seat 1: Bill (10000 in chips)
Seat 2: MrPink (10000 in chips)
Seat 3: Pluribus (10000 in chips)
Seat 4: Eddie (10000 in chips)
Seat 5: MrBrown (10000 in chips)
Seat 6: MrBlue (10000 in chips)
Bill: posts small blind 50
MrPink: posts big blind 100
*** HOLE CARDS ***
Dealt to Bill [4d 5s]
Dealt to MrPink [6h Ah]
Dealt to Pluribus [Jh 8d]
Dealt to Eddie [As 7c]
Dealt to MrBrown [6c Jd]
Dealt to MrBlue [7s Qs]
Pluribus: folds
Eddie: folds
MrBrown: folds
MrBlue: raises 125 to 225
Bill: folds
MrPink: calls 125
*** FLOP *** [2c 4s 8s]
MrPink: checks
MrBlue: checks
*** TURN *** [2c 4s 8s] [Qd]
MrPink: checks
MrBlue: bets 375
MrPink: folds
Uncalled bet (375) returned to MrBlue
MrBlue collected 500.0 from pot
*** SUMMARY ***
Total pot 500 | Rake 0
Board [2c 4s 8s Qd]


PokerStars Hand #43094: Hold'em No Limit (50/100) - 2019/07/11 11:58:14 ET
Table 'Pluribus Session 43' 6-max (Play Money) Seat #6 is the button
Seat 1: MrPink (10000 in chips)
Seat 2: Pluribus (10000 in chips)
Seat 3: Eddie (10000 in chips)
Seat 4: MrBrown (10000 in chips)
Seat 5: MrBlue (10000 in chips)
Seat 6: Bill (10000 in chips)
MrPink: posts small blind 50
Pluribus: posts big blind 100
*** HOLE CARDS ***
Dealt to MrPink [4h Tc]
Dealt to Pluribus [5s Ah]
Dealt to Eddie [9s 5h]
Dealt to MrBrown [Jd Qc]
Dealt to MrBlue [Kh Jc]
Dealt to Bill [7c 6c]
Eddie: folds
MrBrown: folds
MrBlue: raises 125 to 225
Bill: raises 575 to 800
MrPink: folds
Pluribus: folds
MrBlue: folds
Uncalled bet (575) returned to Bill
Bill collected 600.0 from pot
*** SUMMARY ***
Total pot 600 | Rake 0


PokerStars Hand #43095: Hold'em No Limit (50/100) - 2019/07/11 11:58:15 ET
Table 'Pluribus Session 43' 6-max (Play Money) Seat #6 is the button
Seat 1: Pluribus (10000 in chips)
Seat 2: Eddie (10000 in chips)
Seat 3: MrBrown (10000 in chips)
Seat 4: MrBlue (10000 in chips)
Seat 5: Bill (10000 in chips)
Seat 6: MrPink (10000 in chips)
Pluribus: posts small blind 50
Eddie: posts big blind 100
*** HOLE CARDS ***
Dealt to Pluribus [7s 3c]
Dealt to Eddie [Kd 9s]
Dealt to MrBrown [4d 9h]
Dealt to MrBlue [7d Tc]
Dealt to Bill [Ks 4c]
Dealt to MrPink [7c Qd]
MrBrown: folds
MrBlue: folds
Bill: folds
MrPink: folds
Pluribus: folds
Uncalled bet (50) returned to Eddie
Eddie collected 100.0 from pot
*** SUMMARY ***
Total pot 100 | Rake 0


PokerStars Hand #43096: Hold'em No Limit (50/100) - 2019/07/11 11:58:16 ET
Table 'Pluribus Session 43' 6-max (Play Money) Seat #6 is the button
Seat 1: Eddie (10000 in chips)
Seat 2: MrBrown (10000 in chips)
Seat 3: MrBlue (10000 in chips)
Seat 4: Bill (10000 in chips)
Seat 5: MrPink (10000 in chips)
Seat 6: Pluribus (10000 in chips)
Eddie: posts small blind 50
MrBrown: posts big blind 100
*** HOLE CARDS ***
Dealt to Eddie [7h Tc]
Dealt to MrBrown [9c 6s]
Dealt to MrBlue [7d Qd]
Dealt to Bill [3d 9h]
Dealt to MrPink [4h Jh]
Dealt to Pluribus [Jc 5c]
MrBlue: folds
Bill: folds
MrPink: folds
Pluribus: raises 150 to 250
Eddie: folds
MrBrown: folds
Uncalled bet (150) returned to Pluribus
Pluribus collected 250.0 from pot
*** SUMMARY ***
Total pot 250 | Rake 0


PokerStars Hand #43097: Hold'em No Limit (50/100) - 2019/07/11 11:58:17 ET
Table 'Pluribus Session 43' 6-max (Play Money) Seat #6 is the button
Seat 1: MrBrown (10000 in chips)
Seat 2: MrBlue (10000 in chips)
Seat 3: Bill (10000 in chips)
Seat 4: MrPink (10000 in chips)
Seat 5: Pluribus (10000 in chips)
Seat 6: Eddie (10000 in chips)
MrBrown: posts small blind 50
MrBlue: posts big blind 100
*** HOLE CARDS ***
Dealt to MrBrown [8d As]
Dealt to MrBlue [5s 6s]
Dealt to Bill [4d Js]
Dealt to MrPink [4s 2s]
Dealt to Pluribus [5h 6d]
Dealt to Eddie [9c Kc]
Bill: folds
MrPink: folds
Pluribus: folds
Eddie: raises 122 to 222
MrBrown: folds
MrBlue: raises 839 to 1061
Eddie: calls 839
*** FLOP *** [Qd 9s 2c]
MrBlue: bets 800
Eddie: calls 800
*** TURN *** [Qd 9s 2c] [Jh]
MrBlue: checks
Eddie: checks
*** RIVER *** [Qd 9s 2c] [Jh] [Qh]
MrBlue: checks
Eddie: checks
*** SHOWDOWN ***
Eddie: shows [9c Kc]
Eddie collected 3772.0 from pot
*** SUMMARY ***
Total pot 3772 | Rake 0
Board [Qd 9s 2c Jh Qh]
Seat 2: MrBlue showed [5s 6s] and lost
Seat 6: Eddie showed [9c Kc] and won (3772.0)


PokerStars Hand #43098: Hold'em No Limit (50/100) - 2019/07/11 11:58:18 ET
Table 'Pluribus Session 43' 6-max (Play Money) Seat #6 is the button
Seat 1: MrBlue (10000 in chips)
Seat 2: Bill (10000 in chips)
Seat 3: MrPink (10000 in chips)
Seat 4: Pluribus (10000 in chips)
Seat 5: Eddie (10000 in chips)
Seat 6: MrBrown (10000 in chips)
MrBlue: posts small blind 50
Bill: posts big blind 100
*** HOLE CARDS ***
Dealt to MrBlue [Jd 3d]
Dealt to Bill [Qd 5h]
Dealt to MrPink [Th As]
Dealt to Pluribus [Ad Qs]
Dealt to Eddie [Js 5s]
Dealt to MrBrown [3h 6d]
MrPink: raises 110 to 210
Pluribus: raises 471 to 681
Eddie: folds
MrBrown: folds
MrBlue: folds
Bill: folds
MrPink: folds
Uncalled bet (471) returned to Pluribus
Pluribus collected 570.0 from pot
*** SUMMARY ***
Total pot 570 | Rake 0


PokerStars Hand #43099: Hold'em No Limit (50/100) - 2019/07/11 11:58:19 ET
Table 'Pluribus Session 43' 6-max (Play Money) Seat #6 is the button
Seat 1: Bill (10000 in chips)
Seat 2: MrPink (10000 in chips)
Seat 3: Pluribus (10000 in chips)
Seat 4: Eddie (10000 in chips)
Seat 5: MrBrown (10000 in chips)
Seat 6: MrBlue (10000 in chips)
Bill: posts small blind 50
MrPink: posts big blind 100
*** HOLE CARDS ***
Dealt to Bill [5h 3c]
Dealt to MrPink [3h Jh]
Dealt to Pluribus [Qc Qh]
Dealt to Eddie [Th Kd]
Dealt to MrBrown [6h 8d]
Dealt to MrBlue [3d 5c]
Pluribus: raises 150 to 250
Eddie: folds
MrBrown: folds
MrBlue: folds
Bill: folds
MrPink: calls 150
*** FLOP *** [Js 8c 7c]
MrPink: checks
Pluribus: bets 275
MrPink: calls 275
*** TURN *** [Js 8c 7c] [8h]
MrPink: bets 275
Pluribus: calls 275
*** RIVER *** [Js 8c 7c] [8h] [Jd]
MrPink: bets 1100
Pluribus: calls 1100
*** SHOWDOWN ***
MrPink: shows [3h Jh]
MrPink collected 3850.0 from pot
*** SUMMARY ***
Total pot 3850 | Rake 0
Board [Js 8c 7c 8h Jd]
Seat 2: MrPink showed [3h Jh] and won (3850.0)
Seat 3: Pluribus showed [Qc Qh] and lost


PokerStars Hand #43100: Hold'em No Limit (50/100) - 2019/07/11 11:58:20 ET
Table 'Pluribus Session 43' 6-max (Play Money) Seat #6 is the button
Seat 1: MrPink (10000 in chips)
Seat 2: Pluribus (10000 in chips)
Seat 3: Eddie (10000 in chips)
Seat 4: MrBrown (10000 in chips)
Seat 5: MrBlue (10000 in chips)
Seat 6: Bill (10000 in chips)
MrPink: posts small blind 50
Pluribus: posts big blind 100
*** HOLE CARDS ***
Dealt to MrPink [2d 7d]
Dealt to Pluribus [2h Qd]
Dealt to Eddie [Js Qs]
Dealt to MrBrown [Qc 2s]
Dealt to MrBlue [4c 3s]
Dealt to Bill [5s 9c]
Eddie: raises 100 to 200
MrBrown: folds
MrBlue: folds
Bill: folds
MrPink: folds
Pluribus: folds
Uncalled bet (100) returned to Eddie
Eddie collected 250.0 from pot
*** SUMMARY ***
Total pot 250 | Rake 0


PokerStars Hand #43101: Hold'em No Limit (50/100) - 2019/07/11 11:58:21 ET
Table 'Pluribus Session 43' 6-max (Play Money) Seat #6 is the button
Seat 1: Pluribus (10000 in chips)
Seat 2: Eddie (10000 in chips)
Seat 3: MrBrown (10000 in chips)
Seat 4: MrBlue (10000 in chips)
Seat 5: Bill (10000 in chips)
Seat 6: MrPink (10000 in chips)
Pluribus: posts small blind 50
Eddie: posts big blind 100
*** HOLE CARDS ***
Dealt to Pluribus [5h Ac]
Dealt to Eddie [2h Ts]
Dealt to MrBrown [As 5c]
Dealt to MrBlue [Qs 8s]
Dealt to Bill [6c 4h]
Dealt to MrPink [7c Ad]
MrBrown: folds
MrBlue: folds
Bill: folds
MrPink: raises 150 to 250
Pluribus: folds
Eddie: folds
Uncalled bet (150) returned to MrPink
MrPink collected 250.0 from pot
*** SUMMARY ***
Total pot 250 | Rake 0


PokerStars Hand #43102: Hold'em No Limit (50/100) - 2019/07/11 11:58:22 ET
Table 'Pluribus Session 43' 6-max (Play Money) Seat #6 is the button
Seat 1: Eddie (10000 in chips)
Seat 2: MrBrown (10000 in chips)
Seat 3: MrBlue (10000 in chips)
Seat 4: Bill (10000 in chips)
Seat 5: MrPink (10000 in chips)
Seat 6: Pluribus (10000 in chips)
Eddie: posts small blind 50
MrBrown: posts big blind 100
*** HOLE CARDS ***
Dealt to Eddie [Kc 2h]
Dealt to MrBrown [9d 2s]
Dealt to MrBlue [Qh Kd]
Dealt to Bill [4c Th]
Dealt to MrPink [3d 2d]
Dealt to Pluribus [9s 6c]
MrBlue: raises 125 to 225
Bill: folds
MrPink: folds
Pluribus: folds
Eddie: folds
MrBrown: folds
Uncalled bet (125) returned to MrBlue
MrBlue collected 250.0 from pot
*** SUMMARY ***
Total pot 250 | Rake 0


PokerStars Hand #43103: Hold'em No Limit (50/100) - 2019/07/11 11:58:23 ET
Table 'Pluribus Session 43' 6-max (Play Money) Seat #6 is the button
Seat 1: MrBrown (10000 in chips)
Seat 2: MrBlue (10000 in chips)
Seat 3: Bill (10000 in chips)
Seat 4: MrPink (10000 in chips)
Seat 5: Pluribus (10000 in chips)
Seat 6: Eddie (10000 in chips)
MrBrown: posts small blind 50
MrBlue: posts big blind 100
*** HOLE CARDS ***
Dealt to MrBrown [5c 5d]
Dealt to MrBlue [7h 6s]
Dealt to Bill [9c Qc]
Dealt to MrPink [Ad 3h]
Dealt to Pluribus [Qd 5h]
Dealt to Eddie [Th 4c]
Bill: raises 125 to 225
MrPink: folds
Pluribus: folds
Eddie: folds
MrBrown: folds
MrBlue: calls 125
*** FLOP *** [3s Ks Jc]
MrBlue: checks
Bill: bets 150
MrBlue: folds
Uncalled bet (150) returned to Bill
Bill collected 500.0 from pot
*** SUMMARY ***
Total pot 500 | Rake 0
Board [3s Ks Jc]


PokerStars Hand #43104: Hold'em No Limit (50/100) - 2019/07/11 11:58:24 ET
Table 'Pluribus Session 43' 6-max (Play Money) Seat #6 is the button
Seat 1: MrBlue (10000 in chips)
Seat 2: Bill (10000 in chips)
Seat 3: MrPink (10000 in chips)
Seat 4: Pluribus (10000 in chips)
Seat 5: Eddie (10000 in chips)
Seat 6: MrBrown (10000 in chips)
MrBlue: posts small blind 50
Bill: posts big blind 100
*** HOLE CARDS ***
Dealt to MrBlue [4s 5h]
Dealt to Bill [Ad 3s]
Dealt to MrPink [6c 7s]
Dealt to Pluribus [8c Jh]
Dealt to Eddie [9s 9c]
Dealt to MrBrown [Ks Ah]
MrPink: folds
Pluribus: folds
Eddie: raises 100 to 200
MrBrown: raises 450 to 650
MrBlue: folds
Bill: folds
Eddie: calls 450
*** FLOP *** [6h 9d Td]
Eddie: checks
MrBrown: checks
*** TURN *** [6h 9d Td] [As]
Eddie: checks
MrBrown: bets 725
Eddie: raises 1775 to 2500
MrBrown: calls 1775
*** RIVER *** [6h 9d Td] [As] [Ts]
Eddie: bets 6850 and is all-in
MrBrown: calls 6850 and is all-in
*** SHOWDOWN ***
Eddie: shows [9s 9c]
Eddie collected 20150.0 from pot
*** SUMMARY ***
Total pot 20150 | Rake 0
Board [6h 9d Td As Ts]
Seat 5: Eddie showed [9s 9c] and won (20150.0)
Seat 6: MrBrown showed [Ks Ah] and lost


PokerStars Hand #43105: Hold'em No Limit (50/100) - 2019/07/11 11:58:25 ET
Table 'Pluribus Session 43' 6-max (Play Money) Seat #6 is the button
Seat 1: Bill (10000 in chips)
Seat 2: MrPink (10000 in chips)
Seat 3: Pluribus (10000 in chips)
Seat 4: Eddie (10000 in chips)
Seat 5: MrBrown (10000 in chips)
Seat 6: MrBlue (10000 in chips)
Bill: posts small blind 50
MrPink: posts big blind 100
*** HOLE CARDS ***
Dealt to Bill [9h Ac]
Dealt to MrPink [6s Kc]
Dealt to Pluribus [7h 6c]
Dealt to Eddie [Qc 9d]
Dealt to MrBrown [7s Th]
Dealt to MrBlue [Ad 4s]
Pluribus: folds
Eddie: folds
MrBrown: folds
MrBlue: raises 125 to 225
Bill: folds
MrPink: calls 125
*** FLOP *** [6h 5d Kd]
MrPink: checks
MrBlue: bets 250
MrPink: raises 1000 to 1250
MrBlue: folds
Uncalled bet (1000) returned to MrPink
MrPink collected 1000.0 from pot
*** SUMMARY ***
Total pot 1000 | Rake 0
Board [6h 5d Kd]


PokerStars Hand #43106: Hold'em No Limit (50/100) - 2019/07/11 11:58:26 ET
Table 'Pluribus Session 43' 6-max (Play Money) Seat #6 is the button
Seat 1: MrPink (10000 in chips)
Seat 2: Pluribus (10000 in chips)
Seat 3: Eddie (10000 in chips)
Seat 4: MrBrown (10000 in chips)
Seat 5: MrBlue (10000 in chips)
Seat 6: Bill (10000 in chips)
MrPink: posts small blind 50
Pluribus: posts big blind 100
*** HOLE CARDS ***
Dealt to MrPink [Kh 5s]
Dealt to Pluribus [3c 4h]
Dealt to Eddie [2s Ks]
Dealt to MrBrown [8d 7c]
Dealt to MrBlue [Td 6c]
Dealt to Bill [7s 3h]
Eddie: folds
MrBrown: folds
MrBlue: folds
Bill: folds
MrPink: calls 50
Pluribus: raises 250 to 350
MrPink: folds
Uncalled bet (250) returned to Pluribus
Pluribus collected 200.0 from pot
*** SUMMARY ***
Total pot 200 | Rake 0


PokerStars Hand #43107: Hold'em No Limit (50/100) - 2019/07/11 11:58:27 ET
Table 'Pluribus Session 43' 6-max (Play Money) Seat #6 is the button
Seat 1: Pluribus (10000 in chips)
Seat 2: Eddie (10000 in chips)
Seat 3: MrBrown (10000 in chips)
Seat 4: MrBlue (10000 in chips)
Seat 5: Bill (10000 in chips)
Seat 6: MrPink (10000 in chips)
Pluribus: posts small blind 50
Eddie: posts big blind 100
*** HOLE CARDS ***
Dealt to Pluribus [8h 2c]
Dealt to Eddie [6h 4d]
Dealt to MrBrown [7d Qc]
Dealt to MrBlue [4c 8c]
Dealt to Bill [Kd 5s]
Dealt to MrPink [2h Jc]
MrBrown: folds
MrBlue: folds
Bill: folds
MrPink: folds
Pluribus: folds
Uncalled bet (50) returned to Eddie
Eddie collected 100.0 from pot
*** SUMMARY ***
Total pot 100 | Rake 0


PokerStars Hand #43108: Hold'em No Limit (50/100) - 2019/07/11 11:58:28 ET
Table 'Pluribus Session 43' 6-max (Play Money) Seat #6 is the button
Seat 1: Eddie (10000 in chips)
Seat 2: MrBrown (10000 in chips)
Seat 3: MrBlue (10000 in chips)
Seat 4: Bill (10000 in chips)
Seat 5: MrPink (10000 in chips)
Seat 6: Pluribus (10000 in chips)
Eddie: posts small blind 50
MrBrown: posts big blind 100
*** HOLE CARDS ***
Dealt to Eddie [7h Qd]
Dealt to MrBrown [9c 4d]
Dealt to MrBlue [Ad 6h]
Dealt to Bill [Ah 6d]
Dealt to MrPink [9h Jc]
Dealt to Pluribus [Kd 5s]
MrBlue: folds
Bill: folds
MrPink: folds
Pluribus: folds
Eddie: calls 50
MrBrown: checks
*** FLOP *** [Ac Jh Ts]
Eddie: checks
MrBrown: checks
*** TURN *** [Ac Jh Ts] [Qs]
Eddie: checks
MrBrown: checks
*** RIVER *** [Ac Jh Ts] [Qs] [4c]
Eddie: bets 100
MrBrown: folds
Uncalled bet (100) returned to Eddie
Eddie collected 200.0 from pot
*** SUMMARY ***
Total pot 200 | Rake 0
Board [Ac Jh Ts Qs 4c]


PokerStars Hand #43109: Hold'em No Limit (50/100) - 2019/07/11 11:58:29 ET
Table 'Pluribus Session 43' 6-max (Play Money) Seat #6 is the button
Seat 1: MrBrown (10000 in chips)
Seat 2: MrBlue (10000 in chips)
Seat 3: Bill (10000 in chips)
Seat 4: MrPink (10000 in chips)
Seat 5: Pluribus (10000 in chips)
Seat 6: Eddie (10000 in chips)
MrBrown: posts small blind 50
MrBlue: posts big blind 100
*** HOLE CARDS ***
Dealt to MrBrown [7d 9h]
Dealt to MrBlue [Ah Js]
Dealt to Bill [3c 2h]
Dealt to MrPink [Qh As]
Dealt to Pluribus [4c 6h]
Dealt to Eddie [Jh 6s]
Bill: folds
MrPink: raises 110 to 210
Pluribus: folds
Eddie: folds
MrBrown: folds
MrBlue: calls 110
*** FLOP *** [Kh 8h 5s]
MrBlue: checks
MrPink: bets 470
MrBlue: folds
Uncalled bet (470) returned to MrPink
MrPink collected 470.0 from pot
*** SUMMARY ***
Total pot 470 | Rake 0
Board [Kh 8h 5s]


PokerStars Hand #43110: Hold'em No Limit (50/100) - 2019/07/11 11:58:30 ET
Table 'Pluribus Session 43' 6-max (Play Money) Seat #6 is the button
Seat 1: MrBlue (10000 in chips)
Seat 2: Bill (10000 in chips)
Seat 3: MrPink (10000 in chips)
Seat 4: Pluribus (10000 in chips)
Seat 5: Eddie (10000 in chips)
Seat 6: MrBrown (10000 in chips)
MrBlue: posts small blind 50
Bill: posts big blind 100
*** HOLE CARDS ***
Dealt to MrBlue [Js 6s]
Dealt to Bill [Td 7h]
Dealt to MrPink [3h 4h]
Dealt to Pluribus [Qd 2s]
Dealt to Eddie [8s 6d]
Dealt to MrBrown [Ac 5h]
MrPink: folds
Pluribus: folds
Eddie: folds
MrBrown: raises 150 to 250
MrBlue: folds
Bill: calls 150
*** FLOP *** [Qh 4d 4s]
Bill: checks
MrBrown: checks
*** TURN *** [Qh 4d 4s] [6h]
Bill: bets 275
MrBrown: folds
Uncalled bet (275) returned to Bill
Bill collected 550.0 from pot
*** SUMMARY ***
Total pot 550 | Rake 0
Board [Qh 4d 4s 6h]


PokerStars Hand #43111: Hold'em No Limit (50/100) - 2019/07/11 11:58:31 ET
Table 'Pluribus Session 43' 6-max (Play Money) Seat #6 is the button
Seat 1: Bill (10000 in chips)
Seat 2: MrPink (10000 in chips)
Seat 3: Pluribus (10000 in chips)
Seat 4: Eddie (10000 in chips)
Seat 5: MrBrown (10000 in chips)
Seat 6: MrBlue (10000 in chips)
Bill: posts small blind 50
MrPink: posts big blind 100
*** HOLE CARDS ***
Dealt to Bill [Kh 3d]
Dealt to MrPink [3s 9s]
Dealt to Pluribus [Td Qs]
Dealt to Eddie [8h 9h]
Dealt to MrBrown [Qh 2d]
Dealt to MrBlue [9c Ts]
Pluribus: folds
Eddie: raises 100 to 200
MrBrown: folds
MrBlue: folds
Bill: folds
MrPink: calls 100
*** FLOP *** [6d 4d Tc]
MrPink: checks
Eddie: checks
*** TURN *** [6d 4d Tc] [4s]
MrPink: checks
Eddie: checks
*** RIVER *** [6d 4d Tc] [4s] [8s]
MrPink: bets 350
Eddie: calls 350
*** SHOWDOWN ***
Eddie: shows [8h 9h]
Eddie collected 1150.0 from pot
*** SUMMARY ***
Total pot 1150 | Rake 0
Board [6d 4d Tc 4s 8s]
Seat 2: MrPink showed [3s 9s] and lost
Seat 4: Eddie showed [8h 9h] and won (1150.0)


PokerStars Hand #43112: Hold'em No Limit (50/100) - 2019/07/11 11:58:32 ET
Table 'Pluribus Session 43' 6-max (Play Money) Seat #6 is the button
Seat 1: MrPink (10000 in chips)
Seat 2: Pluribus (10000 in chips)
Seat 3: Eddie (10000 in chips)
Seat 4: MrBrown (10000 in chips)
Seat 5: MrBlue (10000 in chips)
Seat 6: Bill (10000 in chips)
MrPink: posts small blind 50
Pluribus: posts big blind 100
*** HOLE CARDS ***
Dealt to MrPink [4d Js]
Dealt to Pluribus [Ad 8s]
Dealt to Eddie [Kh 7s]
Dealt to MrBrown [Td 4s]
Dealt to MrBlue [2h 9c]
Dealt to Bill [8d 9h]
Eddie: folds
MrBrown: folds
MrBlue: folds
Bill: raises 150 to 250
MrPink: folds
Pluribus: calls 150
*** FLOP *** [3h 2d Qs]
Pluribus: checks
Bill: bets 275
Pluribus: folds
Uncalled bet (275) returned to Bill
Bill collected 550.0 from pot
*** SUMMARY ***
Total pot 550 | Rake 0
Board [3h 2d Qs]


PokerStars Hand #43113: Hold'em No Limit (50/100) - 2019/07/11 11:58:33 ET
Table 'Pluribus Session 43' 6-max (Play Money) Seat #6 is the button
Seat 1: Pluribus (10000 in chips)
Seat 2: Eddie (10000 in chips)
Seat 3: MrBrown (10000 in chips)
Seat 4: MrBlue (10000 in chips)
Seat 5: Bill (10000 in chips)
Seat 6: MrPink (10000 in chips)
Pluribus: posts small blind 50
Eddie: posts big blind 100
*** HOLE CARDS ***
Dealt to Pluribus [Ad 7s]
Dealt to Eddie [Th 5h]
Dealt to MrBrown [Ts Ks]
Dealt to MrBlue [Ah As]
Dealt to Bill [4h Qh]
Dealt to MrPink [3d 5s]
MrBrown: raises 125 to 225
MrBlue: raises 544 to 769
Bill: folds
MrPink: folds
Pluribus: folds
Eddie: folds
MrBrown: folds
Uncalled bet (544) returned to MrBlue
MrBlue collected 600.0 from pot
*** SUMMARY ***
Total pot 600 | Rake 0


PokerStars Hand #43114: Hold'em No Limit (50/100) - 2019/07/11 11:58:34 ET
Table 'Pluribus Session 43' 6-max (Play Money) Seat #6 is the button
Seat 1: Eddie (10000 in chips)
Seat 2: MrBrown (10000 in chips)
Seat 3: MrBlue (10000 in chips)
Seat 4: Bill (10000 in chips)
Seat 5: MrPink (10000 in chips)
Seat 6: Pluribus (10000 in chips)
Eddie: posts small blind 50
MrBrown: posts big blind 100
*** HOLE CARDS ***
Dealt to Eddie [7c 3h]
Dealt to MrBrown [2c Js]
Dealt to MrBlue [8d 6c]
Dealt to Bill [9c 9d]
Dealt to MrPink [2d 6s]
Dealt to Pluribus [6h Ah]
MrBlue: folds
Bill: raises 125 to 225
MrPink: folds
Pluribus: calls 225
Eddie: folds
MrBrown: folds
*** FLOP *** [Qs 4c 5s]
Bill: checks
Pluribus: bets 600
Bill: calls 600
*** TURN *** [Qs 4c 5s] [8h]
Bill: checks
Pluribus: bets 2700
Bill: folds
Uncalled bet (2700) returned to Pluribus
Pluribus collected 1800.0 from pot
*** SUMMARY ***
Total pot 1800 | Rake 0
Board [Qs 4c 5s 8h]


PokerStars Hand #43115: Hold'em No Limit (50/100) - 2019/07/11 11:58:35 ET
Table 'Pluribus Session 43' 6-max (Play Money) Seat #6 is the button
Seat 1: MrBrown (10000 in chips)
Seat 2: MrBlue (10000 in chips)
Seat 3: Bill (10000 in chips)
Seat 4: MrPink (10000 in chips)
Seat 5: Pluribus (10000 in chips)
Seat 6: Eddie (10000 in chips)
MrBrown: posts small blind 50
MrBlue: posts big blind 100
*** HOLE CARDS ***
Dealt to MrBrown [Jc Js]
Dealt to MrBlue [7c 8c]
Dealt to Bill [2c Kc]
Dealt to MrPink [4d 9s]
Dealt to Pluribus [3s 7s]
Dealt to Eddie [Ks 8h]
Bill: folds
MrPink: folds
Pluribus: folds
Eddie: raises 122 to 222
MrBrown: raises 528 to 750
MrBlue: calls 650
Eddie: folds
*** FLOP *** [Kd 8s Jd]
MrBrown: bets 861
MrBlue: calls 861
*** TURN *** [Kd 8s Jd] [Qh]
MrBrown: bets 1722
MrBlue: folds
Uncalled bet (1722) returned to MrBrown
MrBrown collected 3444.0 from pot
*** SUMMARY ***
Total pot 3444 | Rake 0
Board [Kd 8s Jd Qh]


PokerStars Hand #43116: Hold'em No Limit (50/100) - 2019/07/11 11:58:36 ET
Table 'Pluribus Session 43' 6-max (Play Money) Seat #6 is the button
Seat 1: MrBlue (10000 in chips)
Seat 2: Bill (10000 in chips)
Seat 3: MrPink (10000 in chips)
Seat 4: Pluribus (10000 in chips)
Seat 5: Eddie (10000 in chips)
Seat 6: MrBrown (10000 in chips)
MrBlue: posts small blind 50
Bill: posts big blind 100
*** HOLE CARDS ***
Dealt to MrBlue [2c Jd]
Dealt to Bill [Qs 2h]
Dealt to MrPink [7s 9s]
Dealt to Pluribus [Jh 5d]
Dealt to Eddie [Js 8s]
Dealt to MrBrown [Kc 7h]
MrPink: folds
Pluribus: folds
Eddie: raises 100 to 200
MrBrown: folds
MrBlue: folds
Bill: folds
Uncalled bet (100) returned to Eddie
Eddie collected 250.0 from pot
*** SUMMARY ***
Total pot 250 | Rake 0


PokerStars Hand #43117: Hold'em No Limit (50/100) - 2019/07/11 11:58:37 ET
Table 'Pluribus Session 43' 6-max (Play Money) Seat #6 is the button
Seat 1: Bill (10000 in chips)
Seat 2: MrPink (10000 in chips)
Seat 3: Pluribus (10000 in chips)
Seat 4: Eddie (10000 in chips)
Seat 5: MrBrown (10000 in chips)
Seat 6: MrBlue (10000 in chips)
Bill: posts small blind 50
MrPink: posts big blind 100
*** HOLE CARDS ***
Dealt to Bill [9d 8c]
Dealt to MrPink [Ts 6c]
Dealt to Pluribus [8s Tc]
Dealt to Eddie [5s 6d]
Dealt to MrBrown [5h 4c]
Dealt to MrBlue [9s Kc]
Pluribus: folds
Eddie: folds
MrBrown: folds
MrBlue: raises 125 to 225
Bill: folds
MrPink: calls 125
*** FLOP *** [Ah 5d Js]
MrPink: checks
MrBlue: checks
*** TURN *** [Ah 5d Js] [5c]
MrPink: checks
MrBlue: checks
*** RIVER *** [Ah 5d Js] [5c] [Ac]
MrPink: checks
MrBlue: checks
*** SHOWDOWN ***
MrBlue: shows [9s Kc]
MrBlue collected 500.0 from pot
*** SUMMARY ***
Total pot 500 | Rake 0
Board [Ah 5d Js 5c Ac]
Seat 2: MrPink showed [Ts 6c] and lost
Seat 6: MrBlue showed [9s Kc] and won (500.0)


PokerStars Hand #43118: Hold'em No Limit (50/100) - 2019/07/11 11:58:38 ET
Table 'Pluribus Session 43' 6-max (Play Money) Seat #6 is the button
Seat 1: MrPink (10000 in chips)
Seat 2: Pluribus (10000 in chips)
Seat 3: Eddie (10000 in chips)
Seat 4: MrBrown (10000 in chips)
Seat 5: MrBlue (10000 in chips)
Seat 6: Bill (10000 in chips)
MrPink: posts small blind 50
Pluribus: posts big blind 100
*** HOLE CARDS ***
Dealt to MrPink [7s 4s]
Dealt to Pluribus [9h 2c]
Dealt to Eddie [Kc Qd]
Dealt to MrBrown [6c 6h]
Dealt to MrBlue [Kd 3c]
Dealt to Bill [Ad 6s]
Eddie: raises 100 to 200
MrBrown: folds
MrBlue: folds
Bill: folds
MrPink: folds
Pluribus: folds
Uncalled bet (100) returned to Eddie
Eddie collected 250.0 from pot
*** SUMMARY ***
Total pot 250 | Rake 0


PokerStars Hand #43119: Hold'em No Limit (50/100) - 2019/07/11 11:58:39 ET
Table 'Pluribus Session 43' 6-max (Play Money) Seat #6 is the button
Seat 1: Pluribus (10000 in chips)
Seat 2: Eddie (10000 in chips)
Seat 3: MrBrown (10000 in chips)
Seat 4: MrBlue (10000 in chips)
Seat 5: Bill (10000 in chips)
Seat 6: MrPink (10000 in chips)
Pluribus: posts small blind 50
Eddie: posts big blind 100
*** HOLE CARDS ***
Dealt to Pluribus [Td Jd]
Dealt to Eddie [9c Qs]
Dealt to MrBrown [8s 2h]
Dealt to MrBlue [Th 4d]
Dealt to Bill [Ks Jc]
Dealt to MrPink [6h Ad]
MrBrown: folds
MrBlue: folds
Bill: raises 125 to 225
MrPink: folds
Pluribus: calls 175
Eddie: folds
*** FLOP *** [2s 2c Kd]
Pluribus: checks
Bill: bets 275
Pluribus: calls 275
*** TURN *** [2s 2c Kd] [7c]
Pluribus: checks
Bill: checks
*** RIVER *** [2s 2c Kd] [7c] [6d]
Pluribus: bets 550
Bill: calls 550
*** SHOWDOWN ***
Bill: shows [Ks Jc]
Bill collected 2200.0 from pot
*** SUMMARY ***
Total pot 2200 | Rake 0
Board [2s 2c Kd 7c 6d]
Seat 1: Pluribus showed [Td Jd] and lost
Seat 5: Bill showed [Ks Jc] and won (2200.0)


PokerStars Hand #43120: Hold'em No Limit (50/100) - 2019/07/11 11:58:40 ET
Table 'Pluribus Session 43' 6-max (Play Money) Seat #6 is the button
Seat 1: Eddie (10000 in chips)
Seat 2: MrBrown (10000 in chips)
Seat 3: MrBlue (10000 in chips)
Seat 4: Bill (10000 in chips)
Seat 5: MrPink (10000 in chips)
Seat 6: Pluribus (10000 in chips)
Eddie: posts small blind 50
MrBrown: posts big blind 100
*** HOLE CARDS ***
Dealt to Eddie [2c Jd]
Dealt to MrBrown [2h Js]
Dealt to MrBlue [4d 3d]
Dealt to Bill [4s Jh]
Dealt to MrPink [8h 9s]
Dealt to Pluribus [Jc 5h]
MrBlue: folds
Bill: folds
MrPink: folds
Pluribus: folds
Eddie: folds
Uncalled bet (50) returned to MrBrown
MrBrown collected 100.0 from pot
*** SUMMARY ***
Total pot 100 | Rake 0


PokerStars Hand #43121: Hold'em No Limit (50/100) - 2019/07/11 11:58:41 ET
Table 'Pluribus Session 43' 6-max (Play Money) Seat #6 is the button
Seat 1: MrBrown (10000 in chips)
Seat 2: MrBlue (10000 in chips)
Seat 3: Bill (10000 in chips)
Seat 4: MrPink (10000 in chips)
Seat 5: Pluribus (10000 in chips)
Seat 6: Eddie (10000 in chips)
MrBrown: posts small blind 50
MrBlue: posts big blind 100
*** HOLE CARDS ***
Dealt to MrBrown [Td 9h]
Dealt to MrBlue [Tc Kd]
Dealt to Bill [Jc 4c]
Dealt to MrPink [3s 7c]
Dealt to Pluribus [4d 2c]
Dealt to Eddie [Qd 9d]
Bill: folds
MrPink: folds
Pluribus: folds
Eddie: raises 122 to 222
MrBrown: folds
MrBlue: calls 122
*** FLOP *** [8h 2h Ac]
MrBlue: checks
Eddie: bets 150
MrBlue: folds
Uncalled bet (150) returned to Eddie
Eddie collected 494.0 from pot
*** SUMMARY ***
Total pot 494 | Rake 0
Board [8h 2h Ac]


PokerStars Hand #43122: Hold'em No Limit (50/100) - 2019/07/11 11:58:42 ET
Table 'Pluribus Session 43' 6-max (Play Money) Seat #6 is the button
Seat 1: MrBlue (10000 in chips)
Seat 2: Bill (10000 in chips)
Seat 3: MrPink (10000 in chips)
Seat 4: Pluribus (10000 in chips)
Seat 5: Eddie (10000 in chips)
Seat 6: MrBrown (10000 in chips)
MrBlue: posts small blind 50
Bill: posts big blind 100
*** HOLE CARDS ***
Dealt to MrBlue [2h 4h]
Dealt to Bill [5s 6d]
Dealt to MrPink [7d 2s]
Dealt to Pluribus [7h Qd]
Dealt to Eddie [Th 9s]
Dealt to MrBrown [8c Tc]
MrPink: folds
Pluribus: folds
Eddie: folds
MrBrown: raises 150 to 250
MrBlue: folds
Bill: calls 150
*** FLOP *** [Ac Ts 4c]
Bill: checks
MrBrown: checks
*** TURN *** [Ac Ts 4c] [7c]
Bill: bets 412
MrBrown: calls 412
*** RIVER *** [Ac Ts 4c] [7c] [2d]
Bill: checks
MrBrown: bets 2061
Bill: folds
Uncalled bet (2061) returned to MrBrown
MrBrown collected 1374.0 from pot
*** SUMMARY ***
Total pot 1374 | Rake 0
Board [Ac Ts 4c 7c 2d]


PokerStars Hand #43123: Hold'em No Limit (50/100) - 2019/07/11 11:58:43 ET
Table 'Pluribus Session 43' 6-max (Play Money) Seat #6 is the button
Seat 1: Bill (10000 in chips)
Seat 2: MrPink (10000 in chips)
Seat 3: Pluribus (10000 in chips)
Seat 4: Eddie (10000 in chips)
Seat 5: MrBrown (10000 in chips)
Seat 6: MrBlue (10000 in chips)
Bill: posts small blind 50
MrPink: posts big blind 100
*** HOLE CARDS ***
Dealt to Bill [2h 8s]
Dealt to MrPink [4s Kh]
Dealt to Pluribus [7d Th]
Dealt to Eddie [Qh 3h]
Dealt to MrBrown [6s As]
Dealt to MrBlue [5d Ac]
Pluribus: folds
Eddie: folds
MrBrown: folds
MrBlue: raises 125 to 225
Bill: folds
MrPink: folds
Uncalled bet (125) returned to MrBlue
MrBlue collected 250.0 from pot
*** SUMMARY ***
Total pot 250 | Rake 0
